"date","geography","geography code","Rural Urban","Tenure: All categories: Tenure; measures: Value","Tenure: Owned: Total; measures: Value","Tenure: Owned: Owned outright; measures: Value","Tenure: Owned: Owned with a mortgage or loan; measures: Value","Tenure: Shared ownership (part owned and part rented); measures: Value","Tenure: Social rented: Total; measures: Value","Tenure: Social rented: Rented from council (Local Authority); measures: Value","Tenure: Social rented: Other social rented; measures: Value","Tenure: Private rented: Total; measures: Value","Tenure: Private rented: Private landlord or letting agency; measures: Value","Tenure: Private rented: Employer of a household member; measures: Value","Tenure: Private rented: Relative or friend of household member; measures: Value","Tenure: Private rented: Other; measures: Value","Tenure: Living rent free; measures: Value"
"2011","E00004482","E00004482","Total",121,68,35,33,1,20,15,5,32,32,0,0,0,0
"2011","E00004497","E00004497","Total",117,26,3,23,0,78,76,2,11,9,0,2,0,2
"2011","E00004498","E00004498","Total",145,39,15,24,1,90,89,1,14,14,0,0,0,1
"2011","E00004502","E00004502","Total",120,23,11,12,0,84,83,1,13,13,0,0,0,0
"2011","E00004505","E00004505","Total",124,36,15,21,2,69,51,18,16,16,0,0,0,1
"2011","E00004481","E00004481","Total",133,38,18,20,1,91,91,0,3,3,0,0,0,0
"2011","E00004493","E00004493","Total",118,26,9,17,0,61,58,3,28,20,1,3,4,3
"2011","E00004500","E00004500","Total",131,35,8,27,0,74,73,1,22,19,0,3,0,0
"2011","E00004501","E00004501","Total",76,30,15,15,0,31,31,0,15,14,0,1,0,0
"2011","E00004503","E00004503","Total",132,31,17,14,0,77,71,6,20,13,0,3,4,4
"2011","E00004506","E00004506","Total",133,26,4,22,1,83,80,3,20,17,0,3,0,3
"2011","E00004507","E00004507","Total",104,76,45,31,0,18,18,0,8,8,0,0,0,2
"2011","E00004504","E00004504","Total",117,102,69,33,1,2,2,0,9,8,0,1,0,3
"2011","E00004508","E00004508","Total",150,83,50,33,2,34,34,0,27,21,0,4,2,4
"2011","E00004509","E00004509","Total",122,65,40,25,3,44,39,5,9,8,0,1,0,1
"2011","E00004510","E00004510","Total",128,53,35,18,1,21,9,12,50,49,0,0,1,3
"2011","E00004511","E00004511","Total",144,90,59,31,0,22,8,14,29,24,0,5,0,3
"2011","E00004486","E00004486","Total",116,67,43,24,9,22,22,0,15,13,0,2,0,3
"2011","E00004487","E00004487","Total",112,19,9,10,1,74,9,65,18,16,0,2,0,0
"2011","E00004489","E00004489","Total",120,43,23,20,2,50,49,1,18,18,0,0,0,7
"2011","E00004490","E00004490","Total",94,19,10,9,1,51,44,7,21,19,1,1,0,2
"2011","E00004491","E00004491","Total",149,32,10,22,1,96,91,5,19,19,0,0,0,1
"2011","E00004517","E00004517","Total",109,29,12,17,0,66,65,1,14,12,2,0,0,0
"2011","E00004492","E00004492","Total",128,99,60,39,0,4,4,0,21,18,3,0,0,4
"2011","E00004494","E00004494","Total",182,112,64,48,1,2,2,0,56,51,2,3,0,11
"2011","E00004495","E00004495","Total",126,101,70,31,0,4,2,2,19,17,0,2,0,2
"2011","E00004496","E00004496","Total",151,110,81,29,1,2,1,1,31,30,0,1,0,7
"2011","E00004499","E00004499","Total",135,117,65,52,0,2,1,1,13,13,0,0,0,3
"2011","E00004411","E00004411","Total",114,64,39,25,1,4,4,0,44,43,0,1,0,1
"2011","E00004412","E00004412","Total",128,67,43,24,3,4,2,2,53,51,0,1,1,1
"2011","E00004414","E00004414","Total",123,72,45,27,1,13,6,7,36,34,0,2,0,1
"2011","E00004416","E00004416","Total",114,68,51,17,0,5,4,1,40,37,0,3,0,1
"2011","E00004418","E00004418","Total",114,79,49,30,0,2,2,0,31,30,0,1,0,2
"2011","E00004423","E00004423","Total",122,76,52,24,0,4,1,3,40,38,0,1,1,2
"2011","E00004401","E00004401","Total",128,82,56,26,0,10,10,0,35,32,0,3,0,1
"2011","E00004404","E00004404","Total",116,80,59,21,0,1,1,0,31,30,1,0,0,4
"2011","E00004417","E00004417","Total",125,78,51,27,0,8,5,3,37,34,0,3,0,2
"2011","E00004421","E00004421","Total",123,60,36,24,0,3,3,0,57,53,3,1,0,3
"2011","E00004429","E00004429","Total",127,62,44,18,0,4,2,2,60,58,2,0,0,1
"2011","E00004409","E00004409","Total",108,39,26,13,0,43,42,1,21,20,0,1,0,5
"2011","E00004410","E00004410","Total",120,57,34,23,0,36,34,2,25,25,0,0,0,2
"2011","E00004415","E00004415","Total",139,69,46,23,0,18,1,17,51,44,2,3,2,1
"2011","E00004419","E00004419","Total",126,25,16,9,0,5,2,3,93,89,3,1,0,3
"2011","E00004422","E00004422","Total",92,35,21,14,0,14,13,1,40,39,0,1,0,3
"2011","E00004428","E00004428","Total",131,65,46,19,2,1,0,1,57,51,0,5,1,6
"2011","E00004430","E00004430","Total",125,10,6,4,1,86,81,5,24,23,0,1,0,4
"2011","E00004402","E00004402","Total",127,58,38,20,0,9,2,7,59,59,0,0,0,1
"2011","E00004420","E00004420","Total",112,67,45,22,0,2,2,0,42,40,0,2,0,1
"2011","E00004424","E00004424","Total",117,64,39,25,0,2,2,0,48,46,0,2,0,3
"2011","E00004425","E00004425","Total",140,94,64,30,0,0,0,0,45,45,0,0,0,1
"2011","E00004426","E00004426","Total",143,75,49,26,0,17,9,8,49,46,0,3,0,2
"2011","E00004427","E00004427","Total",117,91,67,24,0,1,1,0,22,21,1,0,0,3
"2011","E00004403","E00004403","Total",128,101,75,26,0,0,0,0,18,17,1,0,0,9
"2011","E00004405","E00004405","Total",128,79,54,25,0,0,0,0,42,39,0,2,1,7
"2011","E00004406","E00004406","Total",117,84,55,29,0,4,3,1,20,20,0,0,0,9
"2011","E00004407","E00004407","Total",118,83,58,25,0,4,2,2,24,23,0,0,1,7
"2011","E00004408","E00004408","Total",106,73,47,26,0,1,1,0,30,30,0,0,0,2
"2011","E00004413","E00004413","Total",101,60,36,24,0,3,3,0,37,35,1,1,0,1
"2011","E00004483","E00004483","Total",114,64,42,22,0,11,8,3,37,36,1,0,0,2
"2011","E00004485","E00004485","Total",123,50,22,28,0,48,42,6,23,19,0,4,0,2
"2011","E00004513","E00004513","Total",102,72,52,20,1,9,9,0,17,17,0,0,0,3
"2011","E00004514","E00004514","Total",116,74,46,28,0,18,11,7,23,21,1,1,0,1
"2011","E00004516","E00004516","Total",133,92,63,29,0,11,10,1,26,25,1,0,0,4
"2011","E00004484","E00004484","Total",112,58,32,26,0,32,21,11,21,19,0,1,1,1
"2011","E00004488","E00004488","Total",82,2,1,1,0,76,3,73,3,3,0,0,0,1
"2011","E00004512","E00004512","Total",120,43,20,23,1,50,35,15,25,21,1,1,2,1
"2011","E00004515","E00004515","Total",121,71,36,35,1,18,7,11,31,31,0,0,0,0
"2011","E00004518","E00004518","Total",116,29,10,19,1,74,17,57,12,9,0,2,1,0
"2011","E00004519","E00004519","Total",112,84,38,46,1,13,9,4,13,12,0,1,0,1
"2011","E00004575","E00004575","Total",184,31,18,13,1,25,13,12,127,126,0,1,0,0
"2011","E00004578","E00004578","Total",154,19,8,11,0,27,16,11,107,105,1,0,1,1
"2011","E00004580","E00004580","Total",151,44,18,26,10,38,25,13,57,55,0,2,0,2
"2011","E00004581","E00004581","Total",101,43,17,26,0,33,4,29,20,19,0,0,1,5
"2011","E00004582","E00004582","Total",127,57,27,30,1,25,10,15,43,40,2,1,0,1
"2011","E00004593","E00004593","Total",229,59,18,41,6,51,19,32,108,105,0,3,0,5
"2011","E00004587","E00004587","Total",121,38,15,23,1,63,40,23,18,18,0,0,0,1
"2011","E00004589","E00004589","Total",125,69,37,32,0,32,22,10,24,23,0,1,0,0
"2011","E00004590","E00004590","Total",99,43,18,25,1,35,16,19,20,19,0,0,1,0
"2011","E00004592","E00004592","Total",99,44,18,26,0,33,16,17,21,20,1,0,0,1
"2011","E00004595","E00004595","Total",104,50,30,20,0,40,15,25,12,11,0,1,0,2
"2011","E00004596","E00004596","Total",108,67,30,37,0,19,17,2,21,19,2,0,0,1
"2011","E00004576","E00004576","Total",140,50,21,29,0,67,62,5,21,20,0,1,0,2
"2011","E00004577","E00004577","Total",124,65,24,41,0,45,45,0,12,12,0,0,0,2
"2011","E00004579","E00004579","Total",105,50,25,25,2,33,22,11,18,17,0,1,0,2
"2011","E00004583","E00004583","Total",142,58,29,29,1,41,25,16,40,39,0,1,0,2
"2011","E00004584","E00004584","Total",171,59,29,30,0,67,38,29,43,39,0,4,0,2
"2011","E00004323","E00004323","Total",96,33,18,15,0,22,4,18,37,35,0,2,0,4
"2011","E00004328","E00004328","Total",95,56,34,22,0,10,9,1,28,27,1,0,0,1
"2011","E00004353","E00004353","Total",137,85,66,19,0,0,0,0,45,42,0,2,1,7
"2011","E00004354","E00004354","Total",108,71,49,22,0,0,0,0,31,30,0,1,0,6
"2011","E00004358","E00004358","Total",114,61,26,35,1,30,28,2,20,20,0,0,0,2
"2011","E00004324","E00004324","Total",122,69,44,25,0,9,9,0,41,40,0,1,0,3
"2011","E00004325","E00004325","Total",113,52,36,16,0,2,2,0,58,56,1,1,0,1
"2011","E00004330","E00004330","Total",146,68,29,39,0,1,0,1,74,72,0,1,1,3
"2011","E00004355","E00004355","Total",122,59,35,24,0,20,17,3,41,41,0,0,0,2
"2011","E00004361","E00004361","Total",99,51,37,14,1,18,18,0,27,27,0,0,0,2
"2011","E00004327","E00004327","Total",140,64,36,28,0,12,11,1,59,59,0,0,0,5
"2011","E00004329","E00004329","Total",124,48,22,26,0,10,7,3,65,64,0,1,0,1
"2011","E00004356","E00004356","Total",121,64,38,26,0,3,2,1,51,50,0,0,1,3
"2011","E00004357","E00004357","Total",118,69,40,29,0,1,0,1,46,45,1,0,0,2
"2011","E00004360","E00004360","Total",118,70,37,33,0,7,6,1,38,37,0,1,0,3
"2011","E00004322","E00004322","Total",114,81,59,22,0,1,1,0,30,28,0,1,1,2
"2011","E00004347","E00004347","Total",97,61,32,29,0,2,2,0,30,30,0,0,0,4
"2011","E00004348","E00004348","Total",131,55,26,29,0,12,6,6,63,62,0,0,1,1
"2011","E00004349","E00004349","Total",117,81,45,36,0,6,3,3,27,25,0,2,0,3
"2011","E00004352","E00004352","Total",118,85,52,33,1,3,3,0,28,26,0,1,1,1
"2011","E00004345","E00004345","Total",121,84,56,28,0,1,0,1,27,27,0,0,0,9
"2011","E00004346","E00004346","Total",94,25,19,6,2,43,42,1,24,24,0,0,0,0
"2011","E00004350","E00004350","Total",125,78,55,23,0,1,0,1,41,38,0,3,0,5
"2011","E00004351","E00004351","Total",131,80,63,17,0,5,0,5,37,36,0,1,0,9
"2011","E00004359","E00004359","Total",121,81,63,18,0,0,0,0,33,32,0,0,1,7
"2011","E00004295","E00004295","Total",175,90,51,39,13,5,3,2,64,63,0,1,0,3
"2011","E00004296","E00004296","Total",133,45,22,23,1,63,54,9,23,22,0,0,1,1
"2011","E00004298","E00004298","Total",112,73,38,35,1,10,6,4,28,28,0,0,0,0
"2011","E00004303","E00004303","Total",113,81,49,32,0,3,2,1,28,25,0,2,1,1
"2011","E00004311","E00004311","Total",99,61,23,38,0,10,7,3,26,25,0,1,0,2
"2011","E00004300","E00004300","Total",111,43,18,25,0,29,13,16,37,35,0,1,1,2
"2011","E00004301","E00004301","Total",241,33,18,15,1,29,19,10,176,175,0,1,0,2
"2011","E00004302","E00004302","Total",143,27,11,16,0,34,31,3,82,81,0,1,0,0
"2011","E00004314","E00004314","Total",153,47,13,34,0,16,3,13,88,87,0,1,0,2
"2011","E00004316","E00004316","Total",122,31,7,24,1,22,11,11,68,66,0,1,1,0
"2011","E00004319","E00004319","Total",143,49,19,30,5,5,5,0,84,80,0,4,0,0
"2011","E00004307","E00004307","Total",150,100,56,44,0,17,7,10,31,29,1,1,0,2
"2011","E00004308","E00004308","Total",123,60,29,31,0,19,5,14,44,42,0,2,0,0
"2011","E00004312","E00004312","Total",150,77,45,32,0,20,10,10,51,50,0,1,0,2
"2011","E00004317","E00004317","Total",161,60,25,35,0,27,3,24,72,69,1,2,0,2
"2011","E00004318","E00004318","Total",126,72,32,40,0,15,4,11,39,38,0,1,0,0
"2011","E00004305","E00004305","Total",134,70,36,34,0,0,0,0,60,57,1,2,0,4
"2011","E00004306","E00004306","Total",157,86,48,38,0,1,0,1,65,61,1,2,1,5
"2011","E00004310","E00004310","Total",128,84,42,42,1,11,11,0,29,28,0,1,0,3
"2011","E00004313","E00004313","Total",131,79,42,37,0,3,0,3,46,44,0,0,2,3
"2011","E00004315","E00004315","Total",154,75,27,48,0,6,6,0,73,71,0,2,0,0
"2011","E00004285","E00004285","Total",144,40,23,17,0,19,16,3,83,83,0,0,0,2
"2011","E00004297","E00004297","Total",154,49,23,26,0,7,0,7,93,86,0,6,1,5
"2011","E00004299","E00004299","Total",135,75,30,45,0,19,4,15,40,40,0,0,0,1
"2011","E00004304","E00004304","Total",178,78,28,50,1,22,10,12,74,73,0,1,0,3
"2011","E00004309","E00004309","Total",115,58,26,32,0,4,4,0,50,46,0,1,3,3
"2011","E00004381","E00004381","Total",117,70,23,47,1,12,12,0,32,31,0,1,0,2
"2011","E00004384","E00004384","Total",101,49,22,27,0,19,16,3,33,31,0,1,1,0
"2011","E00004385","E00004385","Total",91,49,20,29,1,12,7,5,26,25,1,0,0,3
"2011","E00004389","E00004389","Total",108,64,31,33,0,9,9,0,34,33,0,1,0,1
"2011","E00004392","E00004392","Total",95,65,44,21,0,16,11,5,12,11,1,0,0,2
"2011","E00004394","E00004394","Total",94,35,11,24,0,39,38,1,19,19,0,0,0,1
"2011","E00004365","E00004365","Total",139,59,19,40,5,6,0,6,67,63,0,1,3,2
"2011","E00004383","E00004383","Total",103,54,26,28,0,20,17,3,29,26,0,3,0,0
"2011","E00004387","E00004387","Total",89,51,25,26,0,4,2,2,34,31,0,3,0,0
"2011","E00004390","E00004390","Total",113,48,21,27,0,29,29,0,32,32,0,0,0,4
"2011","E00004393","E00004393","Total",113,31,16,15,0,52,51,1,28,28,0,0,0,2
"2011","E00004395","E00004395","Total",133,55,21,34,0,21,20,1,55,53,0,0,2,2
"2011","E00004382","E00004382","Total",139,57,30,27,0,30,8,22,50,48,0,2,0,2
"2011","E00004386","E00004386","Total",101,59,30,29,1,15,10,5,25,24,0,1,0,1
"2011","E00004388","E00004388","Total",99,53,24,29,0,7,6,1,39,36,0,3,0,0
"2011","E00004391","E00004391","Total",128,60,37,23,1,22,9,13,45,44,0,1,0,0
"2011","E00004396","E00004396","Total",131,17,9,8,1,99,59,40,12,12,0,0,0,2
"2011","E00004398","E00004398","Total",99,39,20,19,1,41,31,10,17,16,0,1,0,1
"2011","E00004367","E00004367","Total",148,24,10,14,0,102,101,1,19,17,0,2,0,3
"2011","E00004368","E00004368","Total",175,77,47,30,15,5,4,1,75,71,3,1,0,3
"2011","E00004372","E00004372","Total",109,27,11,16,0,62,62,0,20,19,0,1,0,0
"2011","E00004375","E00004375","Total",119,70,44,26,0,13,13,0,33,32,0,1,0,3
"2011","E00004378","E00004378","Total",137,53,22,31,1,31,16,15,48,45,0,2,1,4
"2011","E00004379","E00004379","Total",135,69,40,29,0,20,18,2,39,34,0,4,1,7
"2011","E00004441","E00004441","Total",115,66,35,31,0,13,10,3,35,34,0,0,1,1
"2011","E00004447","E00004447","Total",77,15,9,6,0,50,5,45,11,11,0,0,0,1
"2011","E00004451","E00004451","Total",118,44,29,15,1,56,3,53,15,15,0,0,0,2
"2011","E00004452","E00004452","Total",143,34,20,14,0,70,21,49,36,32,0,3,1,3
"2011","E00004457","E00004457","Total",117,65,39,26,0,12,12,0,36,33,2,0,1,4
"2011","E00004480","E00004480","Total",116,58,37,21,3,19,14,5,35,32,0,2,1,1
"2011","E00004362","E00004362","Total",127,21,5,16,1,81,69,12,21,20,0,1,0,3
"2011","E00004370","E00004370","Total",117,23,13,10,0,85,79,6,8,8,0,0,0,1
"2011","E00004376","E00004376","Total",176,37,9,28,1,116,66,50,20,18,0,2,0,2
"2011","E00004397","E00004397","Total",106,5,2,3,0,96,32,64,3,3,0,0,0,2
"2011","E00004399","E00004399","Total",131,23,9,14,0,94,92,2,14,14,0,0,0,0
"2011","E00004363","E00004363","Total",153,17,3,14,2,112,108,4,20,19,0,1,0,2
"2011","E00004366","E00004366","Total",165,6,2,4,2,151,151,0,5,5,0,0,0,1
"2011","E00004369","E00004369","Total",123,19,9,10,1,92,90,2,11,9,0,1,1,0
"2011","E00004373","E00004373","Total",146,8,3,5,0,125,124,1,10,8,2,0,0,3
"2011","E00004400","E00004400","Total",180,17,4,13,0,155,154,1,8,7,0,1,0,0
"2011","E00004364","E00004364","Total",225,53,26,27,3,128,109,19,37,37,0,0,0,4
"2011","E00004371","E00004371","Total",103,15,3,12,0,78,77,1,9,7,0,2,0,1
"2011","E00004374","E00004374","Total",97,7,3,4,0,76,73,3,13,12,0,1,0,1
"2011","E00004377","E00004377","Total",95,5,2,3,0,84,83,1,6,6,0,0,0,0
"2011","E00004380","E00004380","Total",152,11,3,8,1,94,91,3,43,41,0,1,1,3
"2011","E00004444","E00004444","Total",160,28,3,25,1,97,94,3,30,29,0,1,0,4
"2011","E00004445","E00004445","Total",105,38,9,29,3,39,36,3,24,22,1,1,0,1
"2011","E00004454","E00004454","Total",189,20,15,5,20,119,66,53,26,25,0,1,0,4
"2011","E00004456","E00004456","Total",124,6,2,4,0,116,19,97,2,2,0,0,0,0
"2011","E00174669","E00174669","Total",125,17,2,15,1,94,92,2,12,12,0,0,0,1
"2011","E00004563","E00004563","Total",195,40,19,21,22,88,40,48,43,42,0,1,0,2
"2011","E00004566","E00004566","Total",140,42,17,25,1,76,75,1,19,18,0,1,0,2
"2011","E00004568","E00004568","Total",157,29,16,13,0,58,45,13,66,65,0,1,0,4
"2011","E00004569","E00004569","Total",161,62,35,27,1,53,31,22,45,42,0,1,2,0
"2011","E00004570","E00004570","Total",131,83,54,29,0,18,14,4,28,27,0,1,0,2
"2011","E00004571","E00004571","Total",151,77,38,39,0,26,14,12,44,41,1,2,0,4
"2011","E00004572","E00004572","Total",160,67,29,38,1,37,36,1,54,50,0,4,0,1
"2011","E00004573","E00004573","Total",149,65,36,29,2,42,31,11,39,36,0,2,1,1
"2011","E00004574","E00004574","Total",143,70,33,37,1,35,28,7,35,33,0,2,0,2
"2011","E00004321","E00004321","Total",114,57,38,19,0,4,1,3,49,49,0,0,0,4
"2011","E00004326","E00004326","Total",117,26,21,5,0,17,9,8,71,71,0,0,0,3
"2011","E00004331","E00004331","Total",112,42,22,20,0,17,17,0,52,52,0,0,0,1
"2011","E00004336","E00004336","Total",175,46,30,16,0,4,1,3,123,123,0,0,0,2
"2011","E00004337","E00004337","Total",114,42,29,13,3,20,20,0,47,44,0,3,0,2
"2011","E00004320","E00004320","Total",112,78,46,32,2,2,1,1,28,27,0,1,0,2
"2011","E00004333","E00004333","Total",133,69,38,31,0,11,10,1,49,48,0,1,0,4
"2011","E00004335","E00004335","Total",145,57,37,20,0,2,2,0,81,80,0,1,0,5
"2011","E00004338","E00004338","Total",112,48,28,20,1,3,3,0,60,60,0,0,0,0
"2011","E00004341","E00004341","Total",132,53,32,21,0,1,0,1,76,75,0,0,1,2
"2011","E00004342","E00004342","Total",94,55,30,25,0,1,1,0,36,34,0,2,0,2
"2011","E00004332","E00004332","Total",87,31,18,13,1,15,2,13,38,34,1,0,3,2
"2011","E00004334","E00004334","Total",106,37,22,15,0,13,13,0,55,53,0,1,1,1
"2011","E00004339","E00004339","Total",112,42,27,15,2,10,10,0,57,53,0,2,2,1
"2011","E00004340","E00004340","Total",95,20,13,7,1,2,1,1,70,68,0,2,0,2
"2011","E00004343","E00004343","Total",120,52,30,22,0,1,1,0,64,60,1,2,1,3
"2011","E00004344","E00004344","Total",118,43,23,20,0,9,6,3,62,62,0,0,0,4
"2011","E00004431","E00004431","Total",106,63,38,25,0,6,6,0,35,35,0,0,0,2
"2011","E00004432","E00004432","Total",135,85,49,36,0,1,1,0,42,39,1,2,0,7
"2011","E00004433","E00004433","Total",139,71,55,16,0,4,2,2,63,59,0,3,1,1
"2011","E00004437","E00004437","Total",116,60,39,21,0,1,1,0,45,44,0,1,0,10
"2011","E00004439","E00004439","Total",113,80,52,28,0,0,0,0,30,30,0,0,0,3
"2011","E00004440","E00004440","Total",112,70,45,25,0,4,4,0,37,37,0,0,0,1
"2011","E00004435","E00004435","Total",119,26,12,14,0,64,62,2,24,23,0,1,0,5
"2011","E00004436","E00004436","Total",166,87,64,23,1,30,23,7,40,40,0,0,0,8
"2011","E00004438","E00004438","Total",118,30,20,10,0,3,3,0,82,81,0,0,1,3
"2011","E00174668","E00174668","Total",108,11,6,5,0,83,83,0,11,11,0,0,0,3
"2011","E00174670","E00174670","Total",107,25,10,15,0,35,6,29,46,44,1,0,1,1
"2011","E00174672","E00174672","Total",141,4,0,4,0,104,0,104,33,24,5,0,4,0
"2011","E00174673","E00174673","Total",91,1,1,0,1,56,0,56,33,20,9,0,4,0
"2011","E00004245","E00004245","Total",163,41,20,21,0,96,76,20,23,22,0,1,0,3
"2011","E00004247","E00004247","Total",156,59,34,25,1,59,15,44,35,34,0,1,0,2
"2011","E00004248","E00004248","Total",207,57,30,27,1,94,59,35,52,47,0,3,2,3
"2011","E00004254","E00004254","Total",119,15,5,10,3,92,63,29,8,7,0,1,0,1
"2011","E00004273","E00004273","Total",159,81,40,41,0,13,11,2,62,57,0,4,1,3
"2011","E00004276","E00004276","Total",122,40,17,23,4,53,43,10,24,23,0,1,0,1
"2011","E00004265","E00004265","Total",112,18,5,13,0,62,62,0,32,32,0,0,0,0
"2011","E00004266","E00004266","Total",156,45,14,31,5,82,76,6,21,20,0,1,0,3
"2011","E00004268","E00004268","Total",142,32,5,27,0,87,74,13,21,20,1,0,0,2
"2011","E00004269","E00004269","Total",121,27,6,21,3,59,58,1,31,31,0,0,0,1
"2011","E00004272","E00004272","Total",113,70,41,29,0,27,22,5,16,14,0,2,0,0
"2011","E00004274","E00004274","Total",130,63,25,38,0,33,27,6,31,27,2,1,1,3
"2011","E00004585","E00004585","Total",134,54,19,35,0,50,27,23,28,26,0,2,0,2
"2011","E00004586","E00004586","Total",116,63,35,28,0,19,9,10,33,32,0,0,1,1
"2011","E00004588","E00004588","Total",154,62,29,33,0,25,11,14,64,61,0,3,0,3
"2011","E00004594","E00004594","Total",124,46,17,29,0,43,31,12,32,30,0,2,0,3
"2011","E00004598","E00004598","Total",106,29,17,12,1,39,39,0,32,31,0,0,1,5
"2011","E00004599","E00004599","Total",161,67,41,26,0,21,16,5,72,69,1,0,2,1
"2011","E00004565","E00004565","Total",145,14,2,12,0,121,119,2,6,5,0,0,1,4
"2011","E00004591","E00004591","Total",112,25,9,16,0,51,36,15,36,34,0,2,0,0
"2011","E00004600","E00004600","Total",124,15,6,9,1,90,84,6,18,16,0,2,0,0
"2011","E00004601","E00004601","Total",117,48,24,24,0,51,47,4,17,13,1,2,1,1
"2011","E00004603","E00004603","Total",131,22,10,12,0,83,83,0,24,22,0,2,0,2
"2011","E00004562","E00004562","Total",123,27,6,21,0,55,49,6,38,34,0,4,0,3
"2011","E00004564","E00004564","Total",118,23,12,11,1,17,16,1,71,67,2,1,1,6
"2011","E00004567","E00004567","Total",128,30,10,20,0,82,81,1,14,11,0,1,2,2
"2011","E00004597","E00004597","Total",214,47,17,30,0,58,55,3,109,109,0,0,0,0
"2011","E00004602","E00004602","Total",115,55,29,26,1,19,6,13,40,39,0,0,1,0
"2011","E00004813","E00004813","Total",174,96,56,40,1,18,13,5,55,52,0,2,1,4
"2011","E00004820","E00004820","Total",136,31,12,19,0,6,4,2,97,96,0,1,0,2
"2011","E00004848","E00004848","Total",159,62,32,30,0,17,17,0,75,69,0,6,0,5
"2011","E00004849","E00004849","Total",138,89,44,45,0,3,2,1,45,40,1,4,0,1
"2011","E00004850","E00004850","Total",203,85,34,51,1,4,2,2,110,107,0,3,0,3
"2011","E00004853","E00004853","Total",144,28,10,18,0,0,0,0,113,110,0,2,1,3
"2011","E00004814","E00004814","Total",124,67,29,38,1,6,5,1,50,50,0,0,0,0
"2011","E00004818","E00004818","Total",138,30,10,20,0,7,2,5,99,98,0,1,0,2
"2011","E00004821","E00004821","Total",109,39,23,16,1,10,2,8,56,55,0,0,1,3
"2011","E00004824","E00004824","Total",130,33,18,15,0,18,5,13,78,78,0,0,0,1
"2011","E00004825","E00004825","Total",110,44,11,33,0,3,1,2,63,61,0,2,0,0
"2011","E00004826","E00004826","Total",125,58,21,37,1,10,5,5,55,53,0,2,0,1
"2011","E00004851","E00004851","Total",95,45,12,33,0,7,1,6,43,41,0,2,0,0
"2011","E00004816","E00004816","Total",131,44,14,30,1,15,10,5,70,68,0,2,0,1
"2011","E00004817","E00004817","Total",112,63,33,30,0,14,5,9,34,34,0,0,0,1
"2011","E00004819","E00004819","Total",138,80,42,38,0,9,7,2,48,46,0,1,1,1
"2011","E00004822","E00004822","Total",130,72,41,31,0,14,9,5,44,43,0,1,0,0
"2011","E00004852","E00004852","Total",138,70,36,34,0,19,16,3,47,46,0,1,0,2
"2011","E00004815","E00004815","Total",242,37,30,7,1,56,11,45,145,144,0,1,0,3
"2011","E00004823","E00004823","Total",180,33,19,14,0,96,73,23,50,48,1,1,0,1
"2011","E00004827","E00004827","Total",168,17,8,9,8,97,25,72,42,42,0,0,0,4
"2011","E00004828","E00004828","Total",133,26,10,16,0,67,63,4,34,33,0,1,0,6
"2011","E00004829","E00004829","Total",109,33,21,12,0,15,13,2,61,60,0,1,0,0
"2011","E00004831","E00004831","Total",117,2,0,2,0,107,18,89,6,6,0,0,0,2
"2011","E00004830","E00004830","Total",139,49,19,30,0,31,17,14,59,59,0,0,0,0
"2011","E00004832","E00004832","Total",147,13,7,6,0,61,25,36,72,68,0,4,0,1
"2011","E00004835","E00004835","Total",167,32,23,9,0,20,7,13,108,108,0,0,0,7
"2011","E00004837","E00004837","Total",191,54,15,39,1,47,18,29,89,85,0,4,0,0
"2011","E00004840","E00004840","Total",117,28,9,19,2,27,22,5,58,58,0,0,0,2
"2011","E00004841","E00004841","Total",133,33,10,23,1,66,46,20,31,30,0,1,0,2
"2011","E00004120","E00004120","Total",143,65,40,25,0,14,7,7,57,55,0,1,1,7
"2011","E00004140","E00004140","Total",111,55,40,15,0,2,2,0,54,54,0,0,0,0
"2011","E00004141","E00004141","Total",114,40,20,20,1,46,2,44,25,24,0,0,1,2
"2011","E00004142","E00004142","Total",133,70,40,30,0,9,6,3,52,50,0,2,0,2
"2011","E00004145","E00004145","Total",110,60,40,20,1,8,3,5,40,40,0,0,0,1
"2011","E00004152","E00004152","Total",113,69,48,21,1,4,0,4,37,36,1,0,0,2
"2011","E00004121","E00004121","Total",118,56,37,19,0,27,0,27,33,30,0,2,1,2
"2011","E00004143","E00004143","Total",126,61,27,34,0,14,2,12,50,49,0,1,0,1
"2011","E00004150","E00004150","Total",147,59,26,33,0,6,6,0,79,78,0,1,0,3
"2011","E00004154","E00004154","Total",122,56,32,24,0,0,0,0,64,63,0,0,1,2
"2011","E00004155","E00004155","Total",103,56,29,27,0,3,2,1,44,41,3,0,0,0
"2011","E00004156","E00004156","Total",126,44,28,16,1,14,5,9,65,63,0,2,0,2
"2011","E00004162","E00004162","Total",128,29,13,16,0,3,2,1,92,91,0,0,1,4
"2011","E00004126","E00004126","Total",144,58,36,22,0,18,16,2,62,61,0,1,0,6
"2011","E00004128","E00004128","Total",161,82,51,31,1,12,11,1,63,58,1,4,0,3
"2011","E00004129","E00004129","Total",142,58,32,26,0,14,11,3,67,66,0,1,0,3
"2011","E00004131","E00004131","Total",119,73,44,29,0,6,6,0,37,35,0,1,1,3
"2011","E00004132","E00004132","Total",92,48,27,21,2,1,1,0,38,36,0,2,0,3
"2011","E00004137","E00004137","Total",147,80,46,34,0,22,7,15,45,45,0,0,0,0
"2011","E00004124","E00004124","Total",100,52,31,21,0,4,4,0,41,41,0,0,0,3
"2011","E00004125","E00004125","Total",178,74,46,28,1,1,1,0,100,96,0,4,0,2
"2011","E00004127","E00004127","Total",124,46,22,24,1,30,5,25,42,39,1,2,0,5
"2011","E00004130","E00004130","Total",128,56,34,22,0,9,5,4,62,60,0,1,1,1
"2011","E00004133","E00004133","Total",118,42,17,25,0,14,8,6,61,60,0,1,0,1
"2011","E00004135","E00004135","Total",105,32,15,17,0,2,1,1,68,66,0,2,0,3
"2011","E00004168","E00004168","Total",109,72,52,20,0,3,1,2,33,32,0,0,1,1
"2011","E00004448","E00004448","Total",142,33,10,23,3,89,78,11,16,15,0,0,1,1
"2011","E00004450","E00004450","Total",175,39,16,23,1,63,55,8,70,68,0,2,0,2
"2011","E00004453","E00004453","Total",144,40,20,20,1,79,76,3,20,19,0,1,0,4
"2011","E00004458","E00004458","Total",182,67,24,43,1,76,63,13,38,37,1,0,0,0
"2011","E00004462","E00004462","Total",114,55,32,23,0,18,15,3,38,33,0,4,1,3
"2011","E00004442","E00004442","Total",109,11,6,5,0,82,51,31,13,13,0,0,0,3
"2011","E00004446","E00004446","Total",118,37,14,23,4,63,57,6,14,14,0,0,0,0
"2011","E00004455","E00004455","Total",123,8,1,7,1,99,95,4,14,13,0,1,0,1
"2011","E00004460","E00004460","Total",100,13,9,4,2,68,68,0,14,12,0,2,0,3
"2011","E00004470","E00004470","Total",140,37,16,21,0,55,52,3,47,44,0,3,0,1
"2011","E00004465","E00004465","Total",166,42,20,22,0,104,94,10,20,19,0,1,0,0
"2011","E00004467","E00004467","Total",133,25,9,16,2,87,86,1,19,16,0,3,0,0
"2011","E00004474","E00004474","Total",142,71,35,36,0,22,14,8,49,48,0,1,0,0
"2011","E00004475","E00004475","Total",123,17,4,13,0,90,84,6,15,15,0,0,0,1
"2011","E00004476","E00004476","Total",134,5,3,2,0,112,110,2,17,16,0,0,1,0
"2011","E00004478","E00004478","Total",220,50,18,32,6,63,35,28,100,96,1,2,1,1
"2011","E00004459","E00004459","Total",154,14,1,13,0,129,126,3,10,9,0,1,0,1
"2011","E00004461","E00004461","Total",131,10,3,7,0,102,102,0,19,18,0,1,0,0
"2011","E00004463","E00004463","Total",139,7,2,5,1,119,117,2,12,12,0,0,0,0
"2011","E00004464","E00004464","Total",89,2,2,0,0,86,82,4,0,0,0,0,0,1
"2011","E00004468","E00004468","Total",143,11,2,9,0,115,107,8,17,15,0,2,0,0
"2011","E00004472","E00004472","Total",156,27,3,24,0,76,73,3,51,47,2,2,0,2
"2011","E00004466","E00004466","Total",121,56,31,25,0,3,2,1,58,56,0,2,0,4
"2011","E00004469","E00004469","Total",122,78,52,26,0,5,4,1,37,34,0,3,0,2
"2011","E00004471","E00004471","Total",117,75,44,31,0,0,0,0,40,36,0,2,2,2
"2011","E00004473","E00004473","Total",124,56,37,19,0,27,27,0,39,35,0,4,0,2
"2011","E00004477","E00004477","Total",163,77,41,36,0,17,16,1,67,63,0,3,1,2
"2011","E00004479","E00004479","Total",141,50,22,28,0,49,47,2,40,38,0,2,0,2
"2011","E00004282","E00004282","Total",149,46,15,31,0,34,15,19,66,64,0,2,0,3
"2011","E00004284","E00004284","Total",128,25,6,19,0,44,12,32,55,55,0,0,0,4
"2011","E00004286","E00004286","Total",158,51,30,21,6,16,13,3,83,83,0,0,0,2
"2011","E00004287","E00004287","Total",111,50,21,29,0,2,0,2,59,53,0,5,1,0
"2011","E00004289","E00004289","Total",129,36,15,21,1,18,3,15,74,71,0,2,1,0
"2011","E00004290","E00004290","Total",164,43,19,24,0,19,3,16,101,101,0,0,0,1
"2011","E00004283","E00004283","Total",137,63,18,45,2,40,35,5,28,28,0,0,0,4
"2011","E00004288","E00004288","Total",166,40,17,23,2,43,28,15,81,77,0,2,2,0
"2011","E00004291","E00004291","Total",138,31,7,24,0,91,89,2,15,12,2,0,1,1
"2011","E00004292","E00004292","Total",121,17,8,9,0,89,82,7,13,13,0,0,0,2
"2011","E00004293","E00004293","Total",119,31,8,23,0,48,18,30,40,40,0,0,0,0
"2011","E00004294","E00004294","Total",119,26,6,20,3,31,19,12,56,55,0,1,0,3
"2011","E00004604","E00004604","Total",136,21,2,19,0,54,23,31,61,59,0,0,2,0
"2011","E00004605","E00004605","Total",113,34,7,27,0,62,62,0,15,14,0,1,0,2
"2011","E00004612","E00004612","Total",142,21,4,17,0,61,58,3,56,54,0,1,1,4
"2011","E00004613","E00004613","Total",125,21,6,15,0,63,60,3,40,39,0,0,1,1
"2011","E00004614","E00004614","Total",224,32,10,22,1,73,28,45,115,114,0,1,0,3
"2011","E00004621","E00004621","Total",133,37,18,19,2,58,54,4,36,35,0,1,0,0
"2011","E00004615","E00004615","Total",102,48,23,25,0,27,24,3,26,25,0,0,1,1
"2011","E00004616","E00004616","Total",133,54,14,40,1,25,14,11,52,49,0,3,0,1
"2011","E00004617","E00004617","Total",114,57,30,27,0,8,5,3,49,46,0,2,1,0
"2011","E00004618","E00004618","Total",125,43,14,29,0,40,28,12,42,40,0,2,0,0
"2011","E00004619","E00004619","Total",123,22,10,12,2,70,64,6,28,25,0,2,1,1
"2011","E00004620","E00004620","Total",141,29,11,18,0,60,32,28,52,51,0,1,0,0
"2011","E00004622","E00004622","Total",209,67,39,28,0,31,25,6,108,105,0,3,0,3
"2011","E00004833","E00004833","Total",156,45,22,23,0,39,23,16,71,71,0,0,0,1
"2011","E00004834","E00004834","Total",185,63,17,46,0,69,33,36,52,51,0,0,1,1
"2011","E00004836","E00004836","Total",171,29,10,19,0,66,36,30,74,73,0,0,1,2
"2011","E00004838","E00004838","Total",131,30,13,17,1,64,31,33,35,34,0,1,0,1
"2011","E00004839","E00004839","Total",178,41,12,29,4,56,14,42,74,71,0,3,0,3
"2011","E00004134","E00004134","Total",100,48,33,15,0,3,1,2,45,43,1,1,0,4
"2011","E00004136","E00004136","Total",110,55,31,24,0,2,2,0,52,49,1,2,0,1
"2011","E00004138","E00004138","Total",142,39,28,11,0,51,44,7,51,51,0,0,0,1
"2011","E00004139","E00004139","Total",140,9,3,6,0,113,104,9,17,15,0,0,2,1
"2011","E00004144","E00004144","Total",102,66,46,20,0,1,1,0,35,32,0,1,2,0
"2011","E00004146","E00004146","Total",126,52,28,24,0,17,12,5,55,54,0,1,0,2
"2011","E00004147","E00004147","Total",126,55,37,18,1,1,1,0,67,66,0,1,0,2
"2011","E00004148","E00004148","Total",106,63,40,23,0,1,1,0,41,40,1,0,0,1
"2011","E00004149","E00004149","Total",149,87,54,33,0,4,3,1,57,56,0,1,0,1
"2011","E00004151","E00004151","Total",148,82,35,47,0,2,1,1,62,62,0,0,0,2
"2011","E00004153","E00004153","Total",108,42,23,19,0,16,3,13,48,45,0,2,1,2
"2011","E00004158","E00004158","Total",124,24,10,14,0,68,59,9,31,29,0,2,0,1
"2011","E00004161","E00004161","Total",96,50,29,21,0,2,1,1,40,38,0,2,0,4
"2011","E00004157","E00004157","Total",94,46,24,22,0,3,0,3,42,42,0,0,0,3
"2011","E00004159","E00004159","Total",160,11,9,2,0,136,133,3,12,12,0,0,0,1
"2011","E00004160","E00004160","Total",103,10,4,6,0,86,68,18,5,5,0,0,0,2
"2011","E00004164","E00004164","Total",160,16,12,4,1,132,129,3,8,8,0,0,0,3
"2011","E00004167","E00004167","Total",99,75,46,29,2,2,1,1,20,17,0,3,0,0
"2011","E00004122","E00004122","Total",103,59,28,31,0,0,0,0,43,42,0,1,0,1
"2011","E00004123","E00004123","Total",108,65,33,32,0,7,2,5,32,21,11,0,0,4
"2011","E00004163","E00004163","Total",163,69,43,26,1,24,5,19,68,66,0,2,0,1
"2011","E00004165","E00004165","Total",146,16,7,9,0,116,115,1,14,13,0,1,0,0
"2011","E00004166","E00004166","Total",157,10,9,1,1,129,129,0,16,15,0,0,1,1
"2011","E00004249","E00004249","Total",114,48,19,29,0,21,16,5,44,38,0,6,0,1
"2011","E00004252","E00004252","Total",115,46,32,14,0,34,16,18,34,30,0,4,0,1
"2011","E00004255","E00004255","Total",128,46,23,23,0,42,25,17,38,37,0,1,0,2
"2011","E00004258","E00004258","Total",111,33,13,20,1,26,16,10,51,50,0,1,0,0
"2011","E00004279","E00004279","Total",134,42,10,32,0,56,19,37,34,30,0,4,0,2
"2011","E00004281","E00004281","Total",115,44,20,24,0,22,12,10,48,45,0,3,0,1
"2011","E00004246","E00004246","Total",121,42,15,27,1,42,25,17,33,31,0,0,2,3
"2011","E00004250","E00004250","Total",127,51,20,31,0,26,4,22,47,47,0,0,0,3
"2011","E00004251","E00004251","Total",95,59,34,25,0,18,10,8,17,14,0,3,0,1
"2011","E00004280","E00004280","Total",108,43,23,20,0,36,10,26,28,24,2,2,0,1
"2011","E00004253","E00004253","Total",132,32,12,20,1,53,50,3,44,44,0,0,0,2
"2011","E00004256","E00004256","Total",149,32,12,20,1,76,56,20,38,23,2,0,13,2
"2011","E00004259","E00004259","Total",104,9,3,6,1,82,64,18,10,8,0,1,1,2
"2011","E00004261","E00004261","Total",114,15,8,7,1,58,35,23,40,39,0,1,0,0
"2011","E00004264","E00004264","Total",176,38,11,27,5,37,5,32,96,92,0,3,1,0
"2011","E00004244","E00004244","Total",100,14,5,9,1,82,82,0,1,1,0,0,0,2
"2011","E00004257","E00004257","Total",113,34,17,17,2,32,24,8,44,43,0,1,0,1
"2011","E00004260","E00004260","Total",136,8,4,4,0,120,120,0,8,8,0,0,0,0
"2011","E00004262","E00004262","Total",114,9,2,7,0,100,97,3,5,5,0,0,0,0
"2011","E00004263","E00004263","Total",121,17,5,12,0,85,85,0,16,15,0,1,0,3
"2011","E00004270","E00004270","Total",189,35,18,17,1,52,36,16,100,92,0,8,0,1
"2011","E00004271","E00004271","Total",142,39,17,22,0,38,24,14,63,60,0,2,1,2
"2011","E00004275","E00004275","Total",104,33,13,20,0,27,18,9,44,42,0,1,1,0
"2011","E00004277","E00004277","Total",135,65,39,26,0,28,13,15,41,34,2,3,2,1
"2011","E00004278","E00004278","Total",102,32,17,15,0,30,21,9,38,37,0,1,0,2
"2011","E00174656","E00174656","Total",115,40,18,22,1,37,6,31,35,31,0,4,0,2
"2011","E00174657","E00174657","Total",100,38,9,29,0,27,4,23,31,28,0,3,0,4
"2011","E00174658","E00174658","Total",80,42,22,20,0,11,10,1,26,24,0,2,0,1
"2011","E00004776","E00004776","Total",138,38,15,23,0,27,11,16,72,67,0,2,3,1
"2011","E00004798","E00004798","Total",111,66,39,27,0,1,0,1,43,41,0,2,0,1
"2011","E00004799","E00004799","Total",142,60,27,33,0,7,6,1,71,71,0,0,0,4
"2011","E00004801","E00004801","Total",133,66,31,35,2,4,2,2,58,57,0,0,1,3
"2011","E00004802","E00004802","Total",108,49,25,24,0,5,5,0,54,54,0,0,0,0
"2011","E00004804","E00004804","Total",113,54,20,34,1,0,0,0,57,54,0,3,0,1
"2011","E00004785","E00004785","Total",123,23,7,16,0,74,73,1,22,20,2,0,0,4
"2011","E00004787","E00004787","Total",145,53,28,25,0,25,23,2,65,62,0,2,1,2
"2011","E00004791","E00004791","Total",106,22,10,12,0,56,17,39,27,25,0,2,0,1
"2011","E00004792","E00004792","Total",117,60,19,41,1,21,3,18,35,34,0,1,0,0
"2011","E00004793","E00004793","Total",121,64,34,30,0,4,3,1,49,47,0,1,1,4
"2011","E00004795","E00004795","Total",101,23,11,12,1,36,1,35,40,37,0,3,0,1
"2011","E00004766","E00004766","Total",121,70,42,28,0,12,9,3,38,34,0,4,0,1
"2011","E00004767","E00004767","Total",142,71,31,40,0,6,3,3,64,63,0,0,1,1
"2011","E00004769","E00004769","Total",151,64,24,40,0,12,7,5,74,72,0,0,2,1
"2011","E00004774","E00004774","Total",108,59,30,29,0,3,3,0,44,44,0,0,0,2
"2011","E00004803","E00004803","Total",82,20,11,9,1,32,7,25,27,24,0,3,0,2
"2011","E00004812","E00004812","Total",160,35,17,18,0,74,61,13,50,49,0,1,0,1
"2011","E00004768","E00004768","Total",99,46,20,26,0,2,2,0,50,49,0,1,0,1
"2011","E00004770","E00004770","Total",91,60,32,28,0,5,5,0,24,23,0,1,0,2
"2011","E00004775","E00004775","Total",113,69,34,35,0,2,2,0,41,40,0,1,0,1
"2011","E00004806","E00004806","Total",124,53,26,27,0,7,4,3,64,63,0,1,0,0
"2011","E00004810","E00004810","Total",126,75,48,27,0,4,3,1,47,45,0,2,0,0
"2011","E00004811","E00004811","Total",122,57,21,36,1,5,5,0,58,56,0,2,0,1
"2011","E00004842","E00004842","Total",116,47,17,30,1,30,26,4,38,36,0,1,1,0
"2011","E00004843","E00004843","Total",110,45,22,23,0,15,12,3,49,46,0,1,2,1
"2011","E00004844","E00004844","Total",139,64,31,33,0,27,18,9,47,47,0,0,0,1
"2011","E00004845","E00004845","Total",131,38,21,17,0,26,3,23,67,58,8,1,0,0
"2011","E00004846","E00004846","Total",127,55,28,27,0,21,6,15,49,47,0,1,1,2
"2011","E00004847","E00004847","Total",137,48,21,27,1,19,0,19,66,63,0,3,0,3
"2011","E00004786","E00004786","Total",107,52,39,13,0,1,0,1,47,47,0,0,0,7
"2011","E00004788","E00004788","Total",125,40,14,26,0,7,6,1,78,76,0,2,0,0
"2011","E00004789","E00004789","Total",87,5,2,3,0,36,32,4,44,44,0,0,0,2
"2011","E00004790","E00004790","Total",130,49,23,26,0,14,2,12,60,58,0,2,0,7
"2011","E00004796","E00004796","Total",132,41,17,24,1,8,8,0,81,80,0,1,0,1
"2011","E00004797","E00004797","Total",143,30,15,15,0,78,77,1,34,33,0,1,0,1
"2011","E00004809","E00004809","Total",117,67,46,21,0,1,1,0,42,39,1,2,0,7
"2011","E00004777","E00004777","Total",115,29,15,14,0,61,60,1,24,24,0,0,0,1
"2011","E00004781","E00004781","Total",134,37,17,20,6,26,23,3,61,57,0,3,1,4
"2011","E00004794","E00004794","Total",198,93,53,40,1,64,60,4,32,30,1,0,1,8
"2011","E00004805","E00004805","Total",96,11,3,8,0,63,61,2,20,20,0,0,0,2
"2011","E00004807","E00004807","Total",109,26,21,5,0,36,9,27,42,41,0,1,0,5
"2011","E00004778","E00004778","Total",105,58,42,16,0,2,1,1,38,35,0,1,2,7
"2011","E00004779","E00004779","Total",142,65,52,13,0,2,0,2,69,66,1,2,0,6
"2011","E00004780","E00004780","Total",124,40,32,8,0,1,0,1,65,62,2,1,0,18
"2011","E00004782","E00004782","Total",114,57,42,15,0,1,1,0,51,49,1,1,0,5
"2011","E00004808","E00004808","Total",93,23,14,9,2,2,0,2,66,61,0,3,2,0
"2011","E00174677","E00174677","Total",160,46,16,30,0,51,11,40,57,57,0,0,0,6
"2011","E00174678","E00174678","Total",113,29,18,11,0,12,11,1,60,55,1,1,3,12
"2011","E00004771","E00004771","Total",117,78,59,19,0,2,2,0,33,32,1,0,0,4
"2011","E00004772","E00004772","Total",124,80,55,25,1,2,2,0,38,35,0,1,2,3
"2011","E00004773","E00004773","Total",133,67,39,28,0,2,0,2,62,61,0,1,0,2
"2011","E00004783","E00004783","Total",124,52,28,24,2,47,46,1,21,19,2,0,0,2
"2011","E00004784","E00004784","Total",121,58,37,21,0,24,0,24,33,30,1,1,1,6
"2011","E00004215","E00004215","Total",129,73,42,31,0,7,6,1,49,46,0,3,0,0
"2011","E00004218","E00004218","Total",131,39,20,19,0,64,62,2,27,24,0,3,0,1
"2011","E00004220","E00004220","Total",87,18,9,9,1,59,59,0,8,8,0,0,0,1
"2011","E00004221","E00004221","Total",111,50,32,18,1,8,1,7,51,49,0,2,0,1
"2011","E00004222","E00004222","Total",109,38,21,17,0,24,7,17,46,44,0,1,1,1
"2011","E00004226","E00004226","Total",119,81,56,25,0,4,2,2,30,29,0,1,0,4
"2011","E00004206","E00004206","Total",127,29,15,14,0,86,75,11,12,10,0,2,0,0
"2011","E00004208","E00004208","Total",125,15,10,5,1,83,81,2,25,24,0,1,0,1
"2011","E00004209","E00004209","Total",113,22,8,14,0,49,45,4,41,36,0,3,2,1
"2011","E00004213","E00004213","Total",167,17,7,10,1,111,12,99,33,30,0,2,1,5
"2011","E00004214","E00004214","Total",243,55,19,36,6,115,8,107,63,61,0,2,0,4
"2011","E00004216","E00004216","Total",146,89,51,38,1,4,3,1,49,49,0,0,0,3
"2011","E00004217","E00004217","Total",141,55,28,27,1,20,17,3,64,59,0,4,1,1
"2011","E00004224","E00004224","Total",147,57,34,23,2,0,0,0,84,77,4,1,2,4
"2011","E00004228","E00004228","Total",107,59,38,21,1,14,10,4,33,33,0,0,0,0
"2011","E00004231","E00004231","Total",142,89,52,37,1,5,2,3,46,45,0,1,0,1
"2011","E00004233","E00004233","Total",124,43,28,15,1,44,4,40,32,30,0,2,0,4
"2011","E00004201","E00004201","Total",144,86,61,25,0,6,4,2,50,46,1,3,0,2
"2011","E00004202","E00004202","Total",160,2,1,1,0,148,12,136,8,6,0,0,2,2
"2011","E00004227","E00004227","Total",145,54,30,24,1,44,28,16,43,36,1,6,0,3
"2011","E00004232","E00004232","Total",132,27,21,6,0,81,1,80,20,19,0,1,0,4
"2011","E00004239","E00004239","Total",111,15,8,7,0,83,2,81,12,10,0,0,2,1
"2011","E00004242","E00004242","Total",105,22,16,6,2,19,9,10,59,24,28,1,6,3
"2011","E00004204","E00004204","Total",149,92,56,36,0,5,5,0,51,48,2,1,0,1
"2011","E00004229","E00004229","Total",174,88,46,42,0,21,1,20,60,55,1,2,2,5
"2011","E00004234","E00004234","Total",124,59,35,24,0,4,4,0,59,57,1,1,0,2
"2011","E00004238","E00004238","Total",126,79,47,32,0,12,12,0,32,30,0,2,0,3
"2011","E00004241","E00004241","Total",133,86,51,35,0,7,4,3,36,33,0,3,0,4
"2011","E00004243","E00004243","Total",110,76,48,28,0,3,0,3,30,29,0,1,0,1
"2011","E00004207","E00004207","Total",128,12,5,7,0,76,71,5,40,40,0,0,0,0
"2011","E00004210","E00004210","Total",126,17,7,10,0,96,94,2,13,12,0,1,0,0
"2011","E00004211","E00004211","Total",124,32,11,21,0,25,19,6,67,66,0,1,0,0
"2011","E00004212","E00004212","Total",134,61,37,24,1,30,9,21,41,36,0,4,1,1
"2011","E00004223","E00004223","Total",116,10,3,7,1,84,30,54,20,17,0,2,1,1
"2011","E00004219","E00004219","Total",190,79,36,43,0,23,19,4,87,86,0,0,1,1
"2011","E00004230","E00004230","Total",130,39,9,30,1,57,51,6,33,29,0,4,0,0
"2011","E00004236","E00004236","Total",150,30,14,16,0,57,43,14,62,55,0,5,2,1
"2011","E00004237","E00004237","Total",123,27,11,16,0,51,44,7,43,41,0,0,2,2
"2011","E00004240","E00004240","Total",136,29,16,13,1,41,26,15,62,55,0,6,1,3
"2011","E00004732","E00004732","Total",124,13,6,7,3,86,74,12,21,21,0,0,0,1
"2011","E00004733","E00004733","Total",131,39,7,32,9,35,11,24,48,45,0,2,1,0
"2011","E00004735","E00004735","Total",136,6,4,2,1,123,115,8,4,4,0,0,0,2
"2011","E00004736","E00004736","Total",130,27,18,9,0,36,8,28,65,62,0,2,1,2
"2011","E00004738","E00004738","Total",113,54,23,31,24,5,0,5,28,22,0,6,0,2
"2011","E00004739","E00004739","Total",131,39,17,22,2,6,1,5,82,76,0,6,0,2
"2011","E00004740","E00004740","Total",99,14,6,8,0,72,72,0,12,12,0,0,0,1
"2011","E00004741","E00004741","Total",132,19,5,14,5,71,61,10,34,30,0,4,0,3
"2011","E00004742","E00004742","Total",185,38,13,25,1,79,79,0,67,63,0,4,0,0
"2011","E00004750","E00004750","Total",144,11,4,7,14,57,37,20,61,61,0,0,0,1
"2011","E00174649","E00174649","Total",108,12,5,7,4,51,5,46,39,37,0,1,1,2
"2011","E00174666","E00174666","Total",80,5,2,3,49,19,4,15,7,6,0,0,1,0
"2011","E00174667","E00174667","Total",87,19,7,12,0,45,35,10,22,18,0,3,1,1
"2011","E00004743","E00004743","Total",136,32,16,16,1,74,74,0,29,29,0,0,0,0
"2011","E00004745","E00004745","Total",127,13,8,5,3,98,97,1,12,11,0,0,1,1
"2011","E00004746","E00004746","Total",152,23,5,18,2,108,107,1,17,17,0,0,0,2
"2011","E00004747","E00004747","Total",132,20,11,9,2,82,80,2,26,23,0,2,1,2
"2011","E00004748","E00004748","Total",151,20,7,13,0,87,84,3,44,44,0,0,0,0
"2011","E00004606","E00004606","Total",169,57,31,26,1,48,47,1,58,55,0,3,0,5
"2011","E00004608","E00004608","Total",133,30,13,17,0,69,67,2,31,28,1,2,0,3
"2011","E00004637","E00004637","Total",121,11,7,4,1,85,58,27,21,20,0,0,1,3
"2011","E00004642","E00004642","Total",130,15,8,7,1,109,107,2,5,4,0,0,1,0
"2011","E00004644","E00004644","Total",132,26,11,15,0,84,80,4,22,22,0,0,0,0
"2011","E00004607","E00004607","Total",132,7,4,3,0,112,46,66,13,11,0,1,1,0
"2011","E00004609","E00004609","Total",221,29,15,14,1,80,65,15,105,100,2,3,0,6
"2011","E00004610","E00004610","Total",123,25,10,15,0,58,57,1,39,33,0,3,3,1
"2011","E00004611","E00004611","Total",157,1,1,0,0,147,10,137,9,4,0,0,5,0
"2011","E00004640","E00004640","Total",146,34,11,23,2,60,57,3,49,48,0,1,0,1
"2011","E00004643","E00004643","Total",186,46,25,21,1,39,24,15,96,90,0,4,2,4
"2011","E00004645","E00004645","Total",111,37,5,32,0,0,0,0,73,70,0,3,0,1
"2011","E00004623","E00004623","Total",151,46,22,24,1,41,34,7,62,62,0,0,0,1
"2011","E00004624","E00004624","Total",120,61,22,39,1,12,12,0,45,45,0,0,0,1
"2011","E00004629","E00004629","Total",117,44,22,22,0,0,0,0,72,71,0,1,0,1
"2011","E00004631","E00004631","Total",130,34,14,20,1,54,50,4,40,39,0,0,1,1
"2011","E00004634","E00004634","Total",145,68,33,35,1,20,1,19,54,52,0,2,0,2
"2011","E00004638","E00004638","Total",158,37,19,18,1,16,3,13,103,100,0,2,1,1
"2011","E00004625","E00004625","Total",172,27,11,16,37,63,33,30,39,39,0,0,0,6
"2011","E00004626","E00004626","Total",235,36,22,14,11,65,23,42,108,100,3,2,3,15
"2011","E00004627","E00004627","Total",98,20,9,11,1,59,55,4,17,17,0,0,0,1
"2011","E00004633","E00004633","Total",102,15,6,9,1,75,70,5,11,11,0,0,0,0
"2011","E00004641","E00004641","Total",125,19,8,11,2,78,74,4,25,21,0,2,2,1
"2011","E00004628","E00004628","Total",91,10,5,5,0,72,48,24,9,9,0,0,0,0
"2011","E00004630","E00004630","Total",104,32,6,26,0,7,7,0,64,64,0,0,0,1
"2011","E00004632","E00004632","Total",95,8,7,1,1,78,43,35,7,6,0,1,0,1
"2011","E00004635","E00004635","Total",125,19,13,6,0,97,90,7,7,7,0,0,0,2
"2011","E00004636","E00004636","Total",113,9,2,7,0,97,93,4,5,4,0,0,1,2
"2011","E00004639","E00004639","Total",96,12,5,7,0,65,41,24,19,17,0,2,0,0
"2011","E00004203","E00004203","Total",164,43,26,17,0,17,15,2,99,92,3,3,1,5
"2011","E00004205","E00004205","Total",145,77,41,36,0,12,9,3,53,48,0,4,1,3
"2011","E00004225","E00004225","Total",195,9,4,5,4,45,12,33,130,125,1,2,2,7
"2011","E00004235","E00004235","Total",163,24,12,12,7,58,1,57,71,69,2,0,0,3
"2011","E00004681","E00004681","Total",133,38,24,14,1,15,1,14,72,63,0,1,8,7
"2011","E00004687","E00004687","Total",116,75,58,17,3,1,1,0,27,23,1,1,2,10
"2011","E00004690","E00004690","Total",109,29,21,8,1,46,46,0,29,26,0,1,2,4
"2011","E00004699","E00004699","Total",69,7,1,6,0,54,54,0,8,7,0,0,1,0
"2011","E00004701","E00004701","Total",147,21,18,3,1,81,3,78,41,36,0,0,5,3
"2011","E00004714","E00004714","Total",141,47,34,13,0,24,1,23,61,35,10,8,8,9
"2011","E00004704","E00004704","Total",162,21,7,14,0,49,13,36,91,87,0,4,0,1
"2011","E00004706","E00004706","Total",198,56,28,28,1,62,49,13,76,74,1,1,0,3
"2011","E00004707","E00004707","Total",228,38,21,17,2,6,3,3,178,176,1,0,1,4
"2011","E00004709","E00004709","Total",152,54,31,23,1,52,50,2,44,43,0,1,0,1
"2011","E00004710","E00004710","Total",131,37,11,26,2,60,38,22,32,31,0,1,0,0
"2011","E00004702","E00004702","Total",125,14,7,7,1,89,78,11,18,18,0,0,0,3
"2011","E00004703","E00004703","Total",143,41,24,17,0,52,47,5,48,46,0,2,0,2
"2011","E00004705","E00004705","Total",161,70,41,29,0,20,17,3,71,67,0,1,3,0
"2011","E00004708","E00004708","Total",118,37,21,16,0,38,33,5,43,41,0,0,2,0
"2011","E00004711","E00004711","Total",142,43,14,29,1,50,42,8,46,44,0,2,0,2
"2011","E00004712","E00004712","Total",157,79,53,26,0,34,6,28,34,24,4,0,6,10
"2011","E00004749","E00004749","Total",178,15,8,7,1,118,107,11,42,40,0,2,0,2
"2011","E00004752","E00004752","Total",127,38,17,21,0,74,59,15,15,15,0,0,0,0
"2011","E00004753","E00004753","Total",125,14,5,9,0,83,83,0,27,26,0,1,0,1
"2011","E00004754","E00004754","Total",134,21,7,14,1,60,59,1,49,47,1,1,0,3
"2011","E00004755","E00004755","Total",111,13,8,5,0,76,75,1,15,13,0,2,0,7
"2011","E00004723","E00004723","Total",114,21,11,10,0,71,70,1,20,19,0,1,0,2
"2011","E00004734","E00004734","Total",109,18,6,12,0,78,75,3,13,12,0,0,1,0
"2011","E00004744","E00004744","Total",126,24,6,18,0,80,79,1,21,21,0,0,0,1
"2011","E00004751","E00004751","Total",147,25,12,13,1,101,97,4,18,17,0,0,1,2
"2011","E00004763","E00004763","Total",110,17,6,11,1,66,66,0,23,21,0,1,1,3
"2011","E00004765","E00004765","Total",102,18,3,15,0,68,67,1,14,13,0,1,0,2
"2011","E00004725","E00004725","Total",126,13,8,5,0,102,100,2,9,8,0,1,0,2
"2011","E00004756","E00004756","Total",112,8,6,2,0,73,48,25,27,26,0,1,0,4
"2011","E00004757","E00004757","Total",116,15,10,5,1,89,88,1,11,11,0,0,0,0
"2011","E00004758","E00004758","Total",80,8,7,1,0,65,63,2,7,7,0,0,0,0
"2011","E00004759","E00004759","Total",104,13,5,8,0,81,54,27,10,8,0,1,1,0
"2011","E00004760","E00004760","Total",104,6,5,1,0,98,6,92,0,0,0,0,0,0
"2011","E00004726","E00004726","Total",117,8,0,8,2,91,28,63,14,13,0,1,0,2
"2011","E00004729","E00004729","Total",101,4,2,2,0,88,27,61,6,5,1,0,0,3
"2011","E00004730","E00004730","Total",77,0,0,0,0,76,6,70,1,1,0,0,0,0
"2011","E00004761","E00004761","Total",136,3,0,3,0,130,24,106,1,1,0,0,0,2
"2011","E00004762","E00004762","Total",133,5,3,2,0,109,9,100,16,15,0,0,1,3
"2011","E00004764","E00004764","Total",93,15,5,10,1,58,43,15,18,15,0,3,0,1
"2011","E00004724","E00004724","Total",126,14,2,12,1,53,49,4,52,49,0,2,1,6
"2011","E00004727","E00004727","Total",125,7,1,6,2,87,43,44,27,26,0,1,0,2
"2011","E00004728","E00004728","Total",199,24,6,18,1,143,120,23,27,22,1,3,1,4
"2011","E00004731","E00004731","Total",158,29,19,10,0,70,38,32,58,54,0,1,3,1
"2011","E00004691","E00004691","Total",151,21,7,14,0,56,53,3,74,70,0,4,0,0
"2011","E00004692","E00004692","Total",141,18,7,11,1,64,64,0,58,56,0,2,0,0
"2011","E00004693","E00004693","Total",138,28,16,12,2,67,58,9,38,37,0,1,0,3
"2011","E00004696","E00004696","Total",126,18,16,2,0,87,83,4,20,19,0,1,0,1
"2011","E00004700","E00004700","Total",111,17,6,11,0,79,43,36,12,12,0,0,0,3
"2011","E00004694","E00004694","Total",108,25,9,16,1,35,22,13,46,45,0,1,0,1
"2011","E00004695","E00004695","Total",179,27,13,14,0,57,50,7,92,87,0,2,3,3
"2011","E00004697","E00004697","Total",135,16,9,7,0,71,50,21,45,40,0,4,1,3
"2011","E00174654","E00174654","Total",98,19,13,6,1,36,11,25,38,34,0,4,0,4
"2011","E00174680","E00174680","Total",91,11,6,5,1,60,58,2,19,18,0,1,0,0
"2011","E00004684","E00004684","Total",132,4,2,2,0,103,33,70,25,23,0,1,1,0
"2011","E00004713","E00004713","Total",93,1,1,0,0,88,3,85,4,4,0,0,0,0
"2011","E00004715","E00004715","Total",145,19,8,11,6,107,34,73,10,7,0,2,1,3
"2011","E00004717","E00004717","Total",72,9,7,2,0,51,5,46,11,10,0,0,1,1
"2011","E00004719","E00004719","Total",179,23,12,11,1,133,82,51,21,18,0,2,1,1
"2011","E00004720","E00004720","Total",118,1,1,0,0,109,2,107,8,7,0,0,1,0
"2011","E00004682","E00004682","Total",64,6,2,4,0,48,48,0,10,10,0,0,0,0
"2011","E00004716","E00004716","Total",127,26,10,16,0,73,72,1,28,24,0,4,0,0
"2011","E00004718","E00004718","Total",119,4,1,3,0,92,91,1,19,19,0,0,0,4
"2011","E00004721","E00004721","Total",133,16,5,11,0,88,87,1,26,23,0,1,2,3
"2011","E00004722","E00004722","Total",107,23,14,9,0,68,67,1,13,13,0,0,0,3
"2011","E00004683","E00004683","Total",68,9,3,6,0,48,37,11,9,8,0,1,0,2
"2011","E00004685","E00004685","Total",122,15,4,11,2,81,77,4,22,20,1,1,0,2
"2011","E00004686","E00004686","Total",123,26,16,10,1,70,69,1,26,24,0,2,0,0
"2011","E00004688","E00004688","Total",174,21,10,11,3,125,123,2,24,23,0,1,0,1
"2011","E00004689","E00004689","Total",116,32,19,13,0,61,60,1,21,21,0,0,0,2
"2011","E00004651","E00004651","Total",106,42,21,21,1,21,1,20,38,36,0,2,0,4
"2011","E00004655","E00004655","Total",125,35,21,14,0,46,37,9,41,38,0,1,2,3
"2011","E00004671","E00004671","Total",170,14,4,10,3,114,33,81,35,34,0,1,0,4
"2011","E00174660","E00174660","Total",51,8,5,3,1,33,14,19,9,7,0,1,1,0
"2011","E00174661","E00174661","Total",84,11,7,4,0,57,21,36,15,13,0,1,1,1
"2011","E00004647","E00004647","Total",168,18,9,9,1,70,51,19,73,72,0,1,0,6
"2011","E00004659","E00004659","Total",165,11,1,10,0,62,27,35,90,90,0,0,0,2
"2011","E00004660","E00004660","Total",128,17,9,8,0,88,27,61,19,18,0,1,0,4
"2011","E00004661","E00004661","Total",129,22,14,8,2,65,37,28,38,38,0,0,0,2
"2011","E00004664","E00004664","Total",147,10,6,4,0,67,14,53,68,66,0,1,1,2
"2011","E00004658","E00004658","Total",114,18,8,10,0,65,55,10,22,21,0,0,1,9
"2011","E00004663","E00004663","Total",118,15,8,7,1,76,70,6,23,21,0,2,0,3
"2011","E00004669","E00004669","Total",105,4,3,1,1,70,54,16,26,26,0,0,0,4
"2011","E00004670","E00004670","Total",109,14,7,7,0,73,43,30,20,20,0,0,0,2
"2011","E00004656","E00004656","Total",233,11,4,7,1,147,27,120,66,46,0,0,20,8
"2011","E00004668","E00004668","Total",84,2,2,0,0,80,8,72,1,1,0,0,0,1
"2011","E00004675","E00004675","Total",105,14,7,7,1,83,53,30,6,5,0,1,0,1
"2011","E00004677","E00004677","Total",112,19,9,10,0,42,40,2,46,43,0,3,0,5
"2011","E00004175","E00004175","Total",128,20,12,8,0,76,74,2,31,29,0,2,0,1
"2011","E00004179","E00004179","Total",190,32,20,12,0,143,143,0,9,8,0,1,0,6
"2011","E00004180","E00004180","Total",128,18,7,11,1,42,37,5,63,61,1,1,0,4
"2011","E00004181","E00004181","Total",212,39,25,14,1,150,146,4,20,13,0,4,3,2
"2011","E00004182","E00004182","Total",76,31,17,14,1,25,2,23,19,18,1,0,0,0
"2011","E00004183","E00004183","Total",106,4,1,3,1,94,5,89,7,6,0,0,1,0
"2011","E00004653","E00004653","Total",113,41,23,18,0,0,0,0,69,65,1,2,1,3
"2011","E00004654","E00004654","Total",100,6,2,4,0,4,0,4,87,86,0,1,0,3
"2011","E00004678","E00004678","Total",127,25,17,8,0,66,58,8,32,29,0,2,1,4
"2011","E00174665","E00174665","Total",113,23,15,8,0,37,34,3,47,42,0,1,4,6
"2011","E00174679","E00174679","Total",49,8,5,3,0,17,1,16,23,14,0,1,8,1
"2011","E00004646","E00004646","Total",110,17,7,10,0,78,49,29,13,11,0,2,0,2
"2011","E00004665","E00004665","Total",117,7,4,3,0,103,24,79,5,5,0,0,0,2
"2011","E00004673","E00004673","Total",126,9,3,6,0,100,53,47,15,13,0,1,1,2
"2011","E00004674","E00004674","Total",102,13,8,5,0,77,77,0,11,8,0,1,2,1
"2011","E00004679","E00004679","Total",102,10,4,6,0,71,71,0,18,17,0,1,0,3
"2011","E00004662","E00004662","Total",144,33,22,11,0,68,68,0,40,36,0,4,0,3
"2011","E00004666","E00004666","Total",178,22,9,13,0,76,73,3,73,69,0,2,2,7
"2011","E00004667","E00004667","Total",126,51,35,16,1,1,1,0,69,66,0,3,0,4
"2011","E00004672","E00004672","Total",120,43,25,18,1,11,8,3,62,60,0,2,0,3
"2011","E00004676","E00004676","Total",118,57,42,15,0,2,1,1,55,50,1,4,0,4
"2011","E00004649","E00004649","Total",129,43,25,18,0,11,4,7,71,67,1,2,1,4
"2011","E00004650","E00004650","Total",208,35,16,19,0,69,2,67,100,99,1,0,0,4
"2011","E00004652","E00004652","Total",133,29,16,13,0,66,64,2,35,35,0,0,0,3
"2011","E00004680","E00004680","Total",126,48,35,13,0,4,1,3,64,60,2,2,0,10
"2011","E00004172","E00004172","Total",148,46,31,15,1,58,52,6,41,32,3,5,1,2
"2011","E00004193","E00004193","Total",119,23,17,6,1,38,11,27,52,42,2,1,7,5
"2011","E00004195","E00004195","Total",133,22,13,9,1,13,3,10,94,88,1,2,3,3
"2011","E00004196","E00004196","Total",101,52,35,17,1,3,1,2,40,37,0,3,0,5
"2011","E00004199","E00004199","Total",163,28,17,11,1,7,0,7,124,115,8,1,0,3
"2011","E00004187","E00004187","Total",226,74,39,35,0,31,16,15,115,112,0,2,1,6
"2011","E00004194","E00004194","Total",144,52,34,18,0,13,13,0,76,74,1,1,0,3
"2011","E00004198","E00004198","Total",182,36,20,16,2,31,20,11,107,98,2,5,2,6
"2011","E00004200","E00004200","Total",136,24,7,17,1,32,10,22,78,70,4,2,2,1
"2011","E00174650","E00174650","Total",92,17,9,8,0,15,10,5,56,48,1,3,4,4
"2011","E00174651","E00174651","Total",81,15,4,11,1,25,20,5,34,31,2,1,0,6
"2011","E00004173","E00004173","Total",127,46,40,6,0,31,11,20,47,41,0,2,4,3
"2011","E00004177","E00004177","Total",74,20,13,7,0,3,1,2,46,43,0,2,1,5
"2011","E00004184","E00004184","Total",112,17,8,9,1,65,43,22,26,22,0,4,0,3
"2011","E00174655","E00174655","Total",160,66,53,13,0,16,5,11,73,66,0,4,3,5
"2011","E00174676","E00174676","Total",152,8,7,1,0,39,0,39,105,93,1,0,11,0
"2011","E00004174","E00004174","Total",131,18,7,11,0,71,68,3,39,36,2,1,0,3
"2011","E00004185","E00004185","Total",171,16,7,9,0,80,27,53,68,60,0,4,4,7
"2011","E00004188","E00004188","Total",109,44,27,17,0,2,1,1,60,57,0,1,2,3
"2011","E00004189","E00004189","Total",118,27,19,8,0,5,2,3,78,74,1,3,0,8
"2011","E00174652","E00174652","Total",84,33,8,25,2,31,31,0,14,13,0,1,0,4
"2011","E00174653","E00174653","Total",105,31,17,14,0,54,54,0,14,9,1,4,0,6
"2011","E00004544","E00004544","Total",98,13,7,6,2,67,61,6,16,15,0,1,0,0
"2011","E00004548","E00004548","Total",138,35,17,18,1,55,3,52,42,38,0,2,2,5
"2011","E00004550","E00004550","Total",146,23,12,11,0,80,68,12,40,33,5,2,0,3
"2011","E00004552","E00004552","Total",126,11,5,6,1,88,84,4,26,21,0,3,2,0
"2011","E00004555","E00004555","Total",127,26,9,17,0,85,85,0,14,13,0,1,0,2
"2011","E00004534","E00004534","Total",114,0,0,0,1,103,10,93,5,5,0,0,0,5
"2011","E00004536","E00004536","Total",138,87,43,44,0,1,0,1,45,42,0,3,0,5
"2011","E00004539","E00004539","Total",79,13,4,9,0,49,46,3,17,15,0,2,0,0
"2011","E00004542","E00004542","Total",178,33,14,19,0,82,81,1,62,61,0,1,0,1
"2011","E00004547","E00004547","Total",164,37,17,20,1,65,57,8,57,55,0,1,1,4
"2011","E00004551","E00004551","Total",208,82,38,44,0,38,1,37,84,80,0,4,0,4
"2011","E00004520","E00004520","Total",140,14,7,7,0,105,75,30,21,18,0,3,0,0
"2011","E00004538","E00004538","Total",103,1,1,0,0,88,1,87,12,12,0,0,0,2
"2011","E00004541","E00004541","Total",113,4,1,3,0,98,33,65,9,8,0,1,0,2
"2011","E00004545","E00004545","Total",199,19,4,15,0,151,145,6,25,24,0,0,1,4
"2011","E00004549","E00004549","Total",124,15,3,12,0,90,89,1,17,17,0,0,0,2
"2011","E00004553","E00004553","Total",113,18,8,10,0,66,30,36,27,25,0,1,1,2
"2011","E00004557","E00004557","Total",121,22,10,12,0,82,81,1,16,16,0,0,0,1
"2011","E00004531","E00004531","Total",119,30,14,16,0,56,40,16,33,30,0,3,0,0
"2011","E00004532","E00004532","Total",168,53,31,22,0,23,4,19,89,81,3,3,2,3
"2011","E00004537","E00004537","Total",85,20,10,10,0,42,34,8,23,22,0,1,0,0
"2011","E00004540","E00004540","Total",156,30,13,17,0,98,73,25,21,19,0,0,2,7
"2011","E00004543","E00004543","Total",126,9,4,5,0,51,2,49,64,58,1,1,4,2
"2011","E00174671","E00174671","Total",87,39,17,22,0,10,3,7,36,36,0,0,0,2
"2011","E00174674","E00174674","Total",88,10,7,3,0,4,3,1,68,68,0,0,0,6
"2011","E00174675","E00174675","Total",117,32,20,12,0,31,23,8,49,44,1,3,1,5
"2011","E00004169","E00004169","Total",149,41,29,12,1,33,0,33,72,55,3,5,9,2
"2011","E00004190","E00004190","Total",384,273,161,112,2,3,1,2,81,67,0,14,0,25
"2011","E00004197","E00004197","Total",116,49,30,19,0,12,3,9,53,47,0,6,0,2
"2011","E00174659","E00174659","Total",161,25,14,11,1,49,0,49,80,68,1,7,4,6
"2011","E00174662","E00174662","Total",90,1,1,0,0,10,1,9,79,67,10,0,2,0
"2011","E00174663","E00174663","Total",111,14,7,7,2,26,2,24,66,61,2,1,2,3
"2011","E00174664","E00174664","Total",100,9,6,3,0,52,1,51,38,30,5,0,3,1
"2011","E00004521","E00004521","Total",127,65,33,32,0,22,3,19,38,34,3,1,0,2
"2011","E00004524","E00004524","Total",216,50,29,21,1,13,0,13,141,107,2,3,29,11
"2011","E00004535","E00004535","Total",124,48,31,17,0,13,4,9,57,54,2,1,0,6
"2011","E00004546","E00004546","Total",143,38,20,18,0,67,56,11,35,32,0,1,2,3
"2011","E00004554","E00004554","Total",217,61,31,30,1,21,6,15,123,119,0,4,0,11
"2011","E00004556","E00004556","Total",143,16,6,10,0,69,64,5,56,51,0,2,3,2
"2011","E00004525","E00004525","Total",119,16,10,6,1,58,4,54,39,37,0,0,2,5
"2011","E00004527","E00004527","Total",102,20,9,11,1,43,37,6,34,34,0,0,0,4
"2011","E00004528","E00004528","Total",170,51,21,30,0,62,48,14,54,54,0,0,0,3
"2011","E00004558","E00004558","Total",142,55,39,16,3,46,44,2,35,34,0,1,0,3
"2011","E00004559","E00004559","Total",153,48,30,18,0,62,49,13,40,39,0,1,0,3
"2011","E00004560","E00004560","Total",121,28,15,13,0,72,26,46,20,19,0,0,1,1
"2011","E00004561","E00004561","Total",128,18,10,8,3,38,19,19,66,63,0,3,0,3
"2011","E00004522","E00004522","Total",117,30,19,11,0,20,12,8,62,59,3,0,0,5
"2011","E00004523","E00004523","Total",244,58,25,33,14,97,31,66,75,72,0,3,0,0
"2011","E00004526","E00004526","Total",125,13,5,8,1,95,72,23,14,11,1,1,1,2
"2011","E00004529","E00004529","Total",207,56,27,29,0,45,1,44,96,94,1,1,0,10
"2011","E00004530","E00004530","Total",141,25,11,14,1,48,15,33,65,63,0,2,0,2
"2011","E00000001","E00000001","Total",99,70,51,19,2,13,13,0,12,10,0,2,0,2
"2011","E00000003","E00000003","Total",112,92,64,28,0,1,0,1,17,16,0,1,0,2
"2011","E00000005","E00000005","Total",217,131,83,48,0,13,9,4,66,60,0,6,0,7
"2011","E00000007","E00000007","Total",83,30,18,12,0,0,0,0,42,40,0,2,0,11
"2011","E00166756","E00166756","Total",158,68,37,31,0,4,2,2,82,79,1,1,1,4
"2011","E00166758","E00166758","Total",207,142,102,40,1,10,9,1,45,42,0,3,0,9
"2011","E00000016","E00000016","Total",182,115,76,39,3,7,7,0,55,53,0,2,0,2
"2011","E00000017","E00000017","Total",142,96,54,42,1,15,11,4,25,25,0,0,0,5
"2011","E00000018","E00000018","Total",122,85,58,27,0,6,6,0,22,21,0,0,1,9
"2011","E00000019","E00000019","Total",85,47,25,22,2,6,6,0,26,23,0,2,1,4
"2011","E00000020","E00000020","Total",126,83,47,36,2,5,5,0,35,33,0,2,0,1
"2011","E00000021","E00000021","Total",173,101,54,47,0,9,9,0,56,51,0,4,1,7
"2011","E00000010","E00000010","Total",78,19,6,13,1,45,37,8,13,12,1,0,0,0
"2011","E00000012","E00000012","Total",137,37,22,15,0,78,70,8,20,18,0,1,1,2
"2011","E00000013","E00000013","Total",96,62,39,23,0,4,3,1,28,27,0,0,1,2
"2011","E00000014","E00000014","Total",132,40,24,16,0,62,53,9,29,27,0,0,2,1
"2011","E00000022","E00000022","Total",110,53,26,27,0,44,40,4,12,11,0,1,0,1
"2011","E00000023","E00000023","Total",90,34,19,15,0,43,35,8,9,9,0,0,0,4
"2011","E00166759","E00166759","Total",174,82,48,34,0,19,1,18,66,62,0,3,1,7
"2011","E00000029","E00000029","Total",127,18,9,9,0,48,6,42,58,53,0,3,2,3
"2011","E00000030","E00000030","Total",124,14,6,8,0,82,70,12,27,23,0,1,3,1
"2011","E00000031","E00000031","Total",77,13,8,5,0,50,45,5,11,11,0,0,0,3
"2011","E00000032","E00000032","Total",139,1,1,0,0,132,12,120,5,5,0,0,0,1
"2011","E00000024","E00000024","Total",147,44,22,22,0,2,0,2,77,75,0,1,1,24
"2011","E00000035","E00000035","Total",150,46,16,30,0,2,0,2,89,85,1,3,0,13
"2011","E00166755","E00166755","Total",141,25,16,9,0,4,4,0,80,74,4,0,2,32
"2011","E00166757","E00166757","Total",238,77,50,27,1,3,1,2,141,124,1,12,4,16
"2011","E00000025","E00000025","Total",219,63,39,24,0,9,2,7,124,94,2,6,22,23
"2011","E00000026","E00000026","Total",163,65,27,38,0,2,0,2,88,85,1,2,0,8
"2011","E00000027","E00000027","Total",227,80,35,45,0,7,2,5,131,125,3,1,2,9
"2011","E00000028","E00000028","Total",110,22,11,11,0,0,0,0,82,78,2,2,0,6
"2011","E00009023","E00009023","Total",104,9,4,5,0,8,4,4,86,86,0,0,0,1
"2011","E00009027","E00009027","Total",152,70,46,24,1,24,7,17,54,48,0,6,0,3
"2011","E00009033","E00009033","Total",164,46,16,30,0,43,10,33,75,71,0,2,2,0
"2011","E00009042","E00009042","Total",138,11,8,3,0,5,0,5,120,117,0,3,0,2
"2011","E00009012","E00009012","Total",124,40,24,16,1,50,5,45,30,30,0,0,0,3
"2011","E00009022","E00009022","Total",177,46,30,16,0,46,11,35,82,80,0,2,0,3
"2011","E00009030","E00009030","Total",155,44,20,24,1,54,13,41,54,50,0,4,0,2
"2011","E00009036","E00009036","Total",154,37,21,16,0,29,12,17,84,82,0,2,0,4
"2011","E00009034","E00009034","Total",111,40,21,19,0,16,10,6,54,53,0,1,0,1
"2011","E00009035","E00009035","Total",124,34,12,22,22,20,7,13,45,44,0,1,0,3
"2011","E00009039","E00009039","Total",101,19,6,13,1,43,35,8,33,31,0,1,1,5
"2011","E00176225","E00176225","Total",117,16,4,12,40,40,3,37,19,18,0,1,0,2
"2011","E00176296","E00176296","Total",106,36,19,17,1,9,7,2,58,57,0,0,1,2
"2011","E00009087","E00009087","Total",109,27,11,16,0,54,51,3,27,26,0,1,0,1
"2011","E00009088","E00009088","Total",186,26,12,14,34,99,54,45,25,24,0,1,0,2
"2011","E00009089","E00009089","Total",110,34,14,20,5,20,8,12,51,46,0,5,0,0
"2011","E00009093","E00009093","Total",133,56,37,19,0,20,10,10,56,54,0,2,0,1
"2011","E00009086","E00009086","Total",91,23,10,13,1,18,8,10,49,47,0,2,0,0
"2011","E00009090","E00009090","Total",133,62,29,33,0,15,9,6,54,53,0,1,0,2
"2011","E00009091","E00009091","Total",99,48,31,17,0,10,4,6,41,36,0,4,1,0
"2011","E00009092","E00009092","Total",105,24,12,12,3,13,4,9,65,64,0,1,0,0
"2011","E00008537","E00008537","Total",150,13,8,5,0,111,63,48,23,22,0,0,1,3
"2011","E00008542","E00008542","Total",109,23,6,17,1,63,63,0,21,21,0,0,0,1
"2011","E00008543","E00008543","Total",75,9,2,7,8,31,24,7,24,24,0,0,0,3
"2011","E00008544","E00008544","Total",128,13,2,11,0,106,104,2,9,9,0,0,0,0
"2011","E00008546","E00008546","Total",170,44,19,25,12,66,50,16,47,47,0,0,0,1
"2011","E00009015","E00009015","Total",95,11,4,7,0,71,70,1,13,12,0,1,0,0
"2011","E00009018","E00009018","Total",116,10,5,5,0,94,94,0,11,11,0,0,0,1
"2011","E00009021","E00009021","Total",71,4,2,2,0,53,53,0,14,13,1,0,0,0
"2011","E00009037","E00009037","Total",201,21,6,15,1,152,37,115,20,20,0,0,0,7
"2011","E00009044","E00009044","Total",163,13,7,6,14,87,59,28,49,49,0,0,0,0
"2011","E00009011","E00009011","Total",79,3,1,2,0,66,63,3,10,9,0,0,1,0
"2011","E00009016","E00009016","Total",167,13,5,8,1,125,116,9,27,26,0,0,1,1
"2011","E00009025","E00009025","Total",119,18,7,11,0,81,79,2,19,19,0,0,0,1
"2011","E00009029","E00009029","Total",160,20,14,6,2,84,82,2,52,49,0,1,2,2
"2011","E00008540","E00008540","Total",59,8,3,5,1,46,45,1,4,4,0,0,0,0
"2011","E00008541","E00008541","Total",64,6,3,3,2,37,33,4,19,17,0,1,1,0
"2011","E00008576","E00008576","Total",99,10,1,9,0,71,64,7,17,16,0,0,1,1
"2011","E00008577","E00008577","Total",119,9,5,4,0,95,91,4,14,14,0,0,0,1
"2011","E00008578","E00008578","Total",83,14,4,10,1,27,4,23,36,31,1,4,0,5
"2011","E00176228","E00176228","Total",157,16,6,10,2,110,105,5,28,28,0,0,0,1
"2011","E00176232","E00176232","Total",179,12,6,6,0,146,137,9,18,18,0,0,0,3
"2011","E00009000","E00009000","Total",130,42,16,26,1,18,8,10,63,59,0,4,0,6
"2011","E00009003","E00009003","Total",117,43,29,14,0,26,15,11,47,47,0,0,0,1
"2011","E00009005","E00009005","Total",121,47,26,21,8,30,25,5,36,36,0,0,0,0
"2011","E00009006","E00009006","Total",117,41,13,28,0,11,5,6,65,63,0,1,1,0
"2011","E00008972","E00008972","Total",109,30,12,18,0,38,12,26,38,34,0,4,0,3
"2011","E00008974","E00008974","Total",161,56,29,27,0,50,14,36,52,46,0,4,2,3
"2011","E00008977","E00008977","Total",93,11,1,10,0,74,34,40,8,7,0,1,0,0
"2011","E00008981","E00008981","Total",108,18,5,13,0,72,68,4,17,15,0,2,0,1
"2011","E00008975","E00008975","Total",121,46,14,32,0,47,39,8,28,27,0,1,0,0
"2011","E00008978","E00008978","Total",110,19,10,9,0,35,32,3,56,55,0,1,0,0
"2011","E00008987","E00008987","Total",97,22,7,15,0,32,13,19,43,42,0,1,0,0
"2011","E00009004","E00009004","Total",136,62,42,20,0,17,8,9,54,51,0,3,0,3
"2011","E00009031","E00009031","Total",139,20,9,11,0,95,63,32,24,23,0,0,1,0
"2011","E00009038","E00009038","Total",125,26,14,12,1,68,64,4,30,27,0,3,0,0
"2011","E00009040","E00009040","Total",133,33,13,20,1,58,15,43,41,40,0,0,1,0
"2011","E00009041","E00009041","Total",122,44,14,30,0,35,11,24,42,36,0,5,1,1
"2011","E00009043","E00009043","Total",174,48,21,27,0,32,9,23,93,91,0,2,0,1
"2011","E00009014","E00009014","Total",135,14,7,7,2,108,100,8,10,10,0,0,0,1
"2011","E00009017","E00009017","Total",166,40,11,29,0,67,17,50,58,53,0,3,2,1
"2011","E00009019","E00009019","Total",129,47,19,28,1,41,12,29,40,39,0,0,1,0
"2011","E00009024","E00009024","Total",109,29,12,17,3,24,7,17,49,45,0,2,2,4
"2011","E00009032","E00009032","Total",75,6,2,4,1,38,8,30,29,27,0,0,2,1
"2011","E00008585","E00008585","Total",125,21,6,15,2,80,11,69,19,18,0,0,1,3
"2011","E00008586","E00008586","Total",139,38,23,15,0,48,18,30,53,48,1,3,1,0
"2011","E00008587","E00008587","Total",146,58,30,28,0,20,4,16,67,61,0,6,0,1
"2011","E00008594","E00008594","Total",163,39,19,20,0,36,15,21,87,84,0,1,2,1
"2011","E00008588","E00008588","Total",103,23,7,16,0,60,6,54,19,18,0,1,0,1
"2011","E00008589","E00008589","Total",163,30,12,18,0,73,17,56,58,56,0,2,0,2
"2011","E00008591","E00008591","Total",125,17,5,12,0,84,11,73,21,20,1,0,0,3
"2011","E00008593","E00008593","Total",73,19,7,12,0,37,8,29,17,16,0,1,0,0
"2011","E00008973","E00008973","Total",165,8,6,2,10,116,12,104,30,29,0,1,0,1
"2011","E00009001","E00009001","Total",114,12,8,4,1,68,7,61,33,31,0,2,0,0
"2011","E00009002","E00009002","Total",119,28,9,19,2,6,4,2,80,77,0,3,0,3
"2011","E00009007","E00009007","Total",125,18,10,8,0,98,62,36,9,9,0,0,0,0
"2011","E00009008","E00009008","Total",120,2,0,2,1,99,10,89,17,16,0,1,0,1
"2011","E00009094","E00009094","Total",106,14,6,8,1,72,66,6,18,17,0,1,0,1
"2011","E00009096","E00009096","Total",81,45,27,18,0,8,2,6,25,24,0,0,1,3
"2011","E00009100","E00009100","Total",94,8,1,7,1,78,43,35,6,6,0,0,0,1
"2011","E00176252","E00176252","Total",140,32,5,27,0,48,44,4,58,58,0,0,0,2
"2011","E00176297","E00176297","Total",118,21,10,11,0,65,52,13,29,28,0,1,0,3
"2011","E00009085","E00009085","Total",99,28,11,17,0,10,2,8,61,61,0,0,0,0
"2011","E00009095","E00009095","Total",58,5,2,3,0,22,19,3,31,30,0,1,0,0
"2011","E00009097","E00009097","Total",147,24,12,12,12,71,39,32,36,34,0,1,1,4
"2011","E00009098","E00009098","Total",131,24,12,12,0,75,73,2,24,23,0,1,0,8
"2011","E00009099","E00009099","Total",150,38,19,19,1,51,38,13,53,52,0,1,0,7
"2011","E00008584","E00008584","Total",180,77,37,40,5,29,1,28,66,63,0,3,0,3
"2011","E00008600","E00008600","Total",165,42,16,26,1,33,12,21,87,85,0,2,0,2
"2011","E00008604","E00008604","Total",169,48,18,30,1,39,4,35,80,79,0,1,0,1
"2011","E00008605","E00008605","Total",157,60,33,27,0,30,10,20,64,61,0,3,0,3
"2011","E00008579","E00008579","Total",166,25,13,12,14,72,7,65,53,51,1,1,0,2
"2011","E00008582","E00008582","Total",236,94,25,69,40,38,4,34,63,58,0,5,0,1
"2011","E00008598","E00008598","Total",150,67,16,51,3,20,5,15,60,56,0,3,1,0
"2011","E00008607","E00008607","Total",159,63,17,46,0,13,5,8,83,79,0,2,2,0
"2011","E00176256","E00176256","Total",133,12,6,6,2,13,10,3,102,101,0,1,0,4
"2011","E00176327","E00176327","Total",136,28,12,16,3,14,10,4,90,87,1,1,1,1
"2011","E00008581","E00008581","Total",141,48,24,24,0,30,6,24,62,56,0,6,0,1
"2011","E00008590","E00008590","Total",157,53,21,32,0,38,19,19,59,56,0,3,0,7
"2011","E00008592","E00008592","Total",131,35,24,11,0,35,22,13,61,56,0,4,1,0
"2011","E00008596","E00008596","Total",144,59,21,38,0,33,11,22,50,47,0,3,0,2
"2011","E00008809","E00008809","Total",152,52,21,31,2,39,6,33,58,56,0,2,0,1
"2011","E00008810","E00008810","Total",158,57,16,41,1,39,11,28,56,54,1,1,0,5
"2011","E00008811","E00008811","Total",150,47,21,26,0,35,19,16,67,62,0,5,0,1
"2011","E00008813","E00008813","Total",120,55,21,34,1,24,2,22,40,39,0,1,0,0
"2011","E00008816","E00008816","Total",139,54,13,41,2,42,29,13,40,40,0,0,0,1
"2011","E00008812","E00008812","Total",136,33,15,18,0,59,26,33,44,41,0,2,1,0
"2011","E00008814","E00008814","Total",130,43,17,26,1,38,11,27,47,46,0,1,0,1
"2011","E00008817","E00008817","Total",133,46,23,23,1,48,21,27,35,35,0,0,0,3
"2011","E00008819","E00008819","Total",111,41,13,28,0,43,12,31,27,27,0,0,0,0
"2011","E00008820","E00008820","Total",152,34,11,23,0,65,8,57,53,52,0,0,1,0
"2011","E00008538","E00008538","Total",125,46,16,30,2,29,6,23,46,43,0,3,0,2
"2011","E00008545","E00008545","Total",153,37,9,28,0,11,0,11,105,102,0,2,1,0
"2011","E00008548","E00008548","Total",130,29,5,24,0,20,0,20,80,75,0,4,1,1
"2011","E00008549","E00008549","Total",170,45,13,32,1,33,4,29,91,86,0,5,0,0
"2011","E00008550","E00008550","Total",95,26,9,17,0,19,10,9,50,49,0,1,0,0
"2011","E00008539","E00008539","Total",118,40,9,31,2,21,1,20,55,53,0,2,0,0
"2011","E00008547","E00008547","Total",162,20,3,17,37,62,3,59,42,39,0,3,0,1
"2011","E00008555","E00008555","Total",143,32,17,15,0,20,5,15,88,82,3,3,0,3
"2011","E00008561","E00008561","Total",104,15,6,9,1,64,58,6,23,23,0,0,0,1
"2011","E00176290","E00176290","Total",106,25,11,14,1,49,8,41,30,30,0,0,0,1
"2011","E00008552","E00008552","Total",116,49,15,34,9,4,2,2,50,47,0,3,0,4
"2011","E00008554","E00008554","Total",122,62,33,29,12,6,1,5,42,40,0,2,0,0
"2011","E00008557","E00008557","Total",101,15,7,8,6,74,5,69,4,4,0,0,0,2
"2011","E00008558","E00008558","Total",88,14,9,5,1,69,0,69,2,2,0,0,0,2
"2011","E00008560","E00008560","Total",170,51,18,33,3,3,1,2,109,107,0,2,0,4
"2011","E00008563","E00008563","Total",106,44,16,28,0,10,9,1,43,41,0,2,0,9
"2011","E00008565","E00008565","Total",182,71,23,48,0,22,8,14,88,84,0,4,0,1
"2011","E00008568","E00008568","Total",76,36,13,23,0,0,0,0,40,38,0,2,0,0
"2011","E00008570","E00008570","Total",125,52,19,33,1,5,0,5,67,64,0,3,0,0
"2011","E00008571","E00008571","Total",165,48,17,31,0,4,1,3,111,108,0,3,0,2
"2011","E00008556","E00008556","Total",89,5,3,2,0,58,1,57,23,23,0,0,0,3
"2011","E00008572","E00008572","Total",190,28,3,25,5,109,64,45,44,44,0,0,0,4
"2011","E00008575","E00008575","Total",107,29,8,21,0,55,53,2,20,20,0,0,0,3
"2011","E00176291","E00176291","Total",98,17,8,9,0,62,55,7,18,18,0,0,0,1
"2011","E00008559","E00008559","Total",106,39,11,28,0,15,5,10,52,47,0,5,0,0
"2011","E00008562","E00008562","Total",131,47,21,26,0,18,0,18,65,63,0,2,0,1
"2011","E00008564","E00008564","Total",133,59,31,28,1,19,4,15,52,50,0,2,0,2
"2011","E00008566","E00008566","Total",121,43,10,33,0,18,2,16,60,54,1,5,0,0
"2011","E00008573","E00008573","Total",146,55,20,35,1,26,6,20,64,59,1,4,0,0
"2011","E00008574","E00008574","Total",148,44,8,36,0,3,0,3,100,98,0,2,0,1
"2011","E00008647","E00008647","Total",119,29,6,23,22,44,5,39,23,21,0,1,1,1
"2011","E00008652","E00008652","Total",104,45,12,33,0,48,39,9,10,9,0,0,1,1
"2011","E00008653","E00008653","Total",118,19,6,13,0,86,42,44,11,9,0,1,1,2
"2011","E00008657","E00008657","Total",115,22,7,15,1,77,55,22,11,11,0,0,0,4
"2011","E00008659","E00008659","Total",182,60,12,48,13,60,9,51,47,42,0,3,2,2
"2011","E00008662","E00008662","Total",151,52,12,40,3,50,32,18,46,44,0,1,1,0
"2011","E00008976","E00008976","Total",90,26,14,12,0,10,3,7,51,50,0,1,0,3
"2011","E00008979","E00008979","Total",102,5,1,4,0,93,1,92,4,4,0,0,0,0
"2011","E00008982","E00008982","Total",166,31,5,26,18,88,3,85,26,24,0,0,2,3
"2011","E00008985","E00008985","Total",127,56,17,39,4,37,10,27,28,27,0,0,1,2
"2011","E00008986","E00008986","Total",103,30,18,12,1,55,26,29,16,15,0,1,0,1
"2011","E00008984","E00008984","Total",95,60,31,29,0,10,3,7,24,23,1,0,0,1
"2011","E00008988","E00008988","Total",107,42,9,33,1,12,3,9,51,51,0,0,0,1
"2011","E00008989","E00008989","Total",149,71,26,45,0,26,25,1,52,48,0,2,2,0
"2011","E00008992","E00008992","Total",123,40,13,27,2,30,17,13,49,46,0,3,0,2
"2011","E00008996","E00008996","Total",107,35,21,14,1,13,11,2,56,56,0,0,0,2
"2011","E00008998","E00008998","Total",138,58,30,28,8,43,12,31,27,25,0,2,0,2
"2011","E00008983","E00008983","Total",135,63,32,31,0,59,55,4,13,11,0,2,0,0
"2011","E00008993","E00008993","Total",112,38,10,28,0,53,44,9,20,19,0,1,0,1
"2011","E00008995","E00008995","Total",145,31,5,26,1,63,29,34,49,48,0,1,0,1
"2011","E00008997","E00008997","Total",161,58,16,42,1,45,19,26,56,51,0,4,1,1
"2011","E00008999","E00008999","Total",161,16,1,15,13,113,106,7,18,16,0,2,0,1
"2011","E00008649","E00008649","Total",121,43,22,21,0,25,7,18,51,50,0,0,1,2
"2011","E00008650","E00008650","Total",149,69,23,46,2,44,42,2,33,32,1,0,0,1
"2011","E00008651","E00008651","Total",118,65,22,43,0,18,4,14,33,30,1,2,0,2
"2011","E00008654","E00008654","Total",106,80,29,51,0,5,0,5,19,18,0,1,0,2
"2011","E00008656","E00008656","Total",105,66,23,43,0,18,13,5,19,19,0,0,0,2
"2011","E00008980","E00008980","Total",118,47,13,34,0,11,8,3,59,59,0,0,0,1
"2011","E00008990","E00008990","Total",117,29,10,19,0,58,49,9,30,29,0,1,0,0
"2011","E00008991","E00008991","Total",142,35,21,14,0,12,7,5,94,92,0,2,0,1
"2011","E00008994","E00008994","Total",133,49,13,36,1,33,7,26,47,45,0,2,0,3
"2011","E00009117","E00009117","Total",130,111,42,69,0,5,1,4,14,14,0,0,0,0
"2011","E00009118","E00009118","Total",135,92,36,56,0,18,6,12,24,23,0,0,1,1
"2011","E00009144","E00009144","Total",183,73,30,43,4,36,25,11,65,62,0,2,1,5
"2011","E00009146","E00009146","Total",141,65,20,45,0,12,2,10,64,63,1,0,0,0
"2011","E00009147","E00009147","Total",107,67,30,37,0,8,4,4,32,32,0,0,0,0
"2011","E00009115","E00009115","Total",167,68,30,38,0,20,9,11,79,77,0,2,0,0
"2011","E00009116","E00009116","Total",116,38,18,20,1,35,24,11,41,40,0,1,0,1
"2011","E00009142","E00009142","Total",124,24,10,14,1,72,56,16,27,23,0,4,0,0
"2011","E00009143","E00009143","Total",218,61,21,40,1,17,5,12,138,135,2,1,0,1
"2011","E00009145","E00009145","Total",120,20,3,17,2,65,28,37,32,29,0,2,1,1
"2011","E00009119","E00009119","Total",161,67,27,40,0,54,10,44,37,35,0,2,0,3
"2011","E00009121","E00009121","Total",135,72,28,44,0,36,18,18,27,26,0,1,0,0
"2011","E00009123","E00009123","Total",187,54,18,36,1,50,16,34,82,79,0,2,1,0
"2011","E00009124","E00009124","Total",159,28,10,18,0,40,6,34,88,85,1,1,1,3
"2011","E00008801","E00008801","Total",135,25,9,16,1,91,42,49,16,13,0,1,2,2
"2011","E00008818","E00008818","Total",149,37,13,24,0,53,16,37,56,51,0,5,0,3
"2011","E00008821","E00008821","Total",134,32,11,21,1,67,34,33,33,30,0,3,0,1
"2011","E00008822","E00008822","Total",141,55,9,46,1,39,20,19,44,43,0,1,0,2
"2011","E00008824","E00008824","Total",137,27,2,25,36,47,21,26,25,23,0,0,2,2
"2011","E00008798","E00008798","Total",174,9,1,8,0,158,109,49,7,7,0,0,0,0
"2011","E00008802","E00008802","Total",123,8,2,6,1,110,84,26,4,4,0,0,0,0
"2011","E00008803","E00008803","Total",163,26,4,22,1,101,60,41,34,34,0,0,0,1
"2011","E00008827","E00008827","Total",125,6,3,3,1,110,86,24,6,6,0,0,0,2
"2011","E00176270","E00176270","Total",137,11,6,5,12,100,44,56,13,12,1,0,0,1
"2011","E00008792","E00008792","Total",177,43,13,30,0,68,48,20,64,64,0,0,0,2
"2011","E00008794","E00008794","Total",144,47,19,28,1,31,13,18,64,63,0,1,0,1
"2011","E00008808","E00008808","Total",172,50,15,35,0,79,22,57,43,37,0,5,1,0
"2011","E00008815","E00008815","Total",135,56,23,33,1,29,11,18,47,45,0,2,0,2
"2011","E00008793","E00008793","Total",176,47,13,34,10,45,24,21,73,70,2,1,0,1
"2011","E00008795","E00008795","Total",166,22,3,19,6,116,105,11,22,22,0,0,0,0
"2011","E00008799","E00008799","Total",182,66,25,41,4,52,28,24,55,52,0,3,0,5
"2011","E00008823","E00008823","Total",125,3,0,3,0,103,97,6,16,13,0,3,0,3
"2011","E00008825","E00008825","Total",135,11,3,8,3,110,107,3,10,9,0,0,1,1
"2011","E00008796","E00008796","Total",204,45,13,32,2,94,39,55,58,54,1,2,1,5
"2011","E00008807","E00008807","Total",153,25,5,20,8,64,13,51,55,53,0,2,0,1
"2011","E00176250","E00176250","Total",179,17,2,15,7,38,4,34,115,109,0,3,3,2
"2011","E00176332","E00176332","Total",89,18,2,16,1,28,20,8,41,40,1,0,0,1
"2011","E00008797","E00008797","Total",235,73,19,54,15,75,19,56,70,65,2,2,1,2
"2011","E00008804","E00008804","Total",140,48,16,32,0,30,8,22,62,57,3,0,2,0
"2011","E00008806","E00008806","Total",226,59,11,48,2,72,32,40,92,85,0,7,0,1
"2011","E00008966","E00008966","Total",136,50,25,25,0,33,16,17,52,50,0,2,0,1
"2011","E00008967","E00008967","Total",107,61,33,28,1,24,15,9,16,16,0,0,0,5
"2011","E00008968","E00008968","Total",108,46,24,22,1,25,15,10,35,31,0,0,4,1
"2011","E00008970","E00008970","Total",119,21,10,11,0,84,70,14,13,13,0,0,0,1
"2011","E00008971","E00008971","Total",150,91,48,43,3,31,13,18,24,24,0,0,0,1
"2011","E00008942","E00008942","Total",205,78,37,41,8,31,18,13,84,81,0,3,0,4
"2011","E00008949","E00008949","Total",132,42,19,23,2,64,52,12,24,24,0,0,0,0
"2011","E00008952","E00008952","Total",177,52,20,32,0,65,23,42,58,56,0,1,1,2
"2011","E00008953","E00008953","Total",142,80,33,47,1,20,6,14,37,35,0,1,1,4
"2011","E00008943","E00008943","Total",192,87,39,48,2,28,14,14,74,73,0,0,1,1
"2011","E00008950","E00008950","Total",196,103,45,58,3,24,5,19,66,59,0,7,0,0
"2011","E00008951","E00008951","Total",118,65,38,27,1,19,3,16,31,25,0,3,3,2
"2011","E00008954","E00008954","Total",150,44,23,21,20,46,4,42,38,34,0,4,0,2
"2011","E00008944","E00008944","Total",228,99,38,61,2,34,12,22,93,89,1,1,2,0
"2011","E00008945","E00008945","Total",202,77,32,45,1,40,18,22,82,75,2,4,1,2
"2011","E00008956","E00008956","Total",141,37,13,24,1,38,23,15,63,62,0,1,0,2
"2011","E00008946","E00008946","Total",183,91,38,53,0,36,6,30,55,52,0,1,2,1
"2011","E00008955","E00008955","Total",230,20,5,15,0,35,21,14,171,167,0,4,0,4
"2011","E00008957","E00008957","Total",170,49,17,32,0,73,31,42,45,42,0,3,0,3
"2011","E00008958","E00008958","Total",154,48,14,34,3,61,8,53,40,36,0,3,1,2
"2011","E00008658","E00008658","Total",101,63,21,42,0,27,18,9,11,9,1,0,1,0
"2011","E00008663","E00008663","Total",133,40,11,29,2,64,40,24,27,27,0,0,0,0
"2011","E00008667","E00008667","Total",148,33,9,24,3,59,28,31,52,51,1,0,0,1
"2011","E00008670","E00008670","Total",123,66,27,39,5,22,8,14,30,27,0,3,0,0
"2011","E00008674","E00008674","Total",202,65,15,50,5,26,19,7,105,99,0,4,2,1
"2011","E00008655","E00008655","Total",159,44,5,39,10,73,31,42,29,25,0,2,2,3
"2011","E00008660","E00008660","Total",132,36,16,20,10,50,17,33,36,35,0,1,0,0
"2011","E00008661","E00008661","Total",206,112,30,82,1,16,5,11,76,71,0,4,1,1
"2011","E00008664","E00008664","Total",121,64,19,45,1,26,13,13,30,30,0,0,0,0
"2011","E00008668","E00008668","Total",136,66,23,43,0,35,17,18,34,31,0,1,2,1
"2011","E00008648","E00008648","Total",124,71,32,39,0,31,21,10,22,20,0,2,0,0
"2011","E00008665","E00008665","Total",129,23,8,15,0,95,88,7,11,11,0,0,0,0
"2011","E00008669","E00008669","Total",110,45,14,31,0,42,19,23,22,20,0,2,0,1
"2011","E00008671","E00008671","Total",147,59,22,37,1,46,24,22,40,38,0,1,1,1
"2011","E00008675","E00008675","Total",135,35,13,22,0,20,6,14,79,77,0,1,1,1
"2011","E00008677","E00008677","Total",140,46,16,30,0,5,1,4,88,86,0,2,0,1
"2011","E00008666","E00008666","Total",201,69,19,50,2,45,15,30,81,78,0,1,2,4
"2011","E00008672","E00008672","Total",130,80,36,44,0,23,10,13,24,21,0,3,0,3
"2011","E00008673","E00008673","Total",128,94,57,37,2,14,9,5,16,14,0,2,0,2
"2011","E00008678","E00008678","Total",122,67,25,42,9,11,6,5,34,32,0,0,2,1
"2011","E00008681","E00008681","Total",146,30,7,23,0,103,67,36,11,11,0,0,0,2
"2011","E00008682","E00008682","Total",171,62,26,36,2,28,7,21,77,76,0,1,0,2
"2011","E00008925","E00008925","Total",88,12,4,8,0,66,27,39,10,9,0,1,0,0
"2011","E00008935","E00008935","Total",137,38,16,22,1,66,20,46,30,26,0,4,0,2
"2011","E00008936","E00008936","Total",83,11,3,8,0,68,17,51,3,3,0,0,0,1
"2011","E00008938","E00008938","Total",85,8,4,4,0,65,12,53,11,11,0,0,0,1
"2011","E00008940","E00008940","Total",80,11,1,10,0,56,16,40,13,13,0,0,0,0
"2011","E00176227","E00176227","Total",82,5,0,5,0,68,6,62,4,3,0,0,1,5
"2011","E00176267","E00176267","Total",162,20,6,14,0,126,21,105,13,12,0,1,0,3
"2011","E00008908","E00008908","Total",189,41,14,27,1,122,76,46,23,22,1,0,0,2
"2011","E00008910","E00008910","Total",103,16,7,9,0,82,77,5,5,5,0,0,0,0
"2011","E00008911","E00008911","Total",112,17,7,10,0,75,64,11,19,18,0,1,0,1
"2011","E00008912","E00008912","Total",124,28,9,19,1,85,66,19,7,7,0,0,0,3
"2011","E00008914","E00008914","Total",100,13,3,10,1,81,79,2,2,2,0,0,0,3
"2011","E00008913","E00008913","Total",136,6,1,5,1,119,72,47,9,9,0,0,0,1
"2011","E00008916","E00008916","Total",128,8,3,5,0,116,80,36,2,1,0,0,1,2
"2011","E00008918","E00008918","Total",139,4,1,3,2,120,16,104,10,8,0,1,1,3
"2011","E00008919","E00008919","Total",152,48,8,40,1,35,27,8,66,66,0,0,0,2
"2011","E00008920","E00008920","Total",115,13,4,9,0,81,71,10,20,20,0,0,0,1
"2011","E00176226","E00176226","Total",158,12,4,8,0,112,18,94,31,27,0,3,1,3
"2011","E00176229","E00176229","Total",126,11,4,7,0,97,39,58,18,18,0,0,0,0
"2011","E00176230","E00176230","Total",126,25,8,17,1,87,54,33,12,12,0,0,0,1
"2011","E00176231","E00176231","Total",82,6,2,4,1,64,8,56,9,8,0,0,1,2
"2011","E00008676","E00008676","Total",117,14,3,11,0,90,85,5,12,11,0,0,1,1
"2011","E00008679","E00008679","Total",126,13,7,6,1,94,92,2,18,16,0,0,2,0
"2011","E00008680","E00008680","Total",138,24,11,13,9,83,44,39,20,20,0,0,0,2
"2011","E00008683","E00008683","Total",114,17,4,13,10,64,38,26,23,22,0,1,0,0
"2011","E00008684","E00008684","Total",129,23,7,16,0,88,72,16,16,15,0,1,0,2
"2011","E00008691","E00008691","Total",153,31,10,21,0,94,63,31,27,24,0,3,0,1
"2011","E00008692","E00008692","Total",176,53,16,37,2,66,62,4,54,54,0,0,0,1
"2011","E00008694","E00008694","Total",152,82,19,63,1,2,1,1,66,61,0,5,0,1
"2011","E00008695","E00008695","Total",171,68,23,45,0,46,17,29,54,49,1,3,1,3
"2011","E00176299","E00176299","Total",149,10,2,8,12,23,7,16,102,101,1,0,0,2
"2011","E00176313","E00176313","Total",142,32,8,24,19,4,2,2,87,84,0,3,0,0
"2011","E00009120","E00009120","Total",203,27,7,20,0,34,24,10,138,135,0,1,2,4
"2011","E00009122","E00009122","Total",178,62,23,39,3,89,79,10,24,23,0,1,0,0
"2011","E00009125","E00009125","Total",148,2,0,2,0,136,15,121,7,7,0,0,0,3
"2011","E00009126","E00009126","Total",130,25,11,14,0,93,86,7,10,10,0,0,0,2
"2011","E00009127","E00009127","Total",140,20,7,13,0,96,26,70,22,20,0,1,1,2
"2011","E00009130","E00009130","Total",133,8,2,6,0,76,4,72,47,42,0,0,5,2
"2011","E00009113","E00009113","Total",164,49,9,40,1,73,22,51,39,38,0,1,0,2
"2011","E00009129","E00009129","Total",135,77,33,44,1,40,15,25,15,15,0,0,0,2
"2011","E00009131","E00009131","Total",191,78,27,51,1,45,10,35,64,62,0,2,0,3
"2011","E00009132","E00009132","Total",169,21,10,11,3,63,48,15,81,81,0,0,0,1
"2011","E00009135","E00009135","Total",141,39,5,34,0,60,4,56,41,35,0,2,4,1
"2011","E00009136","E00009136","Total",131,19,8,11,1,79,57,22,28,28,0,0,0,4
"2011","E00009114","E00009114","Total",141,76,38,38,1,22,10,12,40,37,0,3,0,2
"2011","E00009128","E00009128","Total",158,44,13,31,1,59,3,56,53,49,0,1,3,1
"2011","E00009133","E00009133","Total",131,61,21,40,1,41,18,23,26,24,0,1,1,2
"2011","E00009137","E00009137","Total",143,32,10,22,1,84,64,20,25,24,0,0,1,1
"2011","E00176271","E00176271","Total",163,2,0,2,12,3,2,1,146,144,0,2,0,0
"2011","E00176298","E00176298","Total",126,16,6,10,2,53,49,4,54,53,0,1,0,1
"2011","E00009134","E00009134","Total",132,85,29,56,0,23,11,12,24,23,0,1,0,0
"2011","E00009138","E00009138","Total",121,69,28,41,2,21,7,14,26,26,0,0,0,3
"2011","E00009140","E00009140","Total",126,62,25,37,0,26,16,10,37,36,0,1,0,1
"2011","E00009141","E00009141","Total",104,46,10,36,1,20,15,5,37,37,0,0,0,0
"2011","E00008611","E00008611","Total",159,70,26,44,2,21,6,15,62,58,1,3,0,4
"2011","E00008634","E00008634","Total",127,64,26,38,1,34,7,27,27,24,0,2,1,1
"2011","E00008636","E00008636","Total",200,64,21,43,6,35,21,14,92,91,0,1,0,3
"2011","E00008641","E00008641","Total",94,49,20,29,1,26,5,21,16,15,0,1,0,2
"2011","E00008642","E00008642","Total",121,45,17,28,9,29,23,6,36,35,0,0,1,2
"2011","E00008906","E00008906","Total",111,51,22,29,0,32,7,25,26,26,0,0,0,2
"2011","E00008907","E00008907","Total",107,22,5,17,0,73,52,21,12,12,0,0,0,0
"2011","E00008930","E00008930","Total",84,46,26,20,1,13,9,4,22,20,0,2,0,2
"2011","E00008937","E00008937","Total",133,52,19,33,1,48,34,14,31,30,0,0,1,1
"2011","E00008939","E00008939","Total",134,65,29,36,4,27,6,21,35,33,0,2,0,3
"2011","E00008909","E00008909","Total",113,23,12,11,1,74,55,19,14,14,0,0,0,1
"2011","E00008915","E00008915","Total",117,52,14,38,0,30,10,20,35,35,0,0,0,0
"2011","E00008917","E00008917","Total",153,60,28,32,1,61,38,23,29,28,0,0,1,2
"2011","E00008922","E00008922","Total",121,50,25,25,1,33,9,24,34,32,1,0,1,3
"2011","E00008924","E00008924","Total",142,76,24,52,1,22,2,20,42,38,0,2,2,1
"2011","E00008921","E00008921","Total",142,49,17,32,0,59,35,24,30,28,0,2,0,4
"2011","E00008923","E00008923","Total",133,22,5,17,0,94,77,17,15,15,0,0,0,2
"2011","E00008926","E00008926","Total",113,59,19,40,0,41,14,27,12,11,0,1,0,1
"2011","E00008928","E00008928","Total",112,49,21,28,0,47,14,33,12,12,0,0,0,4
"2011","E00008712","E00008712","Total",179,33,4,29,0,69,3,66,75,73,0,1,1,2
"2011","E00008714","E00008714","Total",184,41,13,28,4,92,77,15,45,43,0,1,1,2
"2011","E00008717","E00008717","Total",109,22,9,13,2,67,50,17,16,16,0,0,0,2
"2011","E00008718","E00008718","Total",167,24,6,18,3,107,13,94,29,27,1,0,1,4
"2011","E00176258","E00176258","Total",229,22,2,20,1,166,19,147,33,33,0,0,0,7
"2011","E00176277","E00176277","Total",90,2,1,1,1,23,7,16,63,63,0,0,0,1
"2011","E00008713","E00008713","Total",120,2,0,2,1,110,18,92,4,3,0,0,1,3
"2011","E00008715","E00008715","Total",103,7,3,4,4,81,6,75,9,9,0,0,0,2
"2011","E00008716","E00008716","Total",97,1,1,0,0,93,15,78,2,1,0,0,1,1
"2011","E00008719","E00008719","Total",137,7,2,5,2,114,104,10,12,11,0,1,0,2
"2011","E00008720","E00008720","Total",175,23,4,19,6,110,58,52,31,28,0,2,1,5
"2011","E00008775","E00008775","Total",125,20,6,14,0,88,21,67,16,15,0,1,0,1
"2011","E00008776","E00008776","Total",146,16,5,11,1,113,16,97,16,15,0,1,0,0
"2011","E00008777","E00008777","Total",132,12,5,7,1,96,19,77,23,21,0,2,0,0
"2011","E00008780","E00008780","Total",116,17,7,10,0,80,10,70,16,13,0,2,1,3
"2011","E00008781","E00008781","Total",135,22,6,16,0,88,19,69,25,18,0,5,2,0
"2011","E00008778","E00008778","Total",113,16,5,11,1,79,6,73,17,15,0,1,1,0
"2011","E00008779","E00008779","Total",191,17,5,12,27,101,22,79,43,43,0,0,0,3
"2011","E00008783","E00008783","Total",125,15,1,14,1,96,14,82,12,10,0,1,1,1
"2011","E00008784","E00008784","Total",99,9,2,7,0,70,8,62,16,15,0,1,0,4
"2011","E00008787","E00008787","Total",119,35,9,26,1,35,7,28,48,45,0,2,1,0
"2011","E00008791","E00008791","Total",237,49,18,31,10,104,50,54,68,64,0,2,2,6
"2011","E00008756","E00008756","Total",237,60,12,48,4,76,31,45,96,92,0,2,2,1
"2011","E00008757","E00008757","Total",142,24,6,18,0,101,93,8,13,11,0,2,0,4
"2011","E00008758","E00008758","Total",114,47,20,27,2,44,9,35,19,18,0,0,1,2
"2011","E00008782","E00008782","Total",93,25,6,19,0,47,6,41,20,18,0,0,2,1
"2011","E00008785","E00008785","Total",83,23,8,15,0,40,26,14,19,18,0,0,1,1
"2011","E00008786","E00008786","Total",81,3,1,2,0,61,10,51,16,16,0,0,0,1
"2011","E00008761","E00008761","Total",211,17,6,11,0,143,24,119,48,47,0,0,1,3
"2011","E00008764","E00008764","Total",133,3,2,1,0,118,11,107,8,8,0,0,0,4
"2011","E00008765","E00008765","Total",244,63,17,46,9,86,7,79,82,81,0,1,0,4
"2011","E00008766","E00008766","Total",137,2,1,1,0,126,4,122,8,8,0,0,0,1
"2011","E00008789","E00008789","Total",144,46,3,43,4,53,29,24,40,39,0,1,0,1
"2011","E00008609","E00008609","Total",126,31,6,25,4,59,25,34,31,30,0,1,0,1
"2011","E00008621","E00008621","Total",124,24,6,18,0,56,7,49,43,43,0,0,0,1
"2011","E00008626","E00008626","Total",129,8,2,6,1,113,106,7,7,6,0,1,0,0
"2011","E00008627","E00008627","Total",104,11,8,3,0,66,63,3,27,25,0,2,0,0
"2011","E00008630","E00008630","Total",98,19,5,14,1,34,18,16,43,42,0,1,0,1
"2011","E00008633","E00008633","Total",188,26,10,16,3,78,3,75,81,77,2,2,0,0
"2011","E00176269","E00176269","Total",144,29,8,21,2,65,61,4,43,40,2,1,0,5
"2011","E00176274","E00176274","Total",120,18,6,12,16,72,10,62,11,11,0,0,0,3
"2011","E00008635","E00008635","Total",213,31,5,26,4,26,15,11,150,147,0,3,0,2
"2011","E00008637","E00008637","Total",171,50,23,27,2,55,47,8,64,62,0,1,1,0
"2011","E00008638","E00008638","Total",155,35,13,22,0,56,7,49,63,61,0,2,0,1
"2011","E00008639","E00008639","Total",184,37,14,23,0,50,16,34,92,88,0,3,1,5
"2011","E00008640","E00008640","Total",126,33,12,21,0,70,58,12,23,22,0,1,0,0
"2011","E00008759","E00008759","Total",195,29,9,20,1,29,5,24,136,134,0,2,0,0
"2011","E00008760","E00008760","Total",159,36,18,18,2,73,47,26,47,45,0,2,0,1
"2011","E00008763","E00008763","Total",153,44,13,31,1,32,18,14,75,74,0,1,0,1
"2011","E00008788","E00008788","Total",147,20,2,18,1,103,7,96,22,20,0,0,2,1
"2011","E00008790","E00008790","Total",111,5,3,2,0,80,5,75,26,26,0,0,0,0
"2011","E00008762","E00008762","Total",172,60,19,41,1,42,12,30,67,64,0,2,1,2
"2011","E00008767","E00008767","Total",149,43,15,28,0,52,13,39,46,42,1,2,1,8
"2011","E00008768","E00008768","Total",206,32,11,21,0,26,21,5,148,147,0,1,0,0
"2011","E00008769","E00008769","Total",136,24,8,16,3,88,64,24,21,20,0,1,0,0
"2011","E00008770","E00008770","Total",157,58,13,45,6,48,8,40,44,43,0,1,0,1
"2011","E00009190","E00009190","Total",122,16,1,15,16,73,16,57,17,17,0,0,0,0
"2011","E00009195","E00009195","Total",160,44,14,30,13,68,61,7,34,32,0,2,0,1
"2011","E00009198","E00009198","Total",96,20,9,11,4,55,43,12,17,16,0,1,0,0
"2011","E00009202","E00009202","Total",71,9,2,7,1,55,40,15,6,4,0,2,0,0
"2011","E00009206","E00009206","Total",86,7,4,3,0,70,63,7,9,9,0,0,0,0
"2011","E00009191","E00009191","Total",183,54,19,35,4,81,47,34,43,41,0,2,0,1
"2011","E00009192","E00009192","Total",156,43,13,30,3,90,71,19,19,19,0,0,0,1
"2011","E00176326","E00176326","Total",128,37,14,23,0,45,22,23,44,40,0,4,0,2
"2011","E00009203","E00009203","Total",85,42,18,24,1,15,8,7,26,25,0,1,0,1
"2011","E00009205","E00009205","Total",56,7,2,5,0,41,11,30,8,7,0,0,1,0
"2011","E00009208","E00009208","Total",99,30,13,17,3,45,30,15,20,20,0,0,0,1
"2011","E00009209","E00009209","Total",121,7,3,4,1,96,57,39,15,14,1,0,0,2
"2011","E00009210","E00009210","Total",184,42,13,29,26,62,12,50,44,44,0,0,0,10
"2011","E00009217","E00009217","Total",110,36,10,26,1,51,8,43,20,20,0,0,0,2
"2011","E00009194","E00009194","Total",202,35,12,23,15,89,7,82,61,58,0,3,0,2
"2011","E00009197","E00009197","Total",113,19,1,18,1,51,15,36,41,40,0,0,1,1
"2011","E00009204","E00009204","Total",178,32,4,28,9,64,1,63,69,66,0,2,1,4
"2011","E00009207","E00009207","Total",154,65,15,50,1,28,7,21,58,55,0,3,0,2
"2011","E00176262","E00176262","Total",136,22,7,15,14,38,9,29,62,61,0,1,0,0
"2011","E00176314","E00176314","Total",96,8,4,4,40,36,5,31,11,11,0,0,0,1
"2011","E00176315","E00176315","Total",98,25,3,22,12,30,25,5,31,31,0,0,0,0
"2011","E00008612","E00008612","Total",132,26,6,20,0,93,90,3,13,13,0,0,0,0
"2011","E00008615","E00008615","Total",155,13,2,11,1,130,120,10,9,9,0,0,0,2
"2011","E00008618","E00008618","Total",181,20,2,18,4,134,132,2,19,17,0,2,0,4
"2011","E00008619","E00008619","Total",141,15,2,13,13,80,65,15,31,28,0,1,2,2
"2011","E00176316","E00176316","Total",99,18,3,15,2,68,63,5,11,11,0,0,0,0
"2011","E00176335","E00176335","Total",47,1,0,1,1,23,6,17,22,22,0,0,0,0
"2011","E00176336","E00176336","Total",108,7,1,6,34,29,5,24,38,38,0,0,0,0
"2011","E00008616","E00008616","Total",176,34,12,22,17,83,51,32,41,41,0,0,0,1
"2011","E00008617","E00008617","Total",113,8,3,5,0,91,72,19,11,11,0,0,0,3
"2011","E00008622","E00008622","Total",142,6,3,3,0,104,76,28,31,28,0,3,0,1
"2011","E00008623","E00008623","Total",114,9,2,7,1,95,26,69,9,9,0,0,0,0
"2011","E00008624","E00008624","Total",115,11,2,9,1,86,75,11,17,15,0,1,1,0
"2011","E00008646","E00008646","Total",141,12,2,10,2,116,110,6,9,9,0,0,0,2
"2011","E00008625","E00008625","Total",137,9,1,8,0,110,20,90,14,11,0,3,0,4
"2011","E00008628","E00008628","Total",124,18,8,10,0,96,20,76,9,8,0,1,0,1
"2011","E00008629","E00008629","Total",143,19,1,18,0,98,34,64,25,23,0,0,2,1
"2011","E00008631","E00008631","Total",127,5,1,4,1,100,25,75,18,14,0,2,2,3
"2011","E00008632","E00008632","Total",165,24,8,16,34,83,69,14,21,21,0,0,0,3
"2011","E00008610","E00008610","Total",142,22,6,16,0,104,85,19,14,14,0,0,0,2
"2011","E00008613","E00008613","Total",150,35,14,21,1,97,59,38,17,17,0,0,0,0
"2011","E00008620","E00008620","Total",105,40,16,24,0,41,26,15,22,22,0,0,0,2
"2011","E00008643","E00008643","Total",128,54,9,45,1,33,28,5,39,36,1,1,1,1
"2011","E00008644","E00008644","Total",136,86,33,53,3,17,3,14,26,23,0,3,0,4
"2011","E00009179","E00009179","Total",135,15,4,11,1,109,103,6,8,7,0,0,1,2
"2011","E00009180","E00009180","Total",144,25,11,14,0,110,50,60,6,5,0,0,1,3
"2011","E00009181","E00009181","Total",151,12,5,7,0,119,110,9,18,18,0,0,0,2
"2011","E00009182","E00009182","Total",141,9,3,6,7,118,79,39,7,5,0,1,1,0
"2011","E00009183","E00009183","Total",134,10,2,8,0,105,90,15,13,11,0,0,2,6
"2011","E00009196","E00009196","Total",85,10,4,6,0,48,43,5,27,27,0,0,0,0
"2011","E00009212","E00009212","Total",98,15,4,11,1,66,62,4,15,15,0,0,0,1
"2011","E00009213","E00009213","Total",202,18,9,9,1,156,136,20,23,22,0,1,0,4
"2011","E00009214","E00009214","Total",78,18,6,12,0,50,49,1,10,10,0,0,0,0
"2011","E00009218","E00009218","Total",113,7,3,4,0,102,95,7,4,3,0,1,0,0
"2011","E00009219","E00009219","Total",100,5,2,3,0,81,80,1,13,13,0,0,0,1
"2011","E00008696","E00008696","Total",143,29,9,20,21,68,43,25,25,25,0,0,0,0
"2011","E00008700","E00008700","Total",139,38,17,21,0,52,5,47,46,40,0,4,2,3
"2011","E00008702","E00008702","Total",135,34,9,25,0,18,2,16,81,77,1,3,0,2
"2011","E00176272","E00176272","Total",122,20,10,10,1,50,4,46,47,44,0,3,0,4
"2011","E00176280","E00176280","Total",101,34,14,20,0,25,1,24,40,38,0,2,0,2
"2011","E00176301","E00176301","Total",118,6,5,1,1,63,5,58,46,45,0,1,0,2
"2011","E00176323","E00176323","Total",103,22,12,10,1,48,1,47,31,29,0,1,1,1
"2011","E00176324","E00176324","Total",113,15,1,14,0,27,7,20,71,69,0,2,0,0
"2011","E00176325","E00176325","Total",116,36,16,20,17,19,3,16,44,42,0,2,0,0
"2011","E00008686","E00008686","Total",194,81,28,53,7,44,11,33,61,59,0,1,1,1
"2011","E00008704","E00008704","Total",96,44,13,31,2,38,1,37,11,11,0,0,0,1
"2011","E00008705","E00008705","Total",153,58,17,41,8,48,6,42,36,35,0,1,0,3
"2011","E00008706","E00008706","Total",133,39,17,22,0,55,21,34,36,35,0,1,0,3
"2011","E00008709","E00008709","Total",167,69,32,37,0,35,11,24,61,57,0,3,1,2
"2011","E00008771","E00008771","Total",68,22,9,13,1,25,2,23,20,16,0,4,0,0
"2011","E00008772","E00008772","Total",155,40,12,28,1,72,25,47,42,37,0,4,1,0
"2011","E00008773","E00008773","Total",97,9,1,8,1,66,64,2,19,18,0,1,0,2
"2011","E00008774","E00008774","Total",102,17,6,11,0,77,74,3,8,8,0,0,0,0
"2011","E00176300","E00176300","Total",110,23,3,20,0,43,4,39,43,41,0,2,0,1
"2011","E00176319","E00176319","Total",118,49,22,27,1,43,8,35,23,20,0,2,1,2
"2011","E00176328","E00176328","Total",92,30,11,19,1,34,10,24,26,24,0,2,0,1
"2011","E00009047","E00009047","Total",127,44,12,32,1,53,37,16,27,26,0,1,0,2
"2011","E00009049","E00009049","Total",152,62,21,41,10,54,39,15,23,19,0,4,0,3
"2011","E00009057","E00009057","Total",122,42,16,26,0,57,52,5,22,20,0,2,0,1
"2011","E00009058","E00009058","Total",107,37,12,25,1,54,47,7,15,15,0,0,0,0
"2011","E00009064","E00009064","Total",132,74,39,35,0,30,13,17,27,24,0,2,1,1
"2011","E00009051","E00009051","Total",120,45,15,30,0,53,10,43,21,20,0,1,0,1
"2011","E00009053","E00009053","Total",166,64,28,36,0,73,39,34,26,26,0,0,0,3
"2011","E00009054","E00009054","Total",68,12,4,8,0,48,12,36,7,7,0,0,0,1
"2011","E00009056","E00009056","Total",136,50,25,25,0,62,10,52,23,22,0,1,0,1
"2011","E00009067","E00009067","Total",194,64,20,44,0,84,39,45,46,45,0,1,0,0
"2011","E00008685","E00008685","Total",137,30,9,21,1,81,44,37,21,21,0,0,0,4
"2011","E00008687","E00008687","Total",96,37,10,27,1,41,20,21,16,15,0,1,0,1
"2011","E00008689","E00008689","Total",140,34,8,26,1,74,59,15,29,26,1,2,0,2
"2011","E00008707","E00008707","Total",169,54,21,33,0,68,56,12,43,40,1,2,0,4
"2011","E00008710","E00008710","Total",119,54,16,38,1,29,17,12,33,28,1,4,0,2
"2011","E00008711","E00008711","Total",125,32,13,19,1,73,69,4,15,15,0,0,0,4
"2011","E00008723","E00008723","Total",116,17,2,15,0,74,70,4,24,22,0,2,0,1
"2011","E00008724","E00008724","Total",250,59,19,40,18,103,46,57,67,61,0,4,2,3
"2011","E00008725","E00008725","Total",140,40,12,28,1,37,27,10,60,59,0,1,0,2
"2011","E00008728","E00008728","Total",113,45,22,23,4,32,7,25,30,25,0,5,0,2
"2011","E00008736","E00008736","Total",163,38,12,26,13,72,63,9,36,36,0,0,0,4
"2011","E00008722","E00008722","Total",133,65,31,34,0,9,1,8,59,59,0,0,0,0
"2011","E00008726","E00008726","Total",127,74,36,38,1,14,4,10,37,34,0,3,0,1
"2011","E00008727","E00008727","Total",136,60,21,39,7,21,4,17,48,46,0,2,0,0
"2011","E00008750","E00008750","Total",139,76,34,42,0,16,4,12,47,46,0,1,0,0
"2011","E00008753","E00008753","Total",141,83,29,54,1,12,7,5,44,42,0,2,0,1
"2011","E00008721","E00008721","Total",156,62,28,34,0,31,7,24,62,60,0,2,0,1
"2011","E00008752","E00008752","Total",123,25,15,10,0,80,75,5,18,16,1,1,0,0
"2011","E00008754","E00008754","Total",157,47,20,27,1,27,4,23,79,79,0,0,0,3
"2011","E00176302","E00176302","Total",79,7,2,5,0,5,0,5,67,63,0,4,0,0
"2011","E00176303","E00176303","Total",129,67,20,47,0,15,3,12,47,47,0,0,0,0
"2011","E00176320","E00176320","Total",92,35,10,25,6,5,2,3,44,43,0,1,0,2
"2011","E00176321","E00176321","Total",81,21,4,17,0,16,2,14,44,42,0,2,0,0
"2011","E00176322","E00176322","Total",97,36,23,13,0,22,6,16,37,35,0,2,0,2
"2011","E00176330","E00176330","Total",73,17,7,10,0,14,0,14,42,41,0,1,0,0
"2011","E00009062","E00009062","Total",147,14,2,12,9,88,6,82,34,32,0,2,0,2
"2011","E00009063","E00009063","Total",144,26,10,16,1,53,6,47,63,59,0,4,0,1
"2011","E00176216","E00176216","Total",95,3,1,2,0,85,11,74,5,5,0,0,0,2
"2011","E00176217","E00176217","Total",108,2,1,1,1,81,10,71,21,21,0,0,0,3
"2011","E00176218","E00176218","Total",119,1,1,0,0,109,98,11,7,7,0,0,0,2
"2011","E00008698","E00008698","Total",122,32,16,16,1,55,6,49,34,33,0,1,0,0
"2011","E00008699","E00008699","Total",205,67,14,53,2,45,2,43,85,78,0,5,2,6
"2011","E00176219","E00176219","Total",129,17,8,9,0,16,1,15,91,90,0,1,0,5
"2011","E00176220","E00176220","Total",129,8,2,6,0,14,7,7,101,99,0,1,1,6
"2011","E00008708","E00008708","Total",147,35,14,21,1,88,44,44,23,21,1,1,0,0
"2011","E00176221","E00176221","Total",134,3,1,2,0,7,0,7,124,124,0,0,0,0
"2011","E00176287","E00176287","Total",82,25,5,20,6,24,16,8,25,25,0,0,0,2
"2011","E00176288","E00176288","Total",177,58,17,41,17,25,8,17,76,74,0,2,0,1
"2011","E00176289","E00176289","Total",157,17,7,10,2,9,6,3,127,126,0,1,0,2
"2011","E00009048","E00009048","Total",163,7,3,4,1,72,8,64,80,77,2,0,1,3
"2011","E00009050","E00009050","Total",170,8,4,4,1,134,15,119,26,24,0,0,2,1
"2011","E00176259","E00176259","Total",71,7,4,3,0,4,1,3,60,60,0,0,0,0
"2011","E00176265","E00176265","Total",74,30,9,21,1,23,4,19,18,18,0,0,0,2
"2011","E00176279","E00176279","Total",136,3,1,2,0,16,2,14,117,117,0,0,0,0
"2011","E00009154","E00009154","Total",131,21,3,18,2,92,34,58,16,14,0,2,0,0
"2011","E00009155","E00009155","Total",151,38,14,24,8,69,18,51,33,31,0,2,0,3
"2011","E00009165","E00009165","Total",147,20,6,14,3,76,5,71,46,43,0,2,1,2
"2011","E00009174","E00009174","Total",118,20,4,16,0,77,69,8,18,14,0,4,0,3
"2011","E00009175","E00009175","Total",182,57,12,45,4,56,11,45,62,59,0,3,0,3
"2011","E00009176","E00009176","Total",128,34,13,21,0,70,5,65,18,18,0,0,0,6
"2011","E00009148","E00009148","Total",162,35,10,25,10,80,32,48,33,32,0,1,0,4
"2011","E00009160","E00009160","Total",162,41,9,32,1,104,41,63,15,14,0,1,0,1
"2011","E00009184","E00009184","Total",131,6,1,5,0,117,111,6,6,6,0,0,0,2
"2011","E00009185","E00009185","Total",124,37,12,25,1,69,53,16,16,15,0,1,0,1
"2011","E00009186","E00009186","Total",136,18,2,16,0,108,100,8,9,9,0,0,0,1
"2011","E00009157","E00009157","Total",109,55,15,40,0,27,13,14,26,25,0,1,0,1
"2011","E00009162","E00009162","Total",118,52,13,39,5,34,19,15,26,25,0,0,1,1
"2011","E00009163","E00009163","Total",101,3,2,1,0,95,7,88,3,3,0,0,0,0
"2011","E00009168","E00009168","Total",89,9,0,9,0,67,64,3,9,9,0,0,0,4
"2011","E00009187","E00009187","Total",104,31,24,7,5,52,6,46,11,10,0,0,1,5
"2011","E00009188","E00009188","Total",105,59,30,29,0,29,12,17,16,16,0,0,0,1
"2011","E00009199","E00009199","Total",116,25,10,15,0,71,9,62,20,19,0,0,1,0
"2011","E00009200","E00009200","Total",167,66,20,46,1,39,9,30,55,51,0,2,2,6
"2011","E00009216","E00009216","Total",159,28,5,23,1,78,7,71,49,47,0,0,2,3
"2011","E00009223","E00009223","Total",85,44,27,17,2,30,4,26,5,5,0,0,0,4
"2011","E00176268","E00176268","Total",57,3,3,0,1,47,3,44,6,4,0,0,2,0
"2011","E00176286","E00176286","Total",106,58,17,41,0,14,1,13,34,33,0,1,0,0
"2011","E00176334","E00176334","Total",122,17,11,6,7,68,7,61,29,23,0,1,5,1
"2011","E00009201","E00009201","Total",120,15,6,9,2,92,12,80,9,7,0,2,0,2
"2011","E00009215","E00009215","Total",238,22,7,15,0,176,53,123,34,33,0,0,1,6
"2011","E00009221","E00009221","Total",69,1,0,1,0,64,5,59,3,3,0,0,0,1
"2011","E00009222","E00009222","Total",98,1,1,0,0,88,11,77,6,6,0,0,0,3
"2011","E00176285","E00176285","Total",155,14,6,8,1,129,10,119,10,6,0,1,3,1
"2011","E00009156","E00009156","Total",218,82,16,66,1,79,3,76,54,49,1,4,0,2
"2011","E00009171","E00009171","Total",85,33,16,17,0,31,0,31,21,21,0,0,0,0
"2011","E00009172","E00009172","Total",113,38,14,24,0,44,1,43,30,27,0,2,1,1
"2011","E00009177","E00009177","Total",120,73,28,45,0,21,2,19,26,24,0,2,0,0
"2011","E00009178","E00009178","Total",129,59,15,44,5,16,0,16,47,43,1,3,0,2
"2011","E00009149","E00009149","Total",113,11,5,6,1,90,78,12,11,9,0,2,0,0
"2011","E00009159","E00009159","Total",128,16,4,12,1,98,93,5,10,9,0,1,0,3
"2011","E00009164","E00009164","Total",176,31,7,24,20,42,16,26,82,78,0,4,0,1
"2011","E00009166","E00009166","Total",228,23,4,19,10,56,28,28,136,135,0,0,1,3
"2011","E00176222","E00176222","Total",127,65,15,50,0,4,4,0,57,53,0,4,0,1
"2011","E00176223","E00176223","Total",169,36,8,28,2,25,21,4,106,106,0,0,0,0
"2011","E00009152","E00009152","Total",165,39,12,27,0,98,86,12,24,24,0,0,0,4
"2011","E00009161","E00009161","Total",117,21,4,17,2,72,17,55,21,18,0,3,0,1
"2011","E00009167","E00009167","Total",94,12,4,8,0,73,9,64,8,6,0,1,1,1
"2011","E00009170","E00009170","Total",128,18,3,15,6,90,11,79,12,10,0,2,0,2
"2011","E00009173","E00009173","Total",127,28,6,22,0,72,6,66,26,26,0,0,0,1
"2011","E00009151","E00009151","Total",162,4,0,4,6,144,11,133,7,6,0,0,1,1
"2011","E00009153","E00009153","Total",99,48,21,27,0,36,5,31,15,13,2,0,0,0
"2011","E00009158","E00009158","Total",135,47,11,36,3,55,11,44,30,30,0,0,0,0
"2011","E00009169","E00009169","Total",106,62,21,41,1,19,2,17,22,20,0,1,1,2
"2011","E00009065","E00009065","Total",189,58,17,41,6,22,4,18,98,95,1,2,0,5
"2011","E00176251","E00176251","Total",106,14,6,8,2,44,4,40,45,43,0,2,0,1
"2011","E00176266","E00176266","Total",150,8,0,8,59,47,10,37,34,33,0,1,0,2
"2011","E00176304","E00176304","Total",106,32,1,31,17,19,5,14,37,29,1,6,1,1
"2011","E00176317","E00176317","Total",112,13,1,12,27,13,0,13,57,53,0,3,1,2
"2011","E00176331","E00176331","Total",100,32,2,30,0,12,2,10,56,55,0,1,0,0
"2011","E00009069","E00009069","Total",123,19,5,14,6,79,65,14,17,16,0,1,0,2
"2011","E00009073","E00009073","Total",147,45,19,26,2,66,51,15,33,31,0,2,0,1
"2011","E00009076","E00009076","Total",232,48,12,36,11,36,26,10,135,135,0,0,0,2
"2011","E00176333","E00176333","Total",159,13,6,7,3,101,39,62,40,40,0,0,0,2
"2011","E00008830","E00008830","Total",108,16,5,11,0,76,67,9,9,9,0,0,0,7
"2011","E00008831","E00008831","Total",131,11,2,9,0,107,92,15,12,11,0,0,1,1
"2011","E00008838","E00008838","Total",146,16,6,10,2,118,22,96,10,10,0,0,0,0
"2011","E00176247","E00176247","Total",74,11,3,8,0,52,47,5,11,11,0,0,0,0
"2011","E00008850","E00008850","Total",154,16,4,12,0,103,95,8,31,30,1,0,0,4
"2011","E00008851","E00008851","Total",122,11,1,10,0,95,86,9,14,14,0,0,0,2
"2011","E00008852","E00008852","Total",167,57,10,47,1,22,6,16,85,79,1,5,0,2
"2011","E00008860","E00008860","Total",161,24,12,12,0,66,58,8,69,64,0,4,1,2
"2011","E00176241","E00176241","Total",98,26,8,18,2,47,19,28,22,22,0,0,0,1
"2011","E00176242","E00176242","Total",173,57,6,51,6,33,32,1,74,71,0,2,1,3
"2011","E00008828","E00008828","Total",155,35,12,23,0,85,37,48,31,30,0,1,0,4
"2011","E00008840","E00008840","Total",185,35,10,25,6,101,90,11,35,34,0,1,0,8
"2011","E00008841","E00008841","Total",140,13,0,13,3,100,80,20,23,22,0,1,0,1
"2011","E00008844","E00008844","Total",138,22,4,18,0,104,99,5,11,9,1,1,0,1
"2011","E00008848","E00008848","Total",141,18,2,16,1,105,70,35,14,13,0,1,0,3
"2011","E00009052","E00009052","Total",140,21,4,17,0,102,65,37,16,14,0,0,2,1
"2011","E00009060","E00009060","Total",136,23,9,14,0,92,90,2,20,18,0,0,2,1
"2011","E00009066","E00009066","Total",135,30,6,24,1,78,58,20,26,25,0,1,0,0
"2011","E00009068","E00009068","Total",121,41,15,26,0,59,32,27,21,16,0,1,4,0
"2011","E00009071","E00009071","Total",160,32,9,23,0,115,62,53,13,11,0,1,1,0
"2011","E00009045","E00009045","Total",130,20,5,15,0,78,73,5,31,30,0,1,0,1
"2011","E00009070","E00009070","Total",93,18,7,11,1,67,63,4,7,6,0,1,0,0
"2011","E00009072","E00009072","Total",129,50,22,28,2,63,52,11,13,11,0,2,0,1
"2011","E00009075","E00009075","Total",138,31,9,22,0,88,77,11,15,14,0,1,0,4
"2011","E00009079","E00009079","Total",109,11,6,5,1,86,80,6,11,9,0,2,0,0
"2011","E00009046","E00009046","Total",155,26,9,17,1,111,107,4,13,11,0,0,2,4
"2011","E00009074","E00009074","Total",147,17,9,8,1,117,97,20,11,11,0,0,0,1
"2011","E00009077","E00009077","Total",197,30,10,20,0,125,103,22,40,39,0,1,0,2
"2011","E00009078","E00009078","Total",145,25,4,21,0,107,87,20,12,12,0,0,0,1
"2011","E00008731","E00008731","Total",128,28,10,18,0,55,49,6,44,43,0,1,0,1
"2011","E00008739","E00008739","Total",166,24,6,18,11,100,66,34,29,28,0,0,1,2
"2011","E00176224","E00176224","Total",73,11,1,10,3,45,43,2,13,13,0,0,0,1
"2011","E00176233","E00176233","Total",117,14,6,8,1,67,60,7,32,32,0,0,0,3
"2011","E00176234","E00176234","Total",266,98,26,72,21,20,12,8,124,121,0,3,0,3
"2011","E00176235","E00176235","Total",181,55,12,43,21,38,32,6,66,64,0,2,0,1
"2011","E00176236","E00176236","Total",129,5,0,5,91,30,4,26,3,2,0,1,0,0
"2011","E00008729","E00008729","Total",139,14,8,6,1,101,95,6,22,22,0,0,0,1
"2011","E00008732","E00008732","Total",124,4,1,3,1,88,79,9,30,24,0,3,3,1
"2011","E00008734","E00008734","Total",108,14,6,8,2,79,75,4,11,11,0,0,0,2
"2011","E00008735","E00008735","Total",157,21,12,9,13,108,102,6,13,11,0,1,1,2
"2011","E00008737","E00008737","Total",159,9,3,6,1,136,134,2,11,9,0,2,0,2
"2011","E00008740","E00008740","Total",88,0,0,0,0,15,3,12,73,73,0,0,0,0
"2011","E00008742","E00008742","Total",175,12,3,9,3,142,13,129,16,16,0,0,0,2
"2011","E00008743","E00008743","Total",151,14,3,11,0,102,98,4,31,28,0,2,1,4
"2011","E00176237","E00176237","Total",114,27,9,18,2,62,11,51,23,22,0,0,1,0
"2011","E00176238","E00176238","Total",102,12,4,8,10,18,2,16,61,60,0,1,0,1
"2011","E00176239","E00176239","Total",177,60,17,43,5,7,2,5,102,98,0,3,1,3
"2011","E00176240","E00176240","Total",95,14,6,8,11,33,8,25,37,37,0,0,0,0
"2011","E00176253","E00176253","Total",88,27,7,20,11,19,2,17,30,30,0,0,0,1
"2011","E00176257","E00176257","Total",145,18,3,15,19,88,49,39,18,16,0,1,1,2
"2011","E00008744","E00008744","Total",117,9,1,8,8,89,13,76,10,8,0,2,0,1
"2011","E00008745","E00008745","Total",203,44,18,26,10,65,21,44,73,71,0,0,2,11
"2011","E00008746","E00008746","Total",151,6,1,5,11,112,13,99,16,15,0,1,0,6
"2011","E00008747","E00008747","Total",124,11,2,9,0,99,91,8,12,10,0,2,0,2
"2011","E00008748","E00008748","Total",129,16,6,10,4,94,79,15,14,14,0,0,0,1
"2011","E00008832","E00008832","Total",128,10,3,7,2,94,34,60,18,16,0,1,1,4
"2011","E00008839","E00008839","Total",157,26,9,17,2,114,95,19,14,13,0,1,0,1
"2011","E00008842","E00008842","Total",93,8,4,4,0,74,60,14,8,8,0,0,0,3
"2011","E00008847","E00008847","Total",103,26,9,17,0,61,55,6,12,11,0,1,0,4
"2011","E00176248","E00176248","Total",119,5,2,3,14,60,40,20,37,35,1,1,0,3
"2011","E00176249","E00176249","Total",116,8,3,5,35,51,21,30,21,19,0,2,0,1
"2011","E00176306","E00176306","Total",144,12,3,9,1,10,1,9,121,120,0,1,0,0
"2011","E00008829","E00008829","Total",154,28,12,16,0,109,45,64,16,16,0,0,0,1
"2011","E00008833","E00008833","Total",164,29,14,15,1,97,62,35,34,32,0,2,0,3
"2011","E00008846","E00008846","Total",56,6,4,2,0,40,16,24,10,10,0,0,0,0
"2011","E00008849","E00008849","Total",126,5,4,1,1,109,103,6,10,10,0,0,0,1
"2011","E00008854","E00008854","Total",134,27,9,18,1,81,74,7,23,23,0,0,0,2
"2011","E00008866","E00008866","Total",156,15,3,12,5,113,103,10,22,22,0,0,0,1
"2011","E00008871","E00008871","Total",171,14,2,12,56,80,69,11,18,14,1,2,1,3
"2011","E00008877","E00008877","Total",148,27,10,17,1,82,80,2,37,36,0,1,0,1
"2011","E00008879","E00008879","Total",187,64,27,37,1,38,6,32,83,78,0,4,1,1
"2011","E00008888","E00008888","Total",249,20,9,11,51,163,103,60,11,11,0,0,0,4
"2011","E00008905","E00008905","Total",210,34,9,25,1,113,37,76,61,56,0,3,2,1
"2011","E00008887","E00008887","Total",126,14,4,10,0,96,80,16,12,11,0,1,0,4
"2011","E00008893","E00008893","Total",102,6,3,3,0,75,71,4,21,21,0,0,0,0
"2011","E00008894","E00008894","Total",120,13,5,8,1,82,79,3,24,17,0,4,3,0
"2011","E00008895","E00008895","Total",131,9,3,6,0,84,62,22,32,30,0,1,1,6
"2011","E00008899","E00008899","Total",131,14,8,6,0,92,92,0,20,17,0,2,1,5
"2011","E00008901","E00008901","Total",121,11,2,9,0,77,75,2,31,30,0,1,0,2
"2011","E00008885","E00008885","Total",125,40,15,25,2,61,49,12,22,21,0,1,0,0
"2011","E00008886","E00008886","Total",102,10,6,4,1,32,28,4,59,58,1,0,0,0
"2011","E00008889","E00008889","Total",208,57,17,40,10,75,26,49,63,62,0,1,0,3
"2011","E00008890","E00008890","Total",120,20,7,13,0,85,83,2,13,13,0,0,0,2
"2011","E00008892","E00008892","Total",111,11,3,8,1,64,38,26,34,27,0,2,5,1
"2011","E00176243","E00176243","Total",173,103,34,69,2,9,6,3,57,56,0,1,0,2
"2011","E00176244","E00176244","Total",111,49,16,33,6,5,3,2,48,44,0,4,0,3
"2011","E00176245","E00176245","Total",103,36,18,18,8,17,5,12,40,37,0,3,0,2
"2011","E00008864","E00008864","Total",169,23,10,13,4,112,105,7,30,29,0,1,0,0
"2011","E00008875","E00008875","Total",131,10,1,9,0,99,96,3,22,20,0,2,0,0
"2011","E00008891","E00008891","Total",152,14,5,9,7,114,109,5,16,15,1,0,0,1
"2011","E00008896","E00008896","Total",136,11,4,7,0,107,105,2,15,14,0,1,0,3
"2011","E00008903","E00008903","Total",139,17,6,11,0,98,96,2,24,24,0,0,0,0
"2011","E00008904","E00008904","Total",136,18,5,13,1,104,99,5,13,11,0,2,0,0
"2011","E00008853","E00008853","Total",111,8,1,7,0,84,82,2,18,18,0,0,0,1
"2011","E00008856","E00008856","Total",120,18,2,16,0,75,72,3,26,23,1,2,0,1
"2011","E00008857","E00008857","Total",199,16,7,9,1,92,87,5,87,85,0,1,1,3
"2011","E00008858","E00008858","Total",135,20,11,9,2,87,85,2,23,22,0,0,1,3
"2011","E00008859","E00008859","Total",120,14,3,11,0,82,80,2,24,22,0,0,2,0
"2011","E00176264","E00176264","Total",123,12,4,8,6,16,13,3,87,87,0,0,0,2
"2011","E00176309","E00176309","Total",110,10,3,7,0,3,3,0,97,94,0,2,1,0
"2011","E00176310","E00176310","Total",125,43,11,32,15,33,29,4,34,30,0,3,1,0
"2011","E00008878","E00008878","Total",178,23,6,17,11,95,91,4,47,42,0,3,2,2
"2011","E00008880","E00008880","Total",137,17,7,10,1,90,83,7,23,22,0,1,0,6
"2011","E00008881","E00008881","Total",114,18,5,13,3,82,76,6,10,8,0,1,1,1
"2011","E00008882","E00008882","Total",173,59,20,39,0,50,47,3,62,58,1,3,0,2
"2011","E00008883","E00008883","Total",163,14,4,10,0,115,115,0,32,31,0,0,1,2
"2011","E00008884","E00008884","Total",151,7,2,5,1,128,11,117,14,11,0,1,2,1
"2011","E00008867","E00008867","Total",162,35,14,21,0,87,84,3,40,40,0,0,0,0
"2011","E00008868","E00008868","Total",120,42,9,33,1,18,18,0,56,54,0,2,0,3
"2011","E00008869","E00008869","Total",128,7,1,6,0,105,104,1,16,16,0,0,0,0
"2011","E00008870","E00008870","Total",123,18,3,15,0,64,60,4,35,33,0,2,0,6
"2011","E00008897","E00008897","Total",141,13,3,10,1,109,108,1,16,14,0,2,0,2
"2011","E00008898","E00008898","Total",123,24,6,18,0,79,76,3,17,17,0,0,0,3
"2011","E00008861","E00008861","Total",201,31,9,22,0,112,104,8,58,57,0,1,0,0
"2011","E00176255","E00176255","Total",64,10,2,8,8,2,1,1,42,42,0,0,0,2
"2011","E00176261","E00176261","Total",121,29,10,19,7,12,8,4,73,72,0,1,0,0
"2011","E00176278","E00176278","Total",126,17,5,12,1,3,1,2,105,100,0,3,2,0
"2011","E00176305","E00176305","Total",131,29,13,16,1,2,2,0,98,92,1,4,1,1
"2011","E00176307","E00176307","Total",121,19,3,16,0,3,3,0,98,95,1,1,1,1
"2011","E00008834","E00008834","Total",204,62,22,40,1,3,2,1,134,133,0,1,0,4
"2011","E00176260","E00176260","Total",105,27,13,14,1,1,0,1,69,68,0,1,0,7
"2011","E00176275","E00176275","Total",112,7,2,5,0,25,3,22,77,75,0,1,1,3
"2011","E00176276","E00176276","Total",120,17,6,11,0,4,2,2,98,93,1,3,1,1
"2011","E00176308","E00176308","Total",122,7,3,4,0,3,2,1,112,107,1,2,2,0
"2011","E00176311","E00176311","Total",98,18,8,10,0,1,1,0,74,74,0,0,0,5
"2011","E00176312","E00176312","Total",101,35,10,25,0,4,1,3,58,56,0,1,1,4
"2011","E00008865","E00008865","Total",112,6,1,5,0,81,70,11,23,22,0,0,1,2
"2011","E00008900","E00008900","Total",166,18,5,13,0,115,70,45,32,27,2,1,2,1
"2011","E00008902","E00008902","Total",97,14,5,9,1,60,52,8,21,17,0,3,1,1
"2011","E00176263","E00176263","Total",76,20,7,13,20,5,4,1,31,30,0,1,0,0
"2011","E00176281","E00176281","Total",109,6,1,5,1,80,19,61,19,18,0,1,0,3
"2011","E00176283","E00176283","Total",131,7,3,4,10,20,4,16,94,88,0,3,3,0
"2011","E00176329","E00176329","Total",98,0,0,0,0,90,6,84,8,7,0,1,0,0
"2011","E00008872","E00008872","Total",151,32,11,21,2,53,50,3,61,59,0,2,0,3
"2011","E00008874","E00008874","Total",200,58,15,43,2,18,9,9,120,111,0,4,5,2
"2011","E00176282","E00176282","Total",150,29,6,23,1,59,29,30,60,58,0,2,0,1
"2011","E00008941","E00008941","Total",144,45,11,34,0,38,17,21,59,56,0,3,0,2
"2011","E00008947","E00008947","Total",138,30,13,17,0,82,47,35,24,22,0,1,1,2
"2011","E00008948","E00008948","Total",126,18,6,12,1,88,43,45,19,19,0,0,0,0
"2011","E00008960","E00008960","Total",152,12,6,6,1,78,73,5,61,58,0,2,1,0
"2011","E00008963","E00008963","Total",134,42,19,23,0,58,35,23,33,31,0,2,0,1
"2011","E00009082","E00009082","Total",134,14,6,8,1,98,24,74,19,17,0,2,0,2
"2011","E00009083","E00009083","Total",151,38,11,27,1,71,47,24,41,37,0,4,0,0
"2011","E00009103","E00009103","Total",175,56,25,31,0,72,30,42,47,44,0,3,0,0
"2011","E00009106","E00009106","Total",231,29,12,17,26,145,73,72,29,28,0,0,1,2
"2011","E00009107","E00009107","Total",140,19,5,14,0,98,59,39,20,19,0,1,0,3
"2011","E00008959","E00008959","Total",146,42,13,29,11,29,4,25,64,61,1,2,0,0
"2011","E00176246","E00176246","Total",106,46,9,37,1,29,23,6,30,27,0,3,0,0
"2011","E00176292","E00176292","Total",103,2,0,2,3,84,10,74,13,13,0,0,0,1
"2011","E00176295","E00176295","Total",125,4,0,4,25,52,9,43,44,42,0,2,0,0
"2011","E00008962","E00008962","Total",198,25,2,23,4,109,13,96,56,56,0,0,0,4
"2011","E00008965","E00008965","Total",119,19,10,9,1,79,69,10,19,19,0,0,0,1
"2011","E00176254","E00176254","Total",135,21,4,17,1,59,7,52,53,49,0,2,2,1
"2011","E00176318","E00176318","Total",124,28,7,21,4,61,6,55,29,27,0,2,0,2
"2011","E00008961","E00008961","Total",166,35,7,28,6,16,6,10,109,102,0,6,1,0
"2011","E00176273","E00176273","Total",229,37,10,27,3,47,23,24,141,136,0,3,2,1
"2011","E00176294","E00176294","Total",137,13,1,12,4,45,11,34,75,74,0,0,1,0
"2011","E00008580","E00008580","Total",190,67,34,33,2,44,21,23,72,68,0,2,2,5
"2011","E00008583","E00008583","Total",182,18,3,15,15,124,25,99,24,23,0,1,0,1
"2011","E00008602","E00008602","Total",127,13,1,12,2,82,13,69,30,28,0,0,2,0
"2011","E00008606","E00008606","Total",137,37,9,28,1,68,31,37,28,28,0,0,0,3
"2011","E00008608","E00008608","Total",224,13,3,10,3,138,36,102,67,67,0,0,0,3
"2011","E00008597","E00008597","Total",173,44,27,17,0,30,9,21,96,92,1,3,0,3
"2011","E00008599","E00008599","Total",162,37,20,17,0,90,62,28,33,33,0,0,0,2
"2011","E00008601","E00008601","Total",127,19,8,11,0,20,13,7,85,83,0,2,0,3
"2011","E00008603","E00008603","Total",165,15,7,8,0,135,24,111,8,8,0,0,0,7
"2011","E00009084","E00009084","Total",159,22,6,16,0,121,97,24,15,14,0,1,0,1
"2011","E00009109","E00009109","Total",108,13,3,10,1,74,22,52,20,19,0,0,1,0
"2011","E00009110","E00009110","Total",141,23,7,16,0,98,94,4,17,15,0,0,2,3
"2011","E00009111","E00009111","Total",147,26,13,13,0,34,20,14,85,82,0,2,1,2
"2011","E00009112","E00009112","Total",151,27,6,21,2,65,39,26,53,53,0,0,0,4
"2011","E00009101","E00009101","Total",139,20,11,9,0,73,16,57,46,42,1,3,0,0
"2011","E00009102","E00009102","Total",155,25,8,17,1,114,105,9,13,13,0,0,0,2
"2011","E00009104","E00009104","Total",144,9,3,6,0,105,37,68,28,24,0,3,1,2
"2011","E00009105","E00009105","Total",115,13,2,11,0,87,74,13,15,14,0,1,0,0
"2011","E00176284","E00176284","Total",69,32,22,10,1,11,8,3,23,20,0,3,0,2
"2011","E00176293","E00176293","Total",94,21,10,11,2,26,15,11,40,37,0,2,1,5
"2011","E00009359","E00009359","Total",101,2,0,2,4,81,3,78,10,10,0,0,0,4
"2011","E00009365","E00009365","Total",157,27,9,18,2,91,71,20,34,34,0,0,0,3
"2011","E00009367","E00009367","Total",155,6,1,5,4,108,40,68,35,34,0,0,1,2
"2011","E00009372","E00009372","Total",125,67,31,36,1,14,3,11,43,38,1,3,1,0
"2011","E00009375","E00009375","Total",123,47,17,30,1,23,7,16,51,48,0,3,0,1
"2011","E00009379","E00009379","Total",189,6,3,3,21,130,6,124,32,29,0,0,3,0
"2011","E00009384","E00009384","Total",116,18,11,7,1,83,46,37,13,11,0,1,1,1
"2011","E00009360","E00009360","Total",141,41,18,23,1,58,46,12,36,35,0,1,0,5
"2011","E00009376","E00009376","Total",144,32,16,16,0,87,8,79,25,23,0,1,1,0
"2011","E00009378","E00009378","Total",151,58,32,26,0,70,15,55,21,21,0,0,0,2
"2011","E00009380","E00009380","Total",132,27,10,17,1,78,8,70,22,19,0,1,2,4
"2011","E00009381","E00009381","Total",98,21,6,15,0,64,7,57,10,10,0,0,0,3
"2011","E00009363","E00009363","Total",113,28,11,17,0,61,45,16,22,22,0,0,0,2
"2011","E00009382","E00009382","Total",87,3,2,1,1,76,0,76,7,7,0,0,0,0
"2011","E00009383","E00009383","Total",159,10,1,9,28,111,36,75,8,7,0,0,1,2
"2011","E00167291","E00167291","Total",131,3,0,3,0,118,1,117,9,8,1,0,0,1
"2011","E00167292","E00167292","Total",131,4,1,3,2,117,2,115,8,5,0,0,3,0
"2011","E00167293","E00167293","Total",56,4,2,2,0,46,34,12,5,5,0,0,0,1
"2011","E00167294","E00167294","Total",46,9,5,4,1,28,13,15,7,7,0,0,0,1
"2011","E00167295","E00167295","Total",111,36,20,16,2,58,40,18,15,13,0,0,2,0
"2011","E00009366","E00009366","Total",81,19,11,8,1,20,2,18,41,41,0,0,0,0
"2011","E00009368","E00009368","Total",144,47,28,19,1,49,13,36,44,40,0,3,1,3
"2011","E00009369","E00009369","Total",144,40,24,16,4,49,11,38,51,48,0,2,1,0
"2011","E00009370","E00009370","Total",234,44,23,21,80,66,12,54,42,41,0,0,1,2
"2011","E00009361","E00009361","Total",119,22,9,13,1,77,6,71,18,14,0,4,0,1
"2011","E00009362","E00009362","Total",130,43,25,18,0,67,1,66,19,17,0,2,0,1
"2011","E00009373","E00009373","Total",141,26,7,19,1,98,5,93,15,14,0,1,0,1
"2011","E00009374","E00009374","Total",113,30,20,10,0,70,4,66,12,11,0,1,0,1
"2011","E00009377","E00009377","Total",102,25,11,14,1,56,10,46,18,18,0,0,0,2
"2011","E00009799","E00009799","Total",169,22,8,14,6,118,83,35,15,12,0,1,2,8
"2011","E00009801","E00009801","Total",151,27,11,16,1,91,85,6,27,26,0,1,0,5
"2011","E00009806","E00009806","Total",127,29,11,18,1,71,63,8,23,21,1,0,1,3
"2011","E00009812","E00009812","Total",109,7,1,6,0,94,89,5,8,8,0,0,0,0
"2011","E00009819","E00009819","Total",118,53,23,30,0,36,21,15,29,28,0,1,0,0
"2011","E00009800","E00009800","Total",151,21,6,15,1,106,103,3,20,20,0,0,0,3
"2011","E00009808","E00009808","Total",101,15,7,8,0,69,57,12,13,12,0,1,0,4
"2011","E00009826","E00009826","Total",113,17,9,8,0,79,68,11,17,17,0,0,0,0
"2011","E00009829","E00009829","Total",116,11,5,6,0,84,70,14,18,18,0,0,0,3
"2011","E00009831","E00009831","Total",124,17,7,10,1,81,78,3,23,23,0,0,0,2
"2011","E00009797","E00009797","Total",124,10,2,8,2,102,97,5,9,8,0,1,0,1
"2011","E00009798","E00009798","Total",109,11,1,10,0,86,85,1,9,9,0,0,0,3
"2011","E00009827","E00009827","Total",136,13,3,10,2,106,100,6,14,13,0,1,0,1
"2011","E00009828","E00009828","Total",120,9,4,5,0,100,92,8,11,11,0,0,0,0
"2011","E00009830","E00009830","Total",125,12,5,7,0,90,87,3,20,20,0,0,0,3
"2011","E00009802","E00009802","Total",129,11,8,3,1,98,91,7,16,12,0,1,3,3
"2011","E00009805","E00009805","Total",129,11,3,8,0,90,87,3,22,18,3,1,0,6
"2011","E00009807","E00009807","Total",142,14,1,13,0,102,96,6,26,26,0,0,0,0
"2011","E00009811","E00009811","Total",140,33,13,20,0,88,83,5,16,16,0,0,0,3
"2011","E00009795","E00009795","Total",135,8,2,6,2,92,41,51,31,29,0,2,0,2
"2011","E00009814","E00009814","Total",132,86,36,50,1,15,12,3,30,28,0,1,1,0
"2011","E00009815","E00009815","Total",124,33,18,15,0,81,7,74,6,6,0,0,0,4
"2011","E00009820","E00009820","Total",114,81,36,45,0,14,7,7,19,16,0,2,1,0
"2011","E00009822","E00009822","Total",144,31,11,20,3,66,8,58,37,32,0,3,2,7
"2011","E00009794","E00009794","Total",134,6,4,2,1,110,8,102,14,13,0,0,1,3
"2011","E00009809","E00009809","Total",106,14,7,7,0,74,20,54,16,13,0,1,2,2
"2011","E00009816","E00009816","Total",121,89,40,49,0,9,2,7,22,21,0,1,0,1
"2011","E00009821","E00009821","Total",130,95,52,43,1,9,6,3,24,24,0,0,0,1
"2011","E00009825","E00009825","Total",112,48,19,29,0,28,22,6,34,34,0,0,0,2
"2011","E00009796","E00009796","Total",125,47,25,22,4,57,50,7,14,14,0,0,0,3
"2011","E00009803","E00009803","Total",164,45,21,24,21,74,44,30,21,19,0,0,2,3
"2011","E00009804","E00009804","Total",182,46,24,22,2,116,41,75,15,15,0,0,0,3
"2011","E00009810","E00009810","Total",117,61,34,27,0,31,28,3,23,22,0,0,1,2
"2011","E00009813","E00009813","Total",116,62,29,33,0,6,3,3,48,44,0,4,0,0
"2011","E00009817","E00009817","Total",146,57,23,34,3,12,0,12,71,67,0,4,0,3
"2011","E00009818","E00009818","Total",130,61,31,30,0,18,4,14,50,48,0,2,0,1
"2011","E00009823","E00009823","Total",163,49,23,26,0,50,32,18,64,63,0,1,0,0
"2011","E00009824","E00009824","Total",195,44,16,28,14,73,8,65,60,57,0,3,0,4
"2011","E00009723","E00009723","Total",143,13,4,9,0,30,6,24,98,95,2,0,1,2
"2011","E00009729","E00009729","Total",135,18,11,7,0,56,14,42,60,58,2,0,0,1
"2011","E00009736","E00009736","Total",110,33,13,20,0,29,10,19,44,42,0,2,0,4
"2011","E00009744","E00009744","Total",142,44,21,23,5,45,25,20,47,45,0,2,0,1
"2011","E00009749","E00009749","Total",104,22,13,9,0,47,29,18,35,34,0,0,1,0
"2011","E00167281","E00167281","Total",160,52,24,28,6,23,5,18,79,76,0,3,0,0
"2011","E00167282","E00167282","Total",111,21,10,11,29,48,14,34,11,11,0,0,0,2
"2011","E00009738","E00009738","Total",174,14,5,9,0,147,142,5,13,13,0,0,0,0
"2011","E00009739","E00009739","Total",75,7,5,2,0,56,51,5,11,11,0,0,0,1
"2011","E00009740","E00009740","Total",172,15,6,9,2,141,135,6,9,8,0,0,1,5
"2011","E00009746","E00009746","Total",201,16,8,8,1,167,161,6,12,12,0,0,0,5
"2011","E00167283","E00167283","Total",138,25,9,16,1,76,69,7,36,32,1,2,1,0
"2011","E00167284","E00167284","Total",109,19,8,11,1,62,13,49,26,26,0,0,0,1
"2011","E00009732","E00009732","Total",173,35,17,18,0,106,34,72,29,25,0,4,0,3
"2011","E00009737","E00009737","Total",120,42,19,23,0,34,12,22,44,40,0,3,1,0
"2011","E00009741","E00009741","Total",144,48,26,22,0,49,5,44,44,44,0,0,0,3
"2011","E00009742","E00009742","Total",109,48,26,22,1,21,5,16,38,38,0,0,0,1
"2011","E00009743","E00009743","Total",103,65,31,34,0,7,0,7,29,28,0,1,0,2
"2011","E00009745","E00009745","Total",105,41,14,27,1,25,5,20,35,34,0,1,0,3
"2011","E00009730","E00009730","Total",117,12,5,7,1,81,75,6,21,19,0,2,0,2
"2011","E00009733","E00009733","Total",117,46,23,23,0,37,8,29,34,33,0,1,0,0
"2011","E00009734","E00009734","Total",134,45,25,20,0,45,3,42,41,40,0,1,0,3
"2011","E00009735","E00009735","Total",99,41,19,22,0,15,5,10,43,41,0,2,0,0
"2011","E00009747","E00009747","Total",121,28,14,14,3,38,19,19,50,48,0,2,0,2
"2011","E00009751","E00009751","Total",114,27,9,18,1,53,8,45,33,33,0,0,0,0
"2011","E00009275","E00009275","Total",115,27,5,22,0,55,40,15,31,30,0,1,0,2
"2011","E00009279","E00009279","Total",133,35,9,26,0,60,34,26,37,37,0,0,0,1
"2011","E00009293","E00009293","Total",127,37,16,21,0,59,29,30,29,26,0,3,0,2
"2011","E00009294","E00009294","Total",151,31,14,17,3,78,8,70,38,34,0,3,1,1
"2011","E00009295","E00009295","Total",177,31,7,24,0,101,49,52,42,39,0,3,0,3
"2011","E00009309","E00009309","Total",127,55,23,32,1,34,3,31,34,33,0,1,0,3
"2011","E00009724","E00009724","Total",136,43,17,26,1,40,5,35,50,48,0,0,2,2
"2011","E00009725","E00009725","Total",160,45,24,21,4,41,5,36,68,67,0,1,0,2
"2011","E00009726","E00009726","Total",159,17,8,9,19,92,44,48,30,28,0,1,1,1
"2011","E00009727","E00009727","Total",116,19,5,14,1,55,16,39,40,39,0,1,0,1
"2011","E00009728","E00009728","Total",169,24,8,16,2,56,40,16,83,83,0,0,0,4
"2011","E00009718","E00009718","Total",174,53,34,19,2,12,2,10,107,107,0,0,0,0
"2011","E00009720","E00009720","Total",133,38,14,24,8,47,8,39,39,38,0,1,0,1
"2011","E00009722","E00009722","Total",147,30,12,18,8,24,2,22,84,78,0,6,0,1
"2011","E00009750","E00009750","Total",106,7,4,3,0,21,14,7,78,76,0,1,1,0
"2011","E00009753","E00009753","Total",157,44,14,30,2,44,10,34,64,64,0,0,0,3
"2011","E00009721","E00009721","Total",180,47,22,25,2,56,22,34,74,72,1,1,0,1
"2011","E00009748","E00009748","Total",121,22,9,13,1,16,14,2,80,78,0,0,2,2
"2011","E00009752","E00009752","Total",151,43,19,24,2,40,10,30,60,58,0,2,0,6
"2011","E00009754","E00009754","Total",112,41,16,25,0,39,10,29,29,29,0,0,0,3
"2011","E00009755","E00009755","Total",132,31,13,18,2,38,7,31,57,55,0,0,2,4
"2011","E00009756","E00009756","Total",169,51,27,24,0,45,6,39,67,66,0,1,0,6
"2011","E00009273","E00009273","Total",149,48,26,22,1,54,49,5,42,40,1,0,1,4
"2011","E00009285","E00009285","Total",131,54,14,40,6,22,3,19,48,47,0,1,0,1
"2011","E00009297","E00009297","Total",161,47,20,27,5,64,19,45,44,43,0,1,0,1
"2011","E00009298","E00009298","Total",149,25,7,18,8,80,21,59,34,33,0,1,0,2
"2011","E00009313","E00009313","Total",142,34,13,21,5,48,14,34,52,48,0,4,0,3
"2011","E00009271","E00009271","Total",126,13,5,8,0,94,77,17,14,14,0,0,0,5
"2011","E00009276","E00009276","Total",163,37,15,22,0,40,11,29,85,83,0,1,1,1
"2011","E00009280","E00009280","Total",117,34,10,24,7,32,2,30,42,41,0,1,0,2
"2011","E00009282","E00009282","Total",135,32,13,19,1,83,51,32,19,18,0,0,1,0
"2011","E00009284","E00009284","Total",105,13,5,8,16,65,6,59,11,11,0,0,0,0
"2011","E00009296","E00009296","Total",149,26,6,20,2,37,16,21,83,81,2,0,0,1
"2011","E00009274","E00009274","Total",133,31,12,19,4,43,3,40,51,51,0,0,0,4
"2011","E00009277","E00009277","Total",133,40,9,31,0,42,6,36,51,48,0,3,0,0
"2011","E00009278","E00009278","Total",162,42,20,22,0,82,11,71,36,36,0,0,0,2
"2011","E00009281","E00009281","Total",125,22,8,14,1,78,72,6,24,23,0,1,0,0
"2011","E00009283","E00009283","Total",101,62,24,38,1,16,3,13,22,21,0,1,0,0
"2011","E00009272","E00009272","Total",110,65,31,34,0,14,1,13,31,27,0,4,0,0
"2011","E00009287","E00009287","Total",134,66,28,38,13,24,2,22,30,29,0,1,0,1
"2011","E00009303","E00009303","Total",147,60,21,39,0,36,8,28,50,49,0,1,0,1
"2011","E00009306","E00009306","Total",139,48,15,33,2,39,11,28,48,48,0,0,0,2
"2011","E00009307","E00009307","Total",141,67,22,45,0,43,6,37,30,28,0,2,0,1
"2011","E00009286","E00009286","Total",143,66,34,32,0,41,8,33,32,29,0,1,2,4
"2011","E00009288","E00009288","Total",163,22,9,13,3,95,81,14,41,41,0,0,0,2
"2011","E00009289","E00009289","Total",114,50,30,20,8,27,1,26,28,26,0,1,1,1
"2011","E00009299","E00009299","Total",116,51,23,28,0,37,2,35,28,27,0,0,1,0
"2011","E00009300","E00009300","Total",106,19,7,12,2,21,1,20,61,60,1,0,0,3
"2011","E00009302","E00009302","Total",119,19,5,14,5,5,0,5,89,89,0,0,0,1
"2011","E00009229","E00009229","Total",140,55,20,35,1,18,2,16,65,64,0,1,0,1
"2011","E00009239","E00009239","Total",150,60,23,37,1,10,4,6,79,78,0,0,1,0
"2011","E00009243","E00009243","Total",81,23,6,17,1,20,1,19,36,34,1,1,0,1
"2011","E00009245","E00009245","Total",88,39,17,22,0,12,4,8,37,35,0,2,0,0
"2011","E00009258","E00009258","Total",151,56,19,37,0,34,4,30,59,57,1,0,1,2
"2011","E00009263","E00009263","Total",136,50,21,29,2,31,5,26,52,47,0,4,1,1
"2011","E00009268","E00009268","Total",84,35,12,23,1,3,2,1,44,41,0,3,0,1
"2011","E00009270","E00009270","Total",126,57,21,36,0,18,6,12,51,49,1,1,0,0
"2011","E00009230","E00009230","Total",184,79,37,42,0,29,11,18,73,70,0,3,0,3
"2011","E00009240","E00009240","Total",107,66,31,35,1,9,7,2,30,28,0,2,0,1
"2011","E00009247","E00009247","Total",148,53,20,33,0,22,7,15,73,68,0,3,2,0
"2011","E00009253","E00009253","Total",133,43,19,24,1,25,4,21,64,64,0,0,0,0
"2011","E00009269","E00009269","Total",123,56,19,37,0,31,6,25,34,33,0,1,0,2
"2011","E00009228","E00009228","Total",151,57,20,37,1,39,22,17,52,49,0,3,0,2
"2011","E00009234","E00009234","Total",129,38,13,25,0,47,41,6,43,41,0,2,0,1
"2011","E00009235","E00009235","Total",98,34,16,18,3,20,3,17,40,38,0,2,0,1
"2011","E00009236","E00009236","Total",112,43,13,30,0,33,8,25,36,36,0,0,0,0
"2011","E00009238","E00009238","Total",129,23,8,15,1,22,11,11,79,76,0,3,0,4
"2011","E00009266","E00009266","Total",112,40,16,24,1,29,14,15,40,38,0,1,1,2
"2011","E00009267","E00009267","Total",156,89,36,53,0,5,0,5,61,56,0,4,1,1
"2011","E00009227","E00009227","Total",128,21,13,8,0,71,50,21,34,32,0,2,0,2
"2011","E00009259","E00009259","Total",91,19,10,9,2,54,51,3,14,13,1,0,0,2
"2011","E00009260","E00009260","Total",97,18,5,13,1,66,65,1,12,10,0,1,1,0
"2011","E00009261","E00009261","Total",113,13,6,7,0,30,5,25,70,68,1,1,0,0
"2011","E00009262","E00009262","Total",119,22,11,11,0,85,82,3,10,9,0,1,0,2
"2011","E00009264","E00009264","Total",103,16,5,11,0,75,73,2,10,9,0,0,1,2
"2011","E00009265","E00009265","Total",82,23,11,12,0,5,2,3,53,52,0,1,0,1
"2011","E00009308","E00009308","Total",121,49,17,32,5,4,2,2,62,61,0,1,0,1
"2011","E00009310","E00009310","Total",110,63,25,38,0,20,0,20,26,24,0,2,0,1
"2011","E00009311","E00009311","Total",130,92,32,60,1,6,2,4,31,28,0,3,0,0
"2011","E00009312","E00009312","Total",116,14,6,8,0,87,80,7,15,14,0,1,0,0
"2011","E00009314","E00009314","Total",130,16,3,13,0,94,84,10,17,14,0,3,0,3
"2011","E00167285","E00167285","Total",143,4,2,2,53,74,5,69,12,11,0,1,0,0
"2011","E00167286","E00167286","Total",180,55,12,43,21,57,8,49,44,42,0,2,0,3
"2011","E00167287","E00167287","Total",117,51,18,33,2,4,3,1,58,56,0,1,1,2
"2011","E00167288","E00167288","Total",93,7,1,6,2,53,9,44,31,30,0,1,0,0
"2011","E00009291","E00009291","Total",126,55,20,35,0,23,6,17,47,42,0,4,1,1
"2011","E00009292","E00009292","Total",146,78,26,52,0,21,12,9,45,43,0,1,1,2
"2011","E00009301","E00009301","Total",141,69,29,40,1,19,3,16,51,48,0,2,1,1
"2011","E00009304","E00009304","Total",138,42,22,20,1,48,5,43,45,40,0,5,0,2
"2011","E00009305","E00009305","Total",100,74,43,31,0,9,3,6,16,16,0,0,0,1
"2011","E00009675","E00009675","Total",128,50,22,28,0,18,4,14,60,58,0,1,1,0
"2011","E00009676","E00009676","Total",132,110,69,41,0,9,4,5,13,11,0,1,1,0
"2011","E00009677","E00009677","Total",93,60,36,24,0,3,2,1,29,25,0,4,0,1
"2011","E00009678","E00009678","Total",96,77,43,34,0,1,1,0,16,16,0,0,0,2
"2011","E00009680","E00009680","Total",108,80,43,37,0,4,3,1,24,23,0,1,0,0
"2011","E00009645","E00009645","Total",125,78,47,31,1,25,18,7,20,17,0,2,1,1
"2011","E00009660","E00009660","Total",123,43,26,17,3,9,3,6,67,66,0,1,0,1
"2011","E00009664","E00009664","Total",79,16,11,5,0,50,44,6,12,11,0,1,0,1
"2011","E00009674","E00009674","Total",108,52,15,37,2,24,6,18,30,30,0,0,0,0
"2011","E00009681","E00009681","Total",107,9,5,4,0,76,0,76,22,19,0,0,3,0
"2011","E00167289","E00167289","Total",82,44,13,31,0,9,2,7,29,28,0,1,0,0
"2011","E00167290","E00167290","Total",113,40,17,23,1,40,4,36,29,28,0,1,0,3
"2011","E00167296","E00167296","Total",105,5,2,3,4,82,6,76,13,12,1,0,0,1
"2011","E00009459","E00009459","Total",115,31,10,21,1,41,16,25,41,38,1,2,0,1
"2011","E00009471","E00009471","Total",116,40,15,25,0,33,8,25,43,40,0,3,0,0
"2011","E00009472","E00009472","Total",127,65,34,31,0,30,7,23,28,27,1,0,0,4
"2011","E00009475","E00009475","Total",113,30,12,18,1,33,15,18,47,44,1,2,0,2
"2011","E00009478","E00009478","Total",102,39,20,19,0,27,5,22,31,31,0,0,0,5
"2011","E00009479","E00009479","Total",101,50,18,32,0,21,3,18,29,29,0,0,0,1
"2011","E00009468","E00009468","Total",111,52,22,30,0,27,3,24,31,30,0,1,0,1
"2011","E00009469","E00009469","Total",112,19,10,9,0,85,53,32,8,7,0,0,1,0
"2011","E00009470","E00009470","Total",120,41,18,23,1,39,7,32,38,37,0,1,0,1
"2011","E00009473","E00009473","Total",99,23,12,11,0,56,1,55,18,18,0,0,0,2
"2011","E00009474","E00009474","Total",99,35,15,20,0,20,8,12,43,39,0,4,0,1
"2011","E00009476","E00009476","Total",128,36,10,26,2,7,1,6,83,80,0,3,0,0
"2011","E00009460","E00009460","Total",123,51,31,20,0,26,2,24,46,46,0,0,0,0
"2011","E00009477","E00009477","Total",118,37,23,14,1,35,13,22,45,44,0,1,0,0
"2011","E00009480","E00009480","Total",142,71,33,38,1,27,3,24,43,38,0,3,2,0
"2011","E00009481","E00009481","Total",121,78,39,39,0,22,4,18,21,21,0,0,0,0
"2011","E00009484","E00009484","Total",115,46,23,23,0,36,2,34,31,30,1,0,0,2
"2011","E00009649","E00009649","Total",126,87,45,42,0,16,1,15,21,20,1,0,0,2
"2011","E00009655","E00009655","Total",121,77,51,26,0,10,2,8,30,29,0,1,0,4
"2011","E00009656","E00009656","Total",116,71,41,30,1,10,4,6,32,29,0,3,0,2
"2011","E00009657","E00009657","Total",104,58,36,22,1,13,11,2,32,29,0,3,0,0
"2011","E00009663","E00009663","Total",130,61,20,41,0,19,6,13,46,44,0,1,1,4
"2011","E00009232","E00009232","Total",94,59,35,24,0,11,4,7,24,24,0,0,0,0
"2011","E00009233","E00009233","Total",160,96,44,52,2,3,1,2,55,48,1,6,0,4
"2011","E00009237","E00009237","Total",133,62,32,30,0,21,10,11,49,48,0,1,0,1
"2011","E00009249","E00009249","Total",112,47,22,25,0,32,17,15,31,30,0,1,0,2
"2011","E00009250","E00009250","Total",103,34,13,21,0,27,6,21,41,40,0,1,0,1
"2011","E00009256","E00009256","Total",94,46,26,20,0,14,1,13,34,33,0,1,0,0
"2011","E00009231","E00009231","Total",98,51,26,25,1,15,11,4,30,27,0,2,1,1
"2011","E00009241","E00009241","Total",110,47,15,32,0,16,1,15,46,45,0,1,0,1
"2011","E00009244","E00009244","Total",247,105,39,66,1,38,13,25,102,99,0,3,0,1
"2011","E00009246","E00009246","Total",97,34,19,15,1,35,6,29,26,26,0,0,0,1
"2011","E00009251","E00009251","Total",188,66,27,39,0,26,2,24,95,89,0,6,0,1
"2011","E00009252","E00009252","Total",154,59,22,37,0,23,3,20,70,68,0,2,0,2
"2011","E00009242","E00009242","Total",116,23,4,19,1,69,53,16,21,20,0,0,1,2
"2011","E00009248","E00009248","Total",178,29,13,16,1,48,4,44,99,97,1,1,0,1
"2011","E00009254","E00009254","Total",158,51,33,18,0,28,7,21,77,72,1,4,0,2
"2011","E00009255","E00009255","Total",144,11,8,3,1,105,11,94,26,26,0,0,0,1
"2011","E00009257","E00009257","Total",134,53,30,23,0,37,7,30,41,41,0,0,0,3
"2011","E00009334","E00009334","Total",126,75,49,26,1,13,4,9,29,23,0,4,2,8
"2011","E00009337","E00009337","Total",96,55,29,26,0,8,2,6,33,32,0,1,0,0
"2011","E00009338","E00009338","Total",57,18,13,5,0,9,2,7,28,25,0,3,0,2
"2011","E00009339","E00009339","Total",116,31,17,14,0,16,0,16,68,68,0,0,0,1
"2011","E00009341","E00009341","Total",73,34,20,14,0,15,2,13,21,11,5,4,1,3
"2011","E00009343","E00009343","Total",106,40,28,12,2,32,1,31,30,30,0,0,0,2
"2011","E00009315","E00009315","Total",215,57,29,28,1,29,10,19,126,121,0,4,1,2
"2011","E00009320","E00009320","Total",141,87,47,40,2,29,12,17,23,22,1,0,0,0
"2011","E00009333","E00009333","Total",85,27,13,14,1,21,18,3,35,32,0,3,0,1
"2011","E00009335","E00009335","Total",122,26,15,11,1,77,36,41,17,15,0,2,0,1
"2011","E00009336","E00009336","Total",126,14,4,10,0,94,67,27,17,15,0,2,0,1
"2011","E00009646","E00009646","Total",106,46,27,19,1,20,3,17,36,32,1,3,0,3
"2011","E00009647","E00009647","Total",104,42,18,24,1,22,6,16,39,37,1,0,1,0
"2011","E00009648","E00009648","Total",154,72,39,33,1,18,8,10,58,56,0,0,2,5
"2011","E00009651","E00009651","Total",124,40,22,18,0,58,8,50,24,23,1,0,0,2
"2011","E00009659","E00009659","Total",96,21,6,15,0,58,52,6,15,15,0,0,0,2
"2011","E00009679","E00009679","Total",138,67,33,34,12,31,7,24,27,23,1,3,0,1
"2011","E00009652","E00009652","Total",96,33,13,20,0,8,4,4,54,54,0,0,0,1
"2011","E00009658","E00009658","Total",197,67,35,32,23,53,8,45,53,53,0,0,0,1
"2011","E00009665","E00009665","Total",124,19,5,14,0,82,15,67,21,20,0,1,0,2
"2011","E00009666","E00009666","Total",107,46,19,27,0,15,0,15,46,39,0,6,1,0
"2011","E00009667","E00009667","Total",185,62,22,40,1,3,1,2,117,114,0,2,1,2
"2011","E00009644","E00009644","Total",173,77,41,36,6,16,8,8,72,70,1,1,0,2
"2011","E00009653","E00009653","Total",159,32,18,14,1,23,23,0,101,97,1,3,0,2
"2011","E00009661","E00009661","Total",121,18,6,12,2,70,59,11,29,27,0,2,0,2
"2011","E00009662","E00009662","Total",168,40,18,22,1,35,10,25,90,83,2,3,2,2
"2011","E00009669","E00009669","Total",136,34,15,19,1,65,12,53,33,30,0,2,1,3
"2011","E00009654","E00009654","Total",123,25,12,13,23,62,12,50,13,11,0,2,0,0
"2011","E00009668","E00009668","Total",91,22,10,12,0,16,1,15,50,45,2,3,0,3
"2011","E00009670","E00009670","Total",119,63,47,16,0,26,19,7,26,23,1,0,2,4
"2011","E00009671","E00009671","Total",109,85,56,29,0,6,3,3,16,15,0,1,0,2
"2011","E00009672","E00009672","Total",97,68,46,22,0,8,8,0,21,18,0,2,1,0
"2011","E00009673","E00009673","Total",96,60,32,28,0,6,3,3,29,27,0,0,2,1
"2011","E00009316","E00009316","Total",159,47,20,27,9,28,19,9,75,66,1,3,5,0
"2011","E00009342","E00009342","Total",135,47,17,30,1,7,1,6,75,69,0,4,2,5
"2011","E00009344","E00009344","Total",112,54,23,31,0,9,3,6,45,43,1,1,0,4
"2011","E00009345","E00009345","Total",94,26,14,12,0,32,1,31,34,33,0,1,0,2
"2011","E00009353","E00009353","Total",104,60,33,27,0,3,1,2,39,36,1,2,0,2
"2011","E00009355","E00009355","Total",100,54,41,13,1,14,9,5,31,30,0,0,1,0
"2011","E00009330","E00009330","Total",137,84,38,46,3,0,0,0,49,45,1,1,2,1
"2011","E00009354","E00009354","Total",356,142,71,71,4,5,3,2,197,187,1,7,2,8
"2011","E00167297","E00167297","Total",119,17,10,7,1,83,78,5,17,16,1,0,0,1
"2011","E00009321","E00009321","Total",206,22,8,14,1,65,10,55,116,115,0,0,1,2
"2011","E00009346","E00009346","Total",93,12,2,10,0,73,19,54,8,7,0,0,1,0
"2011","E00009348","E00009348","Total",92,12,0,12,0,68,65,3,9,8,0,1,0,3
"2011","E00009349","E00009349","Total",93,1,0,1,0,83,7,76,5,5,0,0,0,4
"2011","E00009351","E00009351","Total",119,19,13,6,0,73,72,1,26,24,0,0,2,1
"2011","E00009317","E00009317","Total",172,36,11,25,0,44,8,36,89,88,0,1,0,3
"2011","E00009324","E00009324","Total",157,66,22,44,0,19,17,2,70,66,0,3,1,2
"2011","E00009327","E00009327","Total",171,83,33,50,1,7,0,7,78,73,0,5,0,2
"2011","E00009328","E00009328","Total",149,51,24,27,0,8,4,4,90,86,1,3,0,0
"2011","E00009331","E00009331","Total",160,47,27,20,0,23,9,14,88,85,0,1,2,2
"2011","E00009350","E00009350","Total",200,45,17,28,0,30,6,24,123,120,1,2,0,2
"2011","E00009318","E00009318","Total",150,29,13,16,1,67,34,33,51,50,0,0,1,2
"2011","E00009325","E00009325","Total",108,48,30,18,1,2,1,1,53,47,0,5,1,4
"2011","E00009340","E00009340","Total",150,69,47,22,0,4,1,3,67,62,0,4,1,10
"2011","E00009352","E00009352","Total",104,27,12,15,0,19,5,14,55,53,0,1,1,3
"2011","E00009357","E00009357","Total",105,59,36,23,0,1,1,0,43,41,0,2,0,2
"2011","E00009358","E00009358","Total",152,76,46,30,0,3,1,2,71,66,1,3,1,2
"2011","E00009319","E00009319","Total",187,60,24,36,0,28,10,18,95,92,0,3,0,4
"2011","E00009322","E00009322","Total",116,41,21,20,2,19,9,10,53,49,0,2,2,1
"2011","E00009326","E00009326","Total",119,40,18,22,0,37,9,28,40,38,0,2,0,2
"2011","E00009329","E00009329","Total",123,43,16,27,1,21,7,14,58,51,1,0,6,0
"2011","E00009332","E00009332","Total",113,48,11,37,1,15,4,11,48,46,0,2,0,1
"2011","E00009356","E00009356","Total",101,31,21,10,1,21,14,7,44,40,1,1,2,4
"2011","E00009466","E00009466","Total",126,5,2,3,0,101,24,77,19,18,0,0,1,1
"2011","E00009467","E00009467","Total",90,50,20,30,0,13,10,3,27,25,0,2,0,0
"2011","E00009496","E00009496","Total",98,11,7,4,0,76,73,3,8,7,0,1,0,3
"2011","E00009497","E00009497","Total",103,18,2,16,1,54,42,12,30,29,0,1,0,0
"2011","E00009501","E00009501","Total",87,13,7,6,0,53,50,3,19,19,0,0,0,2
"2011","E00009465","E00009465","Total",95,41,32,9,0,27,6,21,25,25,0,0,0,2
"2011","E00009489","E00009489","Total",156,34,21,13,0,50,13,37,66,65,0,1,0,6
"2011","E00009492","E00009492","Total",116,21,6,15,0,78,75,3,14,13,1,0,0,3
"2011","E00009495","E00009495","Total",115,10,2,8,0,90,67,23,14,13,0,1,0,1
"2011","E00009500","E00009500","Total",120,46,28,18,1,17,16,1,54,50,0,4,0,2
"2011","E00009461","E00009461","Total",180,62,26,36,0,52,17,35,64,64,0,0,0,2
"2011","E00009482","E00009482","Total",121,38,8,30,0,11,6,5,72,72,0,0,0,0
"2011","E00009483","E00009483","Total",109,34,20,14,0,19,4,15,55,50,0,5,0,1
"2011","E00009485","E00009485","Total",116,33,15,18,0,25,5,20,56,53,1,2,0,2
"2011","E00009487","E00009487","Total",134,41,30,11,16,19,9,10,49,46,2,0,1,9
"2011","E00009488","E00009488","Total",76,19,9,10,1,12,8,4,41,40,1,0,0,3
"2011","E00009486","E00009486","Total",128,17,9,8,8,83,37,46,19,18,0,0,1,1
"2011","E00009490","E00009490","Total",117,40,16,24,3,31,7,24,39,34,1,3,1,4
"2011","E00009491","E00009491","Total",223,10,3,7,0,195,187,8,16,16,0,0,0,2
"2011","E00009493","E00009493","Total",113,18,9,9,2,78,73,5,13,12,0,1,0,2
"2011","E00009494","E00009494","Total",110,9,6,3,0,61,2,59,35,34,1,0,0,5
"2011","E00009462","E00009462","Total",162,20,8,12,1,82,18,64,54,53,0,1,0,5
"2011","E00009463","E00009463","Total",205,75,40,35,1,32,10,22,94,86,0,8,0,3
"2011","E00009464","E00009464","Total",132,35,18,17,0,72,5,67,23,23,0,0,0,2
"2011","E00009498","E00009498","Total",101,0,0,0,1,89,6,83,7,5,0,2,0,4
"2011","E00009499","E00009499","Total",123,9,2,7,2,95,7,88,17,15,0,1,1,0
"2011","E00009435","E00009435","Total",108,63,29,34,1,8,8,0,34,32,0,2,0,2
"2011","E00009437","E00009437","Total",113,67,30,37,0,11,8,3,34,32,0,2,0,1
"2011","E00009439","E00009439","Total",149,70,21,49,0,19,10,9,59,53,1,5,0,1
"2011","E00009441","E00009441","Total",93,36,14,22,3,23,2,21,30,28,0,2,0,1
"2011","E00009443","E00009443","Total",130,38,17,21,2,55,16,39,33,31,0,2,0,2
"2011","E00009541","E00009541","Total",157,47,19,28,0,33,7,26,75,72,1,2,0,2
"2011","E00009543","E00009543","Total",64,27,14,13,0,7,1,6,30,29,1,0,0,0
"2011","E00009548","E00009548","Total",140,20,6,14,0,36,26,10,81,77,0,1,3,3
"2011","E00009551","E00009551","Total",106,32,15,17,1,20,3,17,52,47,0,3,2,1
"2011","E00009554","E00009554","Total",107,41,13,28,0,27,20,7,39,38,0,1,0,0
"2011","E00009555","E00009555","Total",156,54,16,38,0,32,10,22,69,69,0,0,0,1
"2011","E00009563","E00009563","Total",110,31,15,16,1,24,15,9,52,46,0,6,0,2
"2011","E00009545","E00009545","Total",137,66,25,41,1,2,2,0,63,57,1,5,0,5
"2011","E00009546","E00009546","Total",133,64,37,27,1,2,1,1,61,55,1,5,0,5
"2011","E00009567","E00009567","Total",137,53,27,26,0,12,1,11,70,64,1,2,3,2
"2011","E00009572","E00009572","Total",114,33,16,17,1,10,3,7,67,62,0,4,1,3
"2011","E00009578","E00009578","Total",121,64,26,38,0,2,1,1,54,51,0,2,1,1
"2011","E00009579","E00009579","Total",132,59,21,38,3,1,0,1,68,63,0,5,0,1
"2011","E00009540","E00009540","Total",128,38,15,23,0,24,7,17,64,55,0,5,4,2
"2011","E00009547","E00009547","Total",115,32,16,16,1,3,0,3,74,69,1,4,0,5
"2011","E00009549","E00009549","Total",135,17,3,14,3,40,13,27,75,74,0,0,1,0
"2011","E00009550","E00009550","Total",106,35,9,26,0,12,5,7,58,58,0,0,0,1
"2011","E00009552","E00009552","Total",139,48,16,32,2,22,13,9,65,62,0,2,1,2
"2011","E00009553","E00009553","Total",143,30,13,17,0,33,14,19,79,76,0,2,1,1
"2011","E00009557","E00009557","Total",121,24,7,17,1,40,31,9,54,50,1,0,3,2
"2011","E00009405","E00009405","Total",148,13,5,8,0,120,116,4,13,13,0,0,0,2
"2011","E00009410","E00009410","Total",84,9,6,3,1,69,68,1,4,2,0,1,1,1
"2011","E00009411","E00009411","Total",121,7,3,4,0,100,69,31,11,8,0,1,2,3
"2011","E00009414","E00009414","Total",69,9,5,4,0,53,48,5,6,6,0,0,0,1
"2011","E00009418","E00009418","Total",116,13,2,11,1,81,70,11,17,16,0,1,0,4
"2011","E00009542","E00009542","Total",118,22,10,12,0,15,2,13,81,81,0,0,0,0
"2011","E00009559","E00009559","Total",125,40,16,24,0,3,1,2,80,76,0,4,0,2
"2011","E00009562","E00009562","Total",173,37,10,27,0,29,10,19,106,105,0,0,1,1
"2011","E00009565","E00009565","Total",165,53,20,33,0,32,1,31,75,72,1,1,1,5
"2011","E00009568","E00009568","Total",149,47,16,31,2,34,23,11,66,61,0,0,5,0
"2011","E00009569","E00009569","Total",145,55,21,34,0,6,4,2,82,77,3,2,0,2
"2011","E00009538","E00009538","Total",125,24,11,13,1,57,42,15,39,34,2,3,0,4
"2011","E00009544","E00009544","Total",172,60,21,39,0,29,10,19,82,81,0,1,0,1
"2011","E00009570","E00009570","Total",126,20,9,11,1,76,68,8,27,26,1,0,0,2
"2011","E00009571","E00009571","Total",127,68,25,43,0,24,10,14,33,32,0,1,0,2
"2011","E00009575","E00009575","Total",141,33,17,16,0,59,40,19,43,39,0,2,2,6
"2011","E00009580","E00009580","Total",130,48,16,32,1,37,15,22,42,41,0,1,0,2
"2011","E00009558","E00009558","Total",133,32,11,21,2,64,53,11,32,29,0,3,0,3
"2011","E00009560","E00009560","Total",128,13,6,7,0,94,80,14,18,15,0,1,2,3
"2011","E00009564","E00009564","Total",118,11,3,8,2,87,82,5,16,16,0,0,0,2
"2011","E00009566","E00009566","Total",163,31,13,18,20,90,67,23,17,17,0,0,0,5
"2011","E00009573","E00009573","Total",79,8,3,5,0,62,43,19,5,5,0,0,0,4
"2011","E00009577","E00009577","Total",130,38,6,32,1,53,13,40,36,31,1,3,1,2
"2011","E00009539","E00009539","Total",128,11,2,9,0,78,69,9,38,38,0,0,0,1
"2011","E00009556","E00009556","Total",111,18,9,9,2,84,71,13,5,5,0,0,0,2
"2011","E00009561","E00009561","Total",124,35,14,21,0,27,20,7,52,49,0,2,1,10
"2011","E00009574","E00009574","Total",127,14,3,11,2,81,78,3,23,23,0,0,0,7
"2011","E00009576","E00009576","Total",110,15,9,6,1,81,69,12,9,9,0,0,0,4
"2011","E00009426","E00009426","Total",127,33,10,23,1,50,48,2,39,37,0,1,1,4
"2011","E00009427","E00009427","Total",121,21,8,13,1,68,51,17,29,26,0,3,0,2
"2011","E00009428","E00009428","Total",97,41,25,16,2,20,17,3,32,31,0,1,0,2
"2011","E00009431","E00009431","Total",143,88,34,54,1,12,6,6,41,40,0,1,0,1
"2011","E00009433","E00009433","Total",140,23,7,16,1,93,70,23,18,18,0,0,0,5
"2011","E00009423","E00009423","Total",135,33,10,23,1,83,76,7,17,17,0,0,0,1
"2011","E00009425","E00009425","Total",140,40,6,34,0,40,9,31,60,53,1,5,1,0
"2011","E00009434","E00009434","Total",131,17,5,12,2,66,21,45,46,45,0,1,0,0
"2011","E00009456","E00009456","Total",132,69,39,30,1,23,8,15,39,37,0,1,1,0
"2011","E00009458","E00009458","Total",120,25,18,7,2,74,68,6,18,17,0,0,1,1
"2011","E00009440","E00009440","Total",250,9,7,2,0,203,1,202,38,23,8,0,7,0
"2011","E00009444","E00009444","Total",274,14,6,8,0,207,45,162,52,44,2,1,5,1
"2011","E00009447","E00009447","Total",113,56,20,36,0,23,10,13,32,30,0,2,0,2
"2011","E00009451","E00009451","Total",141,67,29,38,0,7,3,4,64,56,0,8,0,3
"2011","E00009453","E00009453","Total",172,44,21,23,1,26,18,8,97,91,0,6,0,4
"2011","E00009436","E00009436","Total",93,8,4,4,0,68,65,3,15,14,0,0,1,2
"2011","E00009442","E00009442","Total",119,21,8,13,1,82,79,3,11,11,0,0,0,4
"2011","E00009446","E00009446","Total",116,16,2,14,1,80,78,2,15,15,0,0,0,4
"2011","E00009448","E00009448","Total",134,49,19,30,0,54,10,44,29,29,0,0,0,2
"2011","E00009450","E00009450","Total",143,73,31,42,0,19,7,12,51,46,0,5,0,0
"2011","E00009389","E00009389","Total",117,4,3,1,0,105,2,103,5,5,0,0,0,3
"2011","E00009394","E00009394","Total",134,40,19,21,0,5,2,3,86,83,1,2,0,3
"2011","E00009396","E00009396","Total",131,19,10,9,0,67,1,66,44,41,0,1,2,1
"2011","E00009407","E00009407","Total",111,52,28,24,1,13,7,6,45,38,0,6,1,0
"2011","E00009412","E00009412","Total",132,60,33,27,1,1,0,1,65,64,0,1,0,5
"2011","E00009417","E00009417","Total",132,7,4,3,18,100,25,75,6,5,0,0,1,1
"2011","E00009390","E00009390","Total",161,59,28,31,1,16,5,11,84,81,1,2,0,1
"2011","E00009392","E00009392","Total",107,52,28,24,0,11,6,5,43,42,0,1,0,1
"2011","E00009393","E00009393","Total",137,45,21,24,0,40,21,19,52,49,0,2,1,0
"2011","E00009419","E00009419","Total",172,73,43,30,0,33,12,21,65,62,0,3,0,1
"2011","E00009420","E00009420","Total",104,53,32,21,1,16,2,14,32,32,0,0,0,2
"2011","E00009391","E00009391","Total",143,56,15,41,1,3,2,1,81,73,0,7,1,2
"2011","E00009395","E00009395","Total",142,50,22,28,2,25,9,16,64,63,0,1,0,1
"2011","E00009397","E00009397","Total",139,58,23,35,0,6,2,4,74,73,1,0,0,1
"2011","E00009421","E00009421","Total",135,72,38,34,1,18,9,9,41,41,0,0,0,3
"2011","E00009422","E00009422","Total",143,67,29,38,1,25,3,22,46,39,0,5,2,4
"2011","E00009386","E00009386","Total",79,9,5,4,0,39,19,20,28,26,1,1,0,3
"2011","E00009398","E00009398","Total",116,30,12,18,7,60,57,3,17,14,0,3,0,2
"2011","E00009399","E00009399","Total",121,46,18,28,1,7,4,3,65,62,0,3,0,2
"2011","E00009401","E00009401","Total",141,26,9,17,0,62,45,17,51,50,0,1,0,2
"2011","E00009402","E00009402","Total",155,46,22,24,0,26,15,11,82,79,0,3,0,1
"2011","E00009404","E00009404","Total",122,28,7,21,0,63,42,21,29,27,0,2,0,2
"2011","E00009387","E00009387","Total",229,20,10,10,20,115,5,110,73,69,0,1,3,1
"2011","E00009400","E00009400","Total",136,49,22,27,1,21,11,10,63,59,0,3,1,2
"2011","E00009403","E00009403","Total",153,3,1,2,0,121,7,114,26,24,0,0,2,3
"2011","E00009406","E00009406","Total",146,69,28,41,0,34,14,20,41,35,1,5,0,2
"2011","E00009408","E00009408","Total",139,35,12,23,0,39,22,17,64,61,0,1,2,1
"2011","E00009409","E00009409","Total",128,10,9,1,0,101,92,9,13,13,0,0,0,4
"2011","E00009424","E00009424","Total",128,35,12,23,11,56,25,31,23,23,0,0,0,3
"2011","E00009429","E00009429","Total",108,70,36,34,0,11,11,0,25,24,0,1,0,2
"2011","E00009430","E00009430","Total",125,88,48,40,0,4,3,1,31,29,0,1,1,2
"2011","E00009432","E00009432","Total",157,82,28,54,1,22,5,17,47,45,0,2,0,5
"2011","E00009457","E00009457","Total",126,88,49,39,0,8,6,2,26,25,0,1,0,4
"2011","E00009438","E00009438","Total",208,46,27,19,0,13,1,12,142,137,0,1,4,7
"2011","E00009445","E00009445","Total",108,44,18,26,1,29,24,5,33,30,0,1,2,1
"2011","E00009449","E00009449","Total",130,51,28,23,1,9,2,7,69,67,0,2,0,0
"2011","E00009452","E00009452","Total",140,58,27,31,2,3,0,3,75,71,0,3,1,2
"2011","E00009454","E00009454","Total",165,45,14,31,1,3,0,3,114,112,0,2,0,2
"2011","E00009455","E00009455","Total",112,79,40,39,1,6,5,1,26,24,0,2,0,0
"2011","E00009585","E00009585","Total",128,83,31,52,0,10,8,2,32,30,0,2,0,3
"2011","E00009586","E00009586","Total",114,68,28,40,1,4,3,1,40,39,0,1,0,1
"2011","E00009587","E00009587","Total",111,52,25,27,0,25,3,22,34,31,0,3,0,0
"2011","E00009588","E00009588","Total",102,31,18,13,1,39,38,1,30,30,0,0,0,1
"2011","E00009591","E00009591","Total",117,47,25,22,0,31,27,4,35,33,0,1,1,4
"2011","E00009592","E00009592","Total",112,14,5,9,5,82,80,2,9,8,0,1,0,2
"2011","E00009589","E00009589","Total",118,79,35,44,2,3,2,1,30,27,0,2,1,4
"2011","E00009590","E00009590","Total",139,98,43,55,0,6,5,1,31,31,0,0,0,4
"2011","E00009595","E00009595","Total",144,88,33,55,1,10,7,3,39,36,0,3,0,6
"2011","E00009598","E00009598","Total",98,30,10,20,0,51,45,6,15,12,0,3,0,2
"2011","E00009599","E00009599","Total",123,65,33,32,1,15,1,14,37,32,1,3,1,5
"2011","E00009593","E00009593","Total",129,50,31,19,3,60,50,10,14,13,0,1,0,2
"2011","E00009594","E00009594","Total",127,82,34,48,5,4,4,0,34,34,0,0,0,2
"2011","E00009596","E00009596","Total",130,89,49,40,1,0,0,0,36,33,0,2,1,4
"2011","E00009597","E00009597","Total",125,90,40,50,0,5,2,3,30,29,0,1,0,0
"2011","E00009604","E00009604","Total",128,93,57,36,0,8,4,4,24,24,0,0,0,3
"2011","E00009385","E00009385","Total",124,6,3,3,0,107,8,99,10,8,0,1,1,1
"2011","E00009388","E00009388","Total",123,19,7,12,0,58,36,22,43,43,0,0,0,3
"2011","E00009413","E00009413","Total",123,49,21,28,0,18,8,10,53,47,0,6,0,3
"2011","E00009415","E00009415","Total",143,76,42,34,1,18,7,11,46,43,1,2,0,2
"2011","E00009416","E00009416","Total",120,69,39,30,1,6,4,2,43,41,0,1,1,1
"2011","E00009526","E00009526","Total",143,77,44,33,2,7,5,2,55,50,0,4,1,2
"2011","E00009530","E00009530","Total",125,75,39,36,1,15,3,12,33,31,0,2,0,1
"2011","E00009531","E00009531","Total",150,62,26,36,0,21,15,6,65,64,0,1,0,2
"2011","E00009534","E00009534","Total",137,61,22,39,0,38,21,17,37,36,1,0,0,1
"2011","E00009536","E00009536","Total",140,87,42,45,1,15,6,9,37,36,1,0,0,0
"2011","E00009524","E00009524","Total",152,61,22,39,1,14,5,9,74,73,0,1,0,2
"2011","E00009527","E00009527","Total",128,69,29,40,0,19,2,17,39,39,0,0,0,1
"2011","E00009528","E00009528","Total",142,41,15,26,1,45,9,36,53,50,0,3,0,2
"2011","E00009532","E00009532","Total",119,27,9,18,0,58,21,37,29,24,0,3,2,5
"2011","E00009533","E00009533","Total",141,29,13,16,0,15,2,13,97,94,0,3,0,0
"2011","E00009535","E00009535","Total",132,45,26,19,1,30,22,8,56,52,0,3,1,0
"2011","E00009517","E00009517","Total",100,45,29,16,1,24,11,13,28,28,0,0,0,2
"2011","E00009518","E00009518","Total",166,45,22,23,1,40,11,29,78,76,0,2,0,2
"2011","E00009519","E00009519","Total",135,9,5,4,0,113,105,8,10,8,0,1,1,3
"2011","E00009520","E00009520","Total",150,70,36,34,1,38,34,4,41,36,0,3,2,0
"2011","E00009523","E00009523","Total",130,50,19,31,4,47,16,31,27,27,0,0,0,2
"2011","E00009614","E00009614","Total",165,14,8,6,5,132,3,129,12,11,0,0,1,2
"2011","E00009615","E00009615","Total",171,69,40,29,2,21,18,3,76,75,0,0,1,3
"2011","E00009616","E00009616","Total",132,48,23,25,0,27,19,8,55,49,0,6,0,2
"2011","E00009618","E00009618","Total",123,24,11,13,0,76,76,0,22,20,0,2,0,1
"2011","E00009619","E00009619","Total",124,20,12,8,0,93,48,45,11,9,0,2,0,0
"2011","E00009620","E00009620","Total",113,23,10,13,0,49,36,13,36,33,1,2,0,5
"2011","E00009608","E00009608","Total",129,59,28,31,1,35,20,15,32,29,1,1,1,2
"2011","E00009617","E00009617","Total",114,59,31,28,1,16,5,11,35,26,2,7,0,3
"2011","E00009621","E00009621","Total",128,72,38,34,0,20,10,10,32,30,0,0,2,4
"2011","E00009622","E00009622","Total",142,61,26,35,0,22,12,10,58,57,0,1,0,1
"2011","E00009623","E00009623","Total",150,38,16,22,0,54,10,44,56,52,0,4,0,2
"2011","E00009626","E00009626","Total",121,80,52,28,2,10,7,3,27,24,1,2,0,2
"2011","E00009627","E00009627","Total",128,51,29,22,1,52,24,28,20,19,0,1,0,4
"2011","E00009632","E00009632","Total",128,89,56,33,0,10,9,1,28,25,0,3,0,1
"2011","E00009635","E00009635","Total",144,88,56,32,1,9,3,6,46,43,3,0,0,0
"2011","E00009641","E00009641","Total",150,67,35,32,0,5,3,2,77,70,3,4,0,1
"2011","E00009624","E00009624","Total",120,55,27,28,1,30,29,1,33,33,0,0,0,1
"2011","E00009625","E00009625","Total",136,54,23,31,0,32,9,23,47,44,0,2,1,3
"2011","E00009628","E00009628","Total",131,75,36,39,0,21,16,5,35,34,0,1,0,0
"2011","E00009629","E00009629","Total",134,59,32,27,2,23,19,4,44,43,0,1,0,6
"2011","E00009631","E00009631","Total",132,38,19,19,0,63,56,7,31,28,0,2,1,0
"2011","E00009630","E00009630","Total",126,59,21,38,1,7,5,2,57,54,0,2,1,2
"2011","E00009633","E00009633","Total",112,57,22,35,1,18,11,7,33,30,0,3,0,3
"2011","E00009634","E00009634","Total",115,82,46,36,0,6,6,0,26,26,0,0,0,1
"2011","E00009636","E00009636","Total",128,70,37,33,1,1,1,0,54,54,0,0,0,2
"2011","E00009638","E00009638","Total",123,82,41,41,0,9,1,8,29,29,0,0,0,3
"2011","E00009757","E00009757","Total",110,29,14,15,0,49,46,3,29,26,1,2,0,3
"2011","E00009768","E00009768","Total",127,22,9,13,0,87,86,1,17,16,0,1,0,1
"2011","E00009771","E00009771","Total",117,17,4,13,1,93,51,42,6,6,0,0,0,0
"2011","E00009773","E00009773","Total",111,10,0,10,0,92,89,3,8,8,0,0,0,1
"2011","E00009776","E00009776","Total",126,6,1,5,0,107,104,3,12,12,0,0,0,1
"2011","E00009780","E00009780","Total",132,50,27,23,2,13,8,5,66,63,0,2,1,1
"2011","E00009781","E00009781","Total",124,55,33,22,0,16,11,5,52,50,0,2,0,1
"2011","E00009783","E00009783","Total",151,88,40,48,1,5,5,0,57,50,0,4,3,0
"2011","E00009784","E00009784","Total",102,37,11,26,0,16,9,7,49,42,0,5,2,0
"2011","E00009786","E00009786","Total",123,54,23,31,3,10,8,2,56,54,0,2,0,0
"2011","E00167278","E00167278","Total",93,53,28,25,1,11,8,3,26,26,0,0,0,2
"2011","E00167279","E00167279","Total",100,9,2,7,35,43,7,36,12,10,1,1,0,1
"2011","E00167280","E00167280","Total",97,31,11,20,30,26,3,23,9,9,0,0,0,1
"2011","E00009770","E00009770","Total",104,38,18,20,0,7,3,4,57,53,0,3,1,2
"2011","E00009774","E00009774","Total",139,77,38,39,1,11,6,5,49,42,0,6,1,1
"2011","E00009775","E00009775","Total",118,39,16,23,1,13,10,3,63,58,1,4,0,2
"2011","E00009779","E00009779","Total",159,79,34,45,4,16,6,10,55,54,0,1,0,5
"2011","E00009782","E00009782","Total",138,65,27,38,0,12,2,10,61,58,0,3,0,0
"2011","E00009766","E00009766","Total",115,64,31,33,0,6,2,4,42,41,0,0,1,3
"2011","E00009767","E00009767","Total",135,73,31,42,1,6,4,2,54,54,0,0,0,1
"2011","E00009769","E00009769","Total",133,64,41,23,0,18,10,8,46,46,0,0,0,5
"2011","E00009777","E00009777","Total",124,59,32,27,1,9,5,4,53,50,0,3,0,2
"2011","E00009778","E00009778","Total",129,57,27,30,1,6,3,3,60,52,0,7,1,5
"2011","E00009758","E00009758","Total",134,46,26,20,1,37,23,14,45,44,1,0,0,5
"2011","E00009760","E00009760","Total",122,55,27,28,1,26,22,4,38,36,0,2,0,2
"2011","E00009787","E00009787","Total",154,46,24,22,0,57,52,5,51,49,0,2,0,0
"2011","E00009788","E00009788","Total",159,39,14,25,1,44,41,3,75,74,0,1,0,0
"2011","E00009789","E00009789","Total",136,90,44,46,1,4,4,0,37,35,1,1,0,4
"2011","E00009759","E00009759","Total",138,56,17,39,0,30,13,17,50,47,1,2,0,2
"2011","E00009763","E00009763","Total",152,29,10,19,0,8,3,5,113,110,1,2,0,2
"2011","E00009764","E00009764","Total",114,23,10,13,1,49,39,10,41,38,1,2,0,0
"2011","E00009765","E00009765","Total",103,16,4,12,1,65,63,2,19,16,0,3,0,2
"2011","E00009772","E00009772","Total",103,20,16,4,0,49,47,2,32,31,0,1,0,2
"2011","E00009504","E00009504","Total",106,56,29,27,1,3,2,1,42,42,0,0,0,4
"2011","E00009521","E00009521","Total",152,82,32,50,0,7,2,5,60,58,0,2,0,3
"2011","E00009522","E00009522","Total",145,79,36,43,1,23,10,13,40,37,0,2,1,2
"2011","E00009525","E00009525","Total",136,55,24,31,2,25,17,8,53,51,0,2,0,1
"2011","E00009529","E00009529","Total",142,84,36,48,1,9,4,5,47,45,0,2,0,1
"2011","E00009502","E00009502","Total",152,83,45,38,0,15,4,11,49,48,0,1,0,5
"2011","E00009503","E00009503","Total",192,60,22,38,0,44,8,36,85,84,0,0,1,3
"2011","E00009506","E00009506","Total",125,70,36,34,1,7,5,2,46,45,0,1,0,1
"2011","E00009509","E00009509","Total",163,83,37,46,2,23,7,16,54,51,0,3,0,1
"2011","E00009537","E00009537","Total",118,64,26,38,1,15,4,11,38,34,0,4,0,0
"2011","E00009505","E00009505","Total",134,56,14,42,1,6,6,0,70,67,0,3,0,1
"2011","E00009507","E00009507","Total",123,68,30,38,0,21,6,15,33,33,0,0,0,1
"2011","E00009508","E00009508","Total",134,63,27,36,1,24,19,5,45,41,0,4,0,1
"2011","E00009510","E00009510","Total",123,67,36,31,2,24,14,10,30,28,0,2,0,0
"2011","E00009512","E00009512","Total",142,54,20,34,1,19,10,9,68,65,0,3,0,0
"2011","E00009511","E00009511","Total",113,71,38,33,1,8,3,5,31,30,0,1,0,2
"2011","E00009513","E00009513","Total",96,49,31,18,0,15,2,13,28,26,0,2,0,4
"2011","E00009514","E00009514","Total",89,30,14,16,0,14,5,9,42,41,0,1,0,3
"2011","E00009515","E00009515","Total",140,64,19,45,0,24,11,13,51,50,0,1,0,1
"2011","E00009516","E00009516","Total",125,73,40,33,3,13,5,8,35,34,0,1,0,1
"2011","E00009684","E00009684","Total",127,44,13,31,1,55,43,12,25,24,0,1,0,2
"2011","E00009702","E00009702","Total",113,41,11,30,2,31,22,9,37,35,0,2,0,2
"2011","E00009705","E00009705","Total",124,67,32,35,0,24,19,5,33,30,0,3,0,0
"2011","E00009706","E00009706","Total",127,46,14,32,1,50,19,31,29,26,0,2,1,1
"2011","E00009708","E00009708","Total",94,43,14,29,2,11,7,4,38,35,0,2,1,0
"2011","E00009709","E00009709","Total",122,46,18,28,1,45,39,6,27,23,0,4,0,3
"2011","E00009711","E00009711","Total",117,47,30,17,0,24,20,4,45,44,0,1,0,1
"2011","E00009716","E00009716","Total",103,40,22,18,2,44,28,16,16,15,0,1,0,1
"2011","E00009699","E00009699","Total",97,57,42,15,10,3,2,1,21,19,0,1,1,6
"2011","E00009700","E00009700","Total",128,79,52,27,0,0,0,0,37,33,0,4,0,12
"2011","E00009701","E00009701","Total",165,17,8,9,1,134,105,29,10,9,0,1,0,3
"2011","E00009703","E00009703","Total",112,21,15,6,0,72,36,36,17,16,0,1,0,2
"2011","E00009707","E00009707","Total",141,38,13,25,2,60,15,45,39,36,0,3,0,2
"2011","E00167275","E00167275","Total",147,6,3,3,26,102,3,99,12,10,0,2,0,1
"2011","E00167276","E00167276","Total",195,63,28,35,50,36,13,23,41,40,0,1,0,5
"2011","E00009682","E00009682","Total",119,35,11,24,2,55,22,33,26,25,0,0,1,1
"2011","E00009685","E00009685","Total",117,44,16,28,0,36,13,23,36,32,0,4,0,1
"2011","E00009714","E00009714","Total",132,59,28,31,1,21,9,12,50,45,0,5,0,1
"2011","E00167267","E00167267","Total",128,32,12,20,0,65,28,37,30,27,0,3,0,1
"2011","E00167268","E00167268","Total",106,48,11,37,10,29,5,24,17,15,0,2,0,2
"2011","E00167269","E00167269","Total",110,2,2,0,15,85,6,79,6,6,0,0,0,2
"2011","E00167270","E00167270","Total",87,17,4,13,13,44,5,39,13,11,0,1,1,0
"2011","E00167271","E00167271","Total",164,58,24,34,0,14,12,2,91,85,0,6,0,1
"2011","E00167277","E00167277","Total",119,35,15,20,3,8,3,5,67,65,2,0,0,6
"2011","E00009686","E00009686","Total",103,45,24,21,2,14,3,11,36,33,1,1,1,6
"2011","E00009713","E00009713","Total",106,58,28,30,0,6,2,4,40,37,0,3,0,2
"2011","E00167272","E00167272","Total",137,2,0,2,1,124,15,109,9,9,0,0,0,1
"2011","E00167273","E00167273","Total",99,33,22,11,0,7,1,6,54,49,2,3,0,5
"2011","E00167274","E00167274","Total",112,36,20,16,0,19,3,16,49,46,0,2,1,8
"2011","E00009600","E00009600","Total",96,21,12,9,5,59,37,22,9,8,0,0,1,2
"2011","E00009601","E00009601","Total",146,113,68,45,0,7,2,5,24,24,0,0,0,2
"2011","E00009602","E00009602","Total",129,66,37,29,0,20,1,19,40,36,2,1,1,3
"2011","E00009603","E00009603","Total",117,81,51,30,2,3,1,2,29,29,0,0,0,2
"2011","E00009605","E00009605","Total",120,55,26,29,0,2,1,1,59,59,0,0,0,4
"2011","E00009581","E00009581","Total",104,76,65,11,4,1,0,1,17,16,0,1,0,6
"2011","E00009582","E00009582","Total",128,79,61,18,1,1,1,0,42,36,0,6,0,5
"2011","E00009583","E00009583","Total",107,50,19,31,1,3,3,0,47,43,0,4,0,6
"2011","E00009584","E00009584","Total",127,96,82,14,1,0,0,0,27,26,0,1,0,3
"2011","E00009606","E00009606","Total",103,66,42,24,1,5,2,3,19,18,1,0,0,12
"2011","E00009607","E00009607","Total",120,76,51,25,1,7,7,0,34,31,0,3,0,2
"2011","E00009609","E00009609","Total",113,77,47,30,1,12,9,3,22,22,0,0,0,1
"2011","E00009610","E00009610","Total",122,78,40,38,0,2,0,2,40,39,0,1,0,2
"2011","E00009612","E00009612","Total",132,73,36,37,2,9,3,6,47,46,1,0,0,1
"2011","E00009613","E00009613","Total",123,73,38,35,1,7,3,4,41,37,0,4,0,1
"2011","E00009642","E00009642","Total",123,72,37,35,0,11,4,7,39,37,0,2,0,1
"2011","E00009761","E00009761","Total",137,47,12,35,0,28,21,7,60,57,0,3,0,2
"2011","E00009762","E00009762","Total",123,37,19,18,2,20,11,9,60,58,0,1,1,4
"2011","E00009790","E00009790","Total",138,57,18,39,2,3,3,0,74,71,1,2,0,2
"2011","E00009791","E00009791","Total",112,22,15,7,0,61,22,39,29,29,0,0,0,0
"2011","E00009792","E00009792","Total",157,50,20,30,1,9,8,1,95,94,0,1,0,2
"2011","E00009793","E00009793","Total",142,60,32,28,2,9,8,1,67,63,0,4,0,4
"2011","E00009611","E00009611","Total",102,51,27,24,1,36,4,32,11,11,0,0,0,3
"2011","E00009637","E00009637","Total",161,78,37,41,1,14,12,2,67,66,0,1,0,1
"2011","E00009639","E00009639","Total",104,77,44,33,1,6,5,1,20,19,0,0,1,0
"2011","E00009640","E00009640","Total",111,61,35,26,1,10,7,3,33,32,0,0,1,6
"2011","E00009643","E00009643","Total",146,95,47,48,1,10,9,1,37,35,0,2,0,3
"2011","E00009690","E00009690","Total",141,21,7,14,2,84,79,5,33,29,0,4,0,1
"2011","E00009692","E00009692","Total",144,24,11,13,0,90,82,8,29,28,0,1,0,1
"2011","E00009696","E00009696","Total",137,65,38,27,3,45,6,39,18,17,0,1,0,6
"2011","E00009698","E00009698","Total",135,80,43,37,0,14,13,1,34,32,1,1,0,7
"2011","E00009717","E00009717","Total",142,21,6,15,2,81,74,7,36,32,0,4,0,2
"2011","E00009683","E00009683","Total",118,55,14,41,2,16,11,5,44,41,0,3,0,1
"2011","E00009688","E00009688","Total",135,86,52,34,0,14,9,5,35,31,0,3,1,0
"2011","E00009689","E00009689","Total",113,40,13,27,1,9,1,8,63,60,0,3,0,0
"2011","E00009691","E00009691","Total",144,56,27,29,4,27,11,16,54,51,0,3,0,3
"2011","E00009710","E00009710","Total",131,48,23,25,1,22,14,8,56,52,1,3,0,4
"2011","E00009712","E00009712","Total",119,79,50,29,0,6,5,1,32,31,0,1,0,2
"2011","E00009687","E00009687","Total",126,61,29,32,0,37,10,27,26,25,0,1,0,2
"2011","E00009693","E00009693","Total",98,13,4,9,1,64,57,7,18,18,0,0,0,2
"2011","E00009694","E00009694","Total",163,12,1,11,50,76,7,69,24,18,0,6,0,1
"2011","E00009695","E00009695","Total",114,49,15,34,1,42,24,18,21,20,0,1,0,1
"2011","E00009697","E00009697","Total",115,34,13,21,2,60,44,16,17,15,0,2,0,2
"2011","E00009868","E00009868","Total",114,36,14,22,1,26,22,4,48,46,0,1,1,3
"2011","E00009869","E00009869","Total",178,29,9,20,2,55,18,37,91,90,0,1,0,1
"2011","E00009870","E00009870","Total",137,34,9,25,0,55,19,36,47,44,0,2,1,1
"2011","E00009879","E00009879","Total",120,52,15,37,0,24,3,21,43,42,0,1,0,1
"2011","E00009902","E00009902","Total",157,77,33,44,0,15,3,12,61,56,0,5,0,4
"2011","E00009903","E00009903","Total",151,50,21,29,2,49,11,38,47,46,1,0,0,3
"2011","E00009871","E00009871","Total",163,47,15,32,19,54,20,34,40,38,0,1,1,3
"2011","E00009874","E00009874","Total",117,41,16,25,0,36,18,18,38,38,0,0,0,2
"2011","E00009882","E00009882","Total",101,12,5,7,1,69,66,3,15,14,0,1,0,4
"2011","E00009884","E00009884","Total",162,29,5,24,0,103,58,45,23,23,0,0,0,7
"2011","E00009885","E00009885","Total",117,13,5,8,1,93,81,12,10,9,0,0,1,0
"2011","E00009888","E00009888","Total",124,9,1,8,1,98,26,72,15,15,0,0,0,1
"2011","E00009867","E00009867","Total",232,85,36,49,1,15,6,9,128,121,1,6,0,3
"2011","E00009876","E00009876","Total",184,58,23,35,1,25,3,22,99,97,0,2,0,1
"2011","E00009880","E00009880","Total",119,67,34,33,2,7,2,5,40,40,0,0,0,3
"2011","E00009892","E00009892","Total",118,73,27,46,4,6,2,4,32,31,0,1,0,3
"2011","E00009894","E00009894","Total",134,72,36,36,0,8,7,1,54,51,0,3,0,0
"2011","E00009901","E00009901","Total",172,69,30,39,1,20,9,11,80,78,0,1,1,2
"2011","E00009893","E00009893","Total",166,85,32,53,0,18,9,9,59,57,0,0,2,4
"2011","E00009895","E00009895","Total",148,49,18,31,1,13,4,9,85,83,0,1,1,0
"2011","E00009898","E00009898","Total",134,48,17,31,0,15,12,3,70,68,0,1,1,1
"2011","E00009899","E00009899","Total",145,63,23,40,2,27,5,22,53,52,0,1,0,0
"2011","E00009900","E00009900","Total",183,68,30,38,11,18,7,11,84,82,0,2,0,2
"2011","E00010216","E00010216","Total",142,39,18,21,1,65,49,16,36,36,0,0,0,1
"2011","E00010233","E00010233","Total",122,56,29,27,0,33,16,17,33,33,0,0,0,0
"2011","E00010248","E00010248","Total",134,59,29,30,0,37,15,22,38,37,0,1,0,0
"2011","E00010249","E00010249","Total",142,62,32,30,2,36,10,26,41,37,0,3,1,1
"2011","E00010250","E00010250","Total",97,10,4,6,0,78,71,7,9,9,0,0,0,0
"2011","E00010214","E00010214","Total",149,40,23,17,3,23,13,10,81,78,1,1,1,2
"2011","E00010217","E00010217","Total",176,19,10,9,0,112,74,38,41,40,0,0,1,4
"2011","E00010220","E00010220","Total",119,11,7,4,0,78,50,28,29,29,0,0,0,1
"2011","E00010221","E00010221","Total",119,18,9,9,0,73,65,8,26,24,0,1,1,2
"2011","E00010245","E00010245","Total",134,30,10,20,1,63,46,17,39,38,0,1,0,1
"2011","E00010223","E00010223","Total",123,6,2,4,0,100,98,2,14,13,0,0,1,3
"2011","E00010224","E00010224","Total",130,5,5,0,0,115,114,1,7,7,0,0,0,3
"2011","E00010228","E00010228","Total",111,4,0,4,0,89,84,5,13,10,1,1,1,5
"2011","E00010229","E00010229","Total",116,19,8,11,0,81,63,18,14,14,0,0,0,2
"2011","E00010231","E00010231","Total",159,24,9,15,0,116,105,11,17,15,0,2,0,2
"2011","E00010234","E00010234","Total",125,40,17,23,5,34,11,23,43,42,0,0,1,3
"2011","E00010237","E00010237","Total",134,35,22,13,1,43,9,34,54,52,0,2,0,1
"2011","E00010239","E00010239","Total",117,45,19,26,2,34,18,16,35,35,0,0,0,1
"2011","E00010240","E00010240","Total",116,38,11,27,3,46,38,8,25,25,0,0,0,4
"2011","E00010242","E00010242","Total",119,32,13,19,2,58,49,9,25,22,1,2,0,2
"2011","E00010243","E00010243","Total",129,72,32,40,2,18,5,13,36,35,0,1,0,1
"2011","E00009840","E00009840","Total",133,95,27,68,1,5,2,3,30,30,0,0,0,2
"2011","E00009843","E00009843","Total",139,115,57,58,0,2,1,1,22,22,0,0,0,0
"2011","E00009863","E00009863","Total",130,94,47,47,0,21,20,1,13,12,0,0,1,2
"2011","E00009864","E00009864","Total",118,67,24,43,0,33,32,1,16,15,0,0,1,2
"2011","E00009865","E00009865","Total",121,46,14,32,8,43,26,17,23,22,0,1,0,1
"2011","E00009872","E00009872","Total",146,18,3,15,21,95,7,88,11,9,0,0,2,1
"2011","E00009877","E00009877","Total",211,68,27,41,15,49,10,39,78,75,1,2,0,1
"2011","E00009878","E00009878","Total",98,14,3,11,0,74,41,33,9,9,0,0,0,1
"2011","E00009881","E00009881","Total",121,27,8,19,1,26,21,5,63,63,0,0,0,4
"2011","E00009905","E00009905","Total",152,53,22,31,5,49,34,15,44,44,0,0,0,1
"2011","E00009873","E00009873","Total",140,60,27,33,1,42,22,20,36,34,0,2,0,1
"2011","E00009883","E00009883","Total",150,67,20,47,2,47,41,6,30,26,0,4,0,4
"2011","E00009886","E00009886","Total",104,9,5,4,0,81,79,2,10,10,0,0,0,4
"2011","E00009887","E00009887","Total",119,17,8,9,0,87,81,6,13,12,0,0,1,2
"2011","E00009889","E00009889","Total",113,74,35,39,0,8,7,1,30,30,0,0,0,1
"2011","E00009890","E00009890","Total",123,59,20,39,0,9,9,0,55,54,0,1,0,0
"2011","E00009875","E00009875","Total",157,56,30,26,0,54,18,36,42,41,0,1,0,5
"2011","E00009896","E00009896","Total",143,43,19,24,2,34,30,4,63,62,0,1,0,1
"2011","E00009897","E00009897","Total",117,104,53,51,0,3,2,1,9,8,0,1,0,1
"2011","E00009904","E00009904","Total",134,89,46,43,1,31,28,3,12,12,0,0,0,1
"2011","E00170302","E00170302","Total",126,6,2,4,5,59,8,51,55,52,0,2,1,1
"2011","E00170303","E00170303","Total",136,117,54,63,0,6,3,3,13,13,0,0,0,0
"2011","E00170304","E00170304","Total",130,2,0,2,25,43,5,38,60,59,0,1,0,0
"2011","E00010511","E00010511","Total",130,54,24,30,2,48,23,25,25,22,0,3,0,1
"2011","E00010512","E00010512","Total",144,48,16,32,3,72,60,12,21,21,0,0,0,0
"2011","E00010515","E00010515","Total",131,90,41,49,1,8,5,3,32,30,1,1,0,0
"2011","E00010516","E00010516","Total",126,30,13,17,1,73,57,16,21,19,0,2,0,1
"2011","E00010519","E00010519","Total",116,28,10,18,2,61,54,7,21,21,0,0,0,4
"2011","E00010520","E00010520","Total",131,34,11,23,2,71,65,6,20,19,1,0,0,4
"2011","E00010521","E00010521","Total",141,36,11,25,0,88,57,31,16,14,0,1,1,1
"2011","E00010524","E00010524","Total",131,26,6,20,3,85,44,41,14,14,0,0,0,3
"2011","E00010527","E00010527","Total",126,43,10,33,1,67,61,6,13,12,0,1,0,2
"2011","E00010498","E00010498","Total",143,56,19,37,2,69,48,21,15,13,0,0,2,1
"2011","E00010526","E00010526","Total",149,47,12,35,1,81,73,8,18,16,0,0,2,2
"2011","E00010529","E00010529","Total",140,29,8,21,0,100,94,6,9,6,0,2,1,2
"2011","E00010530","E00010530","Total",151,52,18,34,1,82,50,32,15,15,0,0,0,1
"2011","E00010497","E00010497","Total",122,31,6,25,1,72,71,1,15,14,0,1,0,3
"2011","E00010504","E00010504","Total",123,44,17,27,0,57,48,9,20,19,1,0,0,2
"2011","E00010505","E00010505","Total",107,42,16,26,0,31,22,9,32,29,0,2,1,2
"2011","E00010507","E00010507","Total",134,51,14,37,0,62,58,4,17,15,0,0,2,4
"2011","E00010510","E00010510","Total",106,39,11,28,2,51,45,6,13,13,0,0,0,1
"2011","E00010513","E00010513","Total",130,24,8,16,2,92,81,11,10,10,0,0,0,2
"2011","E00010514","E00010514","Total",123,78,35,43,1,8,5,3,35,35,0,0,0,1
"2011","E00010517","E00010517","Total",110,10,2,8,1,93,89,4,6,6,0,0,0,0
"2011","E00010523","E00010523","Total",137,40,15,25,1,79,70,9,13,12,0,1,0,4
"2011","E00010525","E00010525","Total",135,36,12,24,2,74,62,12,21,13,0,2,6,2
"2011","E00010495","E00010495","Total",121,28,11,17,1,69,57,12,22,21,0,0,1,1
"2011","E00010501","E00010501","Total",148,56,18,38,4,16,11,5,65,64,0,0,1,7
"2011","E00010518","E00010518","Total",107,13,3,10,0,74,40,34,17,11,0,5,1,3
"2011","E00010522","E00010522","Total",201,38,6,32,23,44,14,30,93,92,0,1,0,3
"2011","E00010528","E00010528","Total",112,31,6,25,0,8,4,4,71,66,0,2,3,2
"2011","E00010496","E00010496","Total",139,45,12,33,2,71,65,6,18,15,0,1,2,3
"2011","E00010499","E00010499","Total",141,30,12,18,0,87,69,18,22,22,0,0,0,2
"2011","E00010500","E00010500","Total",124,44,16,28,1,56,45,11,20,19,0,0,1,3
"2011","E00010508","E00010508","Total",137,49,18,31,2,54,38,16,29,29,0,0,0,3
"2011","E00010494","E00010494","Total",124,18,9,9,1,78,68,10,22,21,0,0,1,5
"2011","E00010502","E00010502","Total",120,23,3,20,1,74,38,36,20,19,0,0,1,2
"2011","E00010503","E00010503","Total",112,6,2,4,1,74,6,68,27,25,0,0,2,4
"2011","E00010506","E00010506","Total",112,26,5,21,1,63,56,7,20,20,0,0,0,2
"2011","E00010509","E00010509","Total",136,57,14,43,2,55,49,6,20,20,0,0,0,2
"2011","E00010531","E00010531","Total",129,51,20,31,1,38,7,31,37,37,0,0,0,2
"2011","E00010560","E00010560","Total",112,31,12,19,2,30,4,26,49,47,2,0,0,0
"2011","E00010561","E00010561","Total",110,42,16,26,1,16,8,8,49,49,0,0,0,2
"2011","E00010565","E00010565","Total",123,74,35,39,1,11,6,5,37,37,0,0,0,0
"2011","E00010567","E00010567","Total",130,78,29,49,0,6,6,0,45,41,0,3,1,1
"2011","E00010536","E00010536","Total",119,58,10,48,0,8,5,3,52,51,0,0,1,1
"2011","E00010537","E00010537","Total",132,67,23,44,2,10,7,3,53,53,0,0,0,0
"2011","E00010538","E00010538","Total",127,75,29,46,0,8,4,4,40,39,0,1,0,4
"2011","E00010539","E00010539","Total",176,75,23,52,1,20,10,10,77,72,0,5,0,3
"2011","E00010540","E00010540","Total",144,83,46,37,1,10,6,4,49,48,0,1,0,1
"2011","E00010535","E00010535","Total",149,53,26,27,1,22,7,15,70,69,0,1,0,3
"2011","E00010541","E00010541","Total",142,49,21,28,1,15,3,12,76,73,0,2,1,1
"2011","E00010542","E00010542","Total",155,48,22,26,0,19,10,9,88,86,0,1,1,0
"2011","E00010543","E00010543","Total",139,63,25,38,0,34,12,22,40,38,0,2,0,2
"2011","E00010546","E00010546","Total",167,48,12,36,3,28,24,4,88,86,0,0,2,0
"2011","E00010532","E00010532","Total",153,30,11,19,0,68,44,24,53,52,0,1,0,2
"2011","E00010548","E00010548","Total",157,38,7,31,0,49,29,20,64,64,0,0,0,6
"2011","E00010549","E00010549","Total",148,38,15,23,0,28,6,22,81,79,0,1,1,1
"2011","E00010564","E00010564","Total",129,36,15,21,1,16,7,9,75,74,0,1,0,1
"2011","E00010566","E00010566","Total",137,24,8,16,0,8,7,1,103,101,0,1,1,2
"2011","E00010568","E00010568","Total",137,48,19,29,0,7,3,4,79,78,1,0,0,3
"2011","E00010550","E00010550","Total",146,23,11,12,1,92,74,18,24,23,0,1,0,6
"2011","E00010552","E00010552","Total",143,33,6,27,0,88,86,2,20,19,0,1,0,2
"2011","E00010554","E00010554","Total",128,11,6,5,0,97,93,4,18,14,0,4,0,2
"2011","E00010558","E00010558","Total",243,50,8,42,6,122,90,32,60,60,0,0,0,5
"2011","E00010563","E00010563","Total",153,43,12,31,0,55,51,4,53,52,0,1,0,2
"2011","E00010533","E00010533","Total",174,91,45,46,2,46,34,12,33,32,0,0,1,2
"2011","E00010551","E00010551","Total",157,65,31,34,5,37,30,7,46,44,0,1,1,4
"2011","E00010559","E00010559","Total",217,45,15,30,25,83,46,37,60,58,0,2,0,4
"2011","E00010562","E00010562","Total",132,60,29,31,0,19,10,9,50,47,1,1,1,3
"2011","E00010545","E00010545","Total",167,88,39,49,8,10,7,3,58,56,0,1,1,3
"2011","E00010547","E00010547","Total",144,83,36,47,2,10,9,1,45,42,0,3,0,4
"2011","E00010553","E00010553","Total",183,46,20,26,3,48,26,22,85,81,0,0,4,1
"2011","E00010555","E00010555","Total",152,76,38,38,0,26,15,11,50,47,0,2,1,0
"2011","E00010534","E00010534","Total",114,38,15,23,1,51,31,20,20,20,0,0,0,4
"2011","E00010544","E00010544","Total",129,78,39,39,0,19,16,3,31,31,0,0,0,1
"2011","E00010556","E00010556","Total",156,88,40,48,0,26,22,4,40,40,0,0,0,2
"2011","E00010557","E00010557","Total",102,66,27,39,2,9,5,4,23,22,0,1,0,2
"2011","E00009844","E00009844","Total",137,123,53,70,0,5,3,2,9,7,1,1,0,0
"2011","E00009846","E00009846","Total",134,102,42,60,0,15,9,6,16,16,0,0,0,1
"2011","E00009850","E00009850","Total",129,91,40,51,0,15,13,2,22,22,0,0,0,1
"2011","E00009855","E00009855","Total",155,74,30,44,0,2,2,0,75,75,0,0,0,4
"2011","E00009866","E00009866","Total",136,114,50,64,0,8,8,0,12,12,0,0,0,2
"2011","E00009835","E00009835","Total",134,83,28,55,0,19,15,4,32,31,0,1,0,0
"2011","E00009842","E00009842","Total",123,74,27,47,2,11,2,9,36,34,0,2,0,0
"2011","E00009845","E00009845","Total",127,68,31,37,1,18,6,12,39,39,0,0,0,1
"2011","E00009853","E00009853","Total",118,76,30,46,1,7,0,7,32,32,0,0,0,2
"2011","E00009856","E00009856","Total",165,72,22,50,0,14,4,10,79,76,0,3,0,0
"2011","E00009837","E00009837","Total",105,40,12,28,1,39,36,3,23,20,0,3,0,2
"2011","E00009838","E00009838","Total",142,114,39,75,0,4,3,1,23,19,0,3,1,1
"2011","E00009839","E00009839","Total",143,99,34,65,1,11,7,4,30,30,0,0,0,2
"2011","E00009841","E00009841","Total",128,109,45,64,0,4,2,2,15,14,0,1,0,0
"2011","E00009847","E00009847","Total",139,105,34,71,0,10,4,6,24,24,0,0,0,0
"2011","E00009849","E00009849","Total",136,89,43,46,0,9,8,1,37,37,0,0,0,1
"2011","E00009851","E00009851","Total",144,124,56,68,0,6,5,1,13,13,0,0,0,1
"2011","E00009852","E00009852","Total",132,83,48,35,0,2,1,1,47,47,0,0,0,0
"2011","E00009857","E00009857","Total",123,104,58,46,1,9,6,3,9,9,0,0,0,0
"2011","E00010182","E00010182","Total",140,48,13,35,1,61,57,4,27,27,0,0,0,3
"2011","E00010183","E00010183","Total",139,46,25,21,1,35,31,4,55,54,0,1,0,2
"2011","E00010185","E00010185","Total",140,65,31,34,0,16,8,8,59,57,0,1,1,0
"2011","E00010212","E00010212","Total",133,48,15,33,0,58,55,3,27,27,0,0,0,0
"2011","E00010184","E00010184","Total",139,53,34,19,0,8,7,1,76,76,0,0,0,2
"2011","E00010199","E00010199","Total",111,36,13,23,1,54,52,2,18,18,0,0,0,2
"2011","E00010201","E00010201","Total",140,49,18,31,2,61,60,1,26,24,0,2,0,2
"2011","E00010202","E00010202","Total",128,48,20,28,1,22,14,8,55,52,0,2,1,2
"2011","E00010210","E00010210","Total",127,70,20,50,2,34,34,0,19,19,0,0,0,2
"2011","E00010177","E00010177","Total",131,35,12,23,1,71,68,3,20,20,0,0,0,4
"2011","E00010196","E00010196","Total",127,36,15,21,0,44,41,3,43,42,1,0,0,4
"2011","E00010197","E00010197","Total",133,43,12,31,2,68,65,3,19,19,0,0,0,1
"2011","E00010198","E00010198","Total",113,41,19,22,1,45,40,5,24,20,0,2,2,2
"2011","E00010206","E00010206","Total",127,19,2,17,2,80,78,2,25,24,0,0,1,1
"2011","E00010207","E00010207","Total",128,25,8,17,1,76,74,2,23,22,0,1,0,3
"2011","E00010200","E00010200","Total",158,42,21,21,1,55,43,12,54,54,0,0,0,6
"2011","E00010205","E00010205","Total",152,43,18,25,0,61,55,6,46,44,0,1,1,2
"2011","E00010208","E00010208","Total",129,46,16,30,0,66,66,0,15,14,0,1,0,2
"2011","E00010209","E00010209","Total",145,39,13,26,0,68,68,0,36,35,0,0,1,2
"2011","E00010211","E00010211","Total",125,37,14,23,1,66,63,3,19,14,0,5,0,2
"2011","E00009932","E00009932","Total",130,42,18,24,2,43,13,30,43,43,0,0,0,0
"2011","E00009933","E00009933","Total",110,45,15,30,2,29,12,17,33,33,0,0,0,1
"2011","E00009934","E00009934","Total",149,56,20,36,1,43,16,27,47,46,0,0,1,2
"2011","E00009937","E00009937","Total",123,45,20,25,0,33,9,24,40,39,0,1,0,5
"2011","E00009942","E00009942","Total",123,52,23,29,1,32,8,24,35,33,0,2,0,3
"2011","E00009929","E00009929","Total",114,33,16,17,0,33,13,20,45,43,0,2,0,3
"2011","E00009930","E00009930","Total",131,62,22,40,1,33,15,18,31,28,0,3,0,4
"2011","E00009931","E00009931","Total",120,27,4,23,0,56,36,20,29,29,0,0,0,8
"2011","E00009935","E00009935","Total",119,22,10,12,4,53,26,27,39,38,0,0,1,1
"2011","E00009938","E00009938","Total",121,44,16,28,1,29,11,18,46,44,0,1,1,1
"2011","E00009907","E00009907","Total",184,32,6,26,0,116,111,5,32,32,0,0,0,4
"2011","E00009908","E00009908","Total",163,31,12,19,0,70,11,59,58,57,0,0,1,4
"2011","E00009927","E00009927","Total",198,54,24,30,2,71,26,45,68,64,0,3,1,3
"2011","E00009928","E00009928","Total",161,49,19,30,2,48,11,37,60,55,0,3,2,2
"2011","E00009936","E00009936","Total",113,46,13,33,4,31,18,13,27,25,0,2,0,5
"2011","E00009915","E00009915","Total",214,22,11,11,32,86,19,67,71,63,1,3,4,3
"2011","E00009924","E00009924","Total",177,13,1,12,9,101,18,83,46,45,0,1,0,8
"2011","E00009939","E00009939","Total",182,45,22,23,2,51,18,33,75,74,1,0,0,9
"2011","E00009940","E00009940","Total",152,49,20,29,2,48,28,20,49,48,0,1,0,4
"2011","E00009944","E00009944","Total",121,48,17,31,2,27,11,16,40,38,0,2,0,4
"2011","E00010423","E00010423","Total",138,44,11,33,2,60,27,33,31,28,0,3,0,1
"2011","E00010424","E00010424","Total",147,25,9,16,1,77,54,23,41,39,0,1,1,3
"2011","E00010426","E00010426","Total",115,28,5,23,0,42,35,7,43,42,0,1,0,2
"2011","E00010428","E00010428","Total",183,32,7,25,23,66,53,13,55,55,0,0,0,7
"2011","E00010429","E00010429","Total",146,59,22,37,2,43,18,25,42,40,0,1,1,0
"2011","E00010433","E00010433","Total",120,25,8,17,0,84,76,8,8,7,0,1,0,3
"2011","E00010432","E00010432","Total",160,17,3,14,1,97,71,26,42,42,0,0,0,3
"2011","E00010436","E00010436","Total",174,44,21,23,11,49,13,36,67,62,0,3,2,3
"2011","E00010444","E00010444","Total",107,8,3,5,2,68,44,24,25,25,0,0,0,4
"2011","E00010446","E00010446","Total",116,0,0,0,1,105,10,95,6,6,0,0,0,4
"2011","E00010449","E00010449","Total",129,25,10,15,1,81,41,40,16,16,0,0,0,6
"2011","E00010438","E00010438","Total",135,55,24,31,1,26,15,11,53,52,0,1,0,0
"2011","E00010442","E00010442","Total",141,64,24,40,0,27,19,8,46,42,0,2,2,4
"2011","E00010443","E00010443","Total",132,66,23,43,2,19,9,10,43,39,0,1,3,2
"2011","E00010445","E00010445","Total",131,74,40,34,0,11,4,7,45,35,0,1,9,1
"2011","E00010451","E00010451","Total",105,12,4,8,0,77,74,3,15,15,0,0,0,1
"2011","E00010452","E00010452","Total",128,26,10,16,0,51,41,10,48,45,0,1,2,3
"2011","E00010453","E00010453","Total",111,25,5,20,0,68,59,9,18,17,0,1,0,0
"2011","E00010454","E00010454","Total",116,37,10,27,0,61,55,6,16,14,0,0,2,2
"2011","E00010455","E00010455","Total",155,22,7,15,0,86,71,15,43,41,0,1,1,4
"2011","E00010458","E00010458","Total",126,27,9,18,0,80,17,63,14,14,0,0,0,5
"2011","E00010465","E00010465","Total",133,10,1,9,1,102,24,78,18,16,0,1,1,2
"2011","E00010467","E00010467","Total",159,8,0,8,0,134,74,60,11,9,0,0,2,6
"2011","E00010469","E00010469","Total",150,9,3,6,0,135,128,7,3,3,0,0,0,3
"2011","E00010477","E00010477","Total",116,4,0,4,0,102,95,7,10,9,0,0,1,0
"2011","E00010478","E00010478","Total",121,29,12,17,0,63,63,0,21,19,1,1,0,8
"2011","E00010483","E00010483","Total",122,48,21,27,1,21,6,15,50,50,0,0,0,2
"2011","E00010485","E00010485","Total",115,86,40,46,1,8,5,3,18,17,0,0,1,2
"2011","E00010492","E00010492","Total",131,57,33,24,0,25,9,16,47,46,0,0,1,2
"2011","E00010456","E00010456","Total",173,86,53,33,0,21,13,8,64,61,0,1,2,2
"2011","E00010464","E00010464","Total",135,47,20,27,3,27,20,7,57,54,0,2,1,1
"2011","E00010466","E00010466","Total",120,40,25,15,1,47,13,34,29,23,0,5,1,3
"2011","E00010471","E00010471","Total",125,68,25,43,0,8,5,3,47,46,0,1,0,2
"2011","E00010476","E00010476","Total",135,94,43,51,0,9,8,1,31,28,0,3,0,1
"2011","E00010468","E00010468","Total",238,13,4,9,3,211,201,10,7,5,0,1,1,4
"2011","E00010470","E00010470","Total",111,10,2,8,1,89,81,8,6,5,0,0,1,5
"2011","E00010472","E00010472","Total",88,4,1,3,0,71,69,2,11,11,0,0,0,2
"2011","E00010473","E00010473","Total",102,7,2,5,0,92,90,2,2,2,0,0,0,1
"2011","E00010475","E00010475","Total",105,4,1,3,0,86,85,1,13,12,0,1,0,2
"2011","E00009833","E00009833","Total",116,87,50,37,0,2,1,1,27,27,0,0,0,0
"2011","E00009854","E00009854","Total",122,105,52,53,1,7,3,4,9,9,0,0,0,0
"2011","E00009860","E00009860","Total",136,100,46,54,0,10,3,7,26,26,0,0,0,0
"2011","E00009861","E00009861","Total",115,88,45,43,0,6,6,0,21,19,2,0,0,0
"2011","E00009862","E00009862","Total",144,77,34,43,1,11,0,11,54,53,0,1,0,1
"2011","E00009832","E00009832","Total",125,72,25,47,0,17,11,6,36,36,0,0,0,0
"2011","E00009834","E00009834","Total",132,65,28,37,0,1,1,0,66,62,0,4,0,0
"2011","E00009836","E00009836","Total",119,62,25,37,0,30,29,1,26,24,0,2,0,1
"2011","E00009848","E00009848","Total",148,77,30,47,1,7,0,7,63,62,0,1,0,0
"2011","E00009858","E00009858","Total",116,57,18,39,0,3,2,1,55,52,0,3,0,1
"2011","E00009859","E00009859","Total",138,73,37,36,0,8,0,8,57,52,1,4,0,0
"2011","E00009989","E00009989","Total",101,52,18,34,0,3,0,3,46,43,1,2,0,0
"2011","E00009992","E00009992","Total",147,105,37,68,0,5,3,2,31,30,0,0,1,6
"2011","E00010002","E00010002","Total",106,56,23,33,0,35,5,30,14,13,1,0,0,1
"2011","E00010023","E00010023","Total",114,43,11,32,1,6,1,5,64,62,0,2,0,0
"2011","E00010024","E00010024","Total",121,97,34,63,1,3,0,3,19,19,0,0,0,1
"2011","E00010025","E00010025","Total",109,35,7,28,0,4,2,2,70,67,0,3,0,0
"2011","E00009995","E00009995","Total",129,68,21,47,0,8,4,4,52,51,0,1,0,1
"2011","E00009997","E00009997","Total",174,32,9,23,0,0,0,0,141,136,2,0,3,1
"2011","E00009998","E00009998","Total",165,62,26,36,0,11,4,7,91,88,2,1,0,1
"2011","E00010001","E00010001","Total",136,74,31,43,1,5,0,5,55,55,0,0,0,1
"2011","E00010026","E00010026","Total",126,61,23,38,0,4,0,4,59,55,3,1,0,2
"2011","E00010422","E00010422","Total",122,53,19,34,1,35,17,18,32,32,0,0,0,1
"2011","E00010425","E00010425","Total",129,45,25,20,0,43,24,19,40,36,1,1,2,1
"2011","E00010427","E00010427","Total",131,32,9,23,1,69,20,49,22,18,0,3,1,7
"2011","E00010430","E00010430","Total",137,65,17,48,0,35,15,20,34,31,2,1,0,3
"2011","E00010439","E00010439","Total",76,11,4,7,0,50,49,1,12,11,0,1,0,3
"2011","E00010431","E00010431","Total",126,46,23,23,0,52,50,2,25,23,1,1,0,3
"2011","E00010435","E00010435","Total",136,53,16,37,0,40,28,12,41,40,0,0,1,2
"2011","E00010437","E00010437","Total",132,50,20,30,2,26,15,11,51,50,0,1,0,3
"2011","E00010440","E00010440","Total",124,60,25,35,4,32,19,13,27,24,0,1,2,1
"2011","E00010441","E00010441","Total",121,55,24,31,1,18,10,8,45,44,0,1,0,2
"2011","E00010416","E00010416","Total",146,65,15,50,1,41,38,3,37,37,0,0,0,2
"2011","E00010417","E00010417","Total",127,42,15,27,0,54,40,14,29,28,0,1,0,2
"2011","E00010418","E00010418","Total",140,36,10,26,7,63,34,29,33,29,1,3,0,1
"2011","E00010419","E00010419","Total",138,27,10,17,0,81,58,23,28,26,0,1,1,2
"2011","E00010420","E00010420","Total",135,35,20,15,0,87,77,10,10,9,0,1,0,3
"2011","E00010421","E00010421","Total",161,37,3,34,3,95,90,5,26,23,0,3,0,0
"2011","E00010434","E00010434","Total",104,43,11,32,4,10,6,4,46,45,1,0,0,1
"2011","E00010415","E00010415","Total",118,42,20,22,3,39,16,23,31,30,0,1,0,3
"2011","E00010447","E00010447","Total",122,59,25,34,1,14,6,8,44,43,0,1,0,4
"2011","E00010448","E00010448","Total",129,73,42,31,0,7,2,5,44,41,0,1,2,5
"2011","E00010450","E00010450","Total",141,61,30,31,1,20,8,12,56,54,0,0,2,3
"2011","E00010176","E00010176","Total",143,29,9,20,0,89,84,5,22,21,0,1,0,3
"2011","E00010179","E00010179","Total",129,6,1,5,1,107,17,90,14,14,0,0,0,1
"2011","E00010181","E00010181","Total",145,19,5,14,0,102,85,17,21,21,0,0,0,3
"2011","E00010186","E00010186","Total",142,3,3,0,0,124,10,114,12,10,1,0,1,3
"2011","E00010203","E00010203","Total",152,34,9,25,0,80,77,3,32,32,0,0,0,6
"2011","E00010175","E00010175","Total",210,30,9,21,69,78,56,22,32,32,0,0,0,1
"2011","E00010178","E00010178","Total",139,16,7,9,2,71,16,55,47,44,0,3,0,3
"2011","E00010180","E00010180","Total",156,44,19,25,0,41,33,8,66,64,0,1,1,5
"2011","E00010204","E00010204","Total",235,43,14,29,36,125,69,56,29,29,0,0,0,2
"2011","E00010187","E00010187","Total",185,67,38,29,1,35,8,27,80,77,0,2,1,2
"2011","E00010189","E00010189","Total",140,74,36,38,1,11,7,4,53,53,0,0,0,1
"2011","E00010192","E00010192","Total",191,38,20,18,16,53,15,38,77,76,0,1,0,7
"2011","E00010193","E00010193","Total",142,69,37,32,0,17,13,4,53,50,0,3,0,3
"2011","E00010188","E00010188","Total",151,50,18,32,3,21,13,8,75,74,0,1,0,2
"2011","E00010190","E00010190","Total",134,45,23,22,2,37,34,3,48,48,0,0,0,2
"2011","E00010191","E00010191","Total",146,37,18,19,2,24,9,15,82,82,0,0,0,1
"2011","E00010194","E00010194","Total",210,28,15,13,0,38,25,13,141,135,1,2,3,3
"2011","E00010195","E00010195","Total",123,60,41,19,1,12,4,8,50,50,0,0,0,0
"2011","E00009996","E00009996","Total",147,55,17,38,0,11,9,2,81,81,0,0,0,0
"2011","E00009999","E00009999","Total",110,40,13,27,0,7,4,3,62,61,0,1,0,1
"2011","E00010000","E00010000","Total",92,35,6,29,0,1,0,1,56,56,0,0,0,0
"2011","E00010004","E00010004","Total",170,43,9,34,0,26,16,10,100,100,0,0,0,1
"2011","E00010005","E00010005","Total",126,76,35,41,1,3,3,0,46,43,0,3,0,0
"2011","E00010007","E00010007","Total",121,50,24,26,2,2,2,0,65,61,0,1,3,2
"2011","E00009991","E00009991","Total",112,73,41,32,0,0,0,0,38,36,0,2,0,1
"2011","E00009993","E00009993","Total",99,93,51,42,1,3,3,0,2,2,0,0,0,0
"2011","E00009994","E00009994","Total",122,105,66,39,0,3,2,1,12,11,0,1,0,2
"2011","E00010003","E00010003","Total",101,34,17,17,1,19,16,3,46,46,0,0,0,1
"2011","E00010009","E00010009","Total",136,67,39,28,0,3,1,2,66,57,1,2,6,0
"2011","E00010010","E00010010","Total",102,77,52,25,0,1,0,1,24,24,0,0,0,0
"2011","E00009990","E00009990","Total",103,66,38,28,0,29,29,0,7,6,0,1,0,1
"2011","E00010006","E00010006","Total",120,85,46,39,0,1,0,1,29,28,0,1,0,5
"2011","E00010008","E00010008","Total",139,119,64,55,0,2,1,1,18,18,0,0,0,0
"2011","E00010011","E00010011","Total",119,85,49,36,1,10,9,1,19,18,0,1,0,4
"2011","E00010012","E00010012","Total",128,108,55,53,0,5,4,1,15,15,0,0,0,0
"2011","E00009988","E00009988","Total",137,72,27,45,0,49,47,2,15,15,0,0,0,1
"2011","E00010019","E00010019","Total",119,63,19,44,0,47,45,2,7,7,0,0,0,2
"2011","E00010021","E00010021","Total",93,35,9,26,2,46,40,6,10,8,0,2,0,0
"2011","E00010022","E00010022","Total",129,58,21,37,1,62,61,1,6,6,0,0,0,2
"2011","E00170306","E00170306","Total",114,18,2,16,19,60,14,46,14,10,0,4,0,3
"2011","E00170309","E00170309","Total",109,70,23,47,3,6,3,3,28,27,0,1,0,2
"2011","E00170310","E00170310","Total",90,52,15,37,5,18,17,1,15,13,0,1,1,0
"2011","E00170311","E00170311","Total",107,66,10,56,13,14,3,11,13,11,0,2,0,1
"2011","E00009910","E00009910","Total",145,71,30,41,1,27,15,12,45,45,0,0,0,1
"2011","E00009914","E00009914","Total",127,47,21,26,3,35,16,19,36,36,0,0,0,6
"2011","E00009920","E00009920","Total",131,48,19,29,0,23,11,12,60,58,0,2,0,0
"2011","E00009941","E00009941","Total",117,60,25,35,0,21,9,12,35,34,0,1,0,1
"2011","E00009943","E00009943","Total",153,74,32,42,2,23,6,17,53,52,0,1,0,1
"2011","E00009909","E00009909","Total",158,66,24,42,4,39,22,17,42,39,0,3,0,7
"2011","E00009913","E00009913","Total",158,59,34,25,0,37,12,25,60,60,0,0,0,2
"2011","E00009922","E00009922","Total",136,43,18,25,0,29,15,14,61,59,0,1,1,3
"2011","E00009926","E00009926","Total",149,61,25,36,1,26,13,13,60,57,0,1,2,1
"2011","E00009906","E00009906","Total",126,59,26,33,0,27,7,20,40,40,0,0,0,0
"2011","E00009912","E00009912","Total",100,34,14,20,3,26,6,20,35,33,0,2,0,2
"2011","E00009919","E00009919","Total",144,71,36,35,0,27,16,11,44,44,0,0,0,2
"2011","E00009921","E00009921","Total",145,53,21,32,1,36,18,18,51,50,0,1,0,4
"2011","E00009923","E00009923","Total",161,72,30,42,0,30,16,14,58,56,0,2,0,1
"2011","E00009911","E00009911","Total",109,73,34,39,1,20,3,17,13,11,0,0,2,2
"2011","E00009916","E00009916","Total",133,78,32,46,0,18,11,7,37,37,0,0,0,0
"2011","E00009917","E00009917","Total",126,45,15,30,7,28,8,20,43,42,0,1,0,3
"2011","E00009918","E00009918","Total",112,65,17,48,3,15,5,10,28,25,0,0,3,1
"2011","E00009925","E00009925","Total",132,65,26,39,0,23,9,14,43,43,0,0,0,1
"2011","E00010457","E00010457","Total",113,53,25,28,0,10,4,6,49,48,0,1,0,1
"2011","E00010474","E00010474","Total",128,95,58,37,0,6,3,3,25,25,0,0,0,2
"2011","E00010480","E00010480","Total",146,67,35,32,2,12,6,6,64,62,0,2,0,1
"2011","E00010482","E00010482","Total",156,84,54,30,0,5,4,1,65,61,0,3,1,2
"2011","E00010461","E00010461","Total",161,45,13,32,0,41,33,8,70,65,1,1,3,5
"2011","E00010479","E00010479","Total",120,75,40,35,2,9,7,2,33,33,0,0,0,1
"2011","E00010481","E00010481","Total",103,73,42,31,0,3,1,2,25,24,0,1,0,2
"2011","E00010487","E00010487","Total",110,40,9,31,1,39,33,6,29,27,0,0,2,1
"2011","E00010488","E00010488","Total",125,72,29,43,2,10,3,7,39,37,0,1,1,2
"2011","E00010459","E00010459","Total",170,42,20,22,0,74,46,28,54,52,1,1,0,0
"2011","E00010484","E00010484","Total",154,80,36,44,1,13,5,8,60,58,0,1,1,0
"2011","E00010486","E00010486","Total",208,29,14,15,13,58,15,43,100,95,0,0,5,8
"2011","E00010490","E00010490","Total",128,65,31,34,0,14,6,8,49,49,0,0,0,0
"2011","E00010491","E00010491","Total",161,44,18,26,1,57,41,16,54,53,0,1,0,5
"2011","E00010460","E00010460","Total",158,55,28,27,0,33,9,24,66,66,0,0,0,4
"2011","E00010462","E00010462","Total",153,44,9,35,1,39,11,28,66,64,0,2,0,3
"2011","E00010463","E00010463","Total",132,27,14,13,1,48,11,37,52,51,0,0,1,4
"2011","E00010489","E00010489","Total",135,60,33,27,0,23,3,20,49,48,0,1,0,3
"2011","E00010493","E00010493","Total",136,52,29,23,0,49,37,12,33,28,0,3,2,2
"2011","E00010127","E00010127","Total",113,50,17,33,0,22,6,16,40,38,0,2,0,1
"2011","E00010128","E00010128","Total",166,53,12,41,0,28,13,15,83,82,0,1,0,2
"2011","E00010131","E00010131","Total",136,55,18,37,0,15,9,6,65,64,0,1,0,1
"2011","E00010132","E00010132","Total",137,47,12,35,1,34,28,6,49,49,0,0,0,6
"2011","E00010133","E00010133","Total",127,60,23,37,1,20,8,12,46,44,1,1,0,0
"2011","E00010134","E00010134","Total",118,43,8,35,2,28,12,16,45,44,0,1,0,0
"2011","E00010108","E00010108","Total",121,72,32,40,0,28,9,19,17,17,0,0,0,4
"2011","E00010135","E00010135","Total",150,37,4,33,0,73,73,0,39,37,0,2,0,1
"2011","E00010136","E00010136","Total",129,51,26,25,1,50,44,6,26,26,0,0,0,1
"2011","E00010137","E00010137","Total",124,15,4,11,5,97,34,63,6,5,0,0,1,1
"2011","E00010139","E00010139","Total",144,92,46,46,0,36,34,2,15,13,0,1,1,1
"2011","E00010114","E00010114","Total",121,14,5,9,2,93,88,5,12,12,0,0,0,0
"2011","E00010116","E00010116","Total",127,69,24,45,0,37,33,4,20,20,0,0,0,1
"2011","E00010117","E00010117","Total",117,64,23,41,0,40,39,1,13,13,0,0,0,0
"2011","E00010118","E00010118","Total",115,85,18,67,1,5,4,1,23,23,0,0,0,1
"2011","E00010123","E00010123","Total",122,61,29,32,0,41,36,5,19,17,1,1,0,1
"2011","E00170298","E00170298","Total",139,46,5,41,0,37,6,31,56,55,0,1,0,0
"2011","E00170312","E00170312","Total",145,39,4,35,45,37,6,31,23,21,0,2,0,1
"2011","E00170313","E00170313","Total",150,67,13,54,3,1,1,0,77,72,0,5,0,2
"2011","E00170314","E00170314","Total",121,23,4,19,3,20,6,14,74,74,0,0,0,1
"2011","E00170315","E00170315","Total",114,25,4,21,0,17,12,5,72,72,0,0,0,0
"2011","E00170316","E00170316","Total",109,19,2,17,5,7,3,4,77,76,0,1,0,1
"2011","E00170322","E00170322","Total",130,20,7,13,6,92,49,43,12,12,0,0,0,0
"2011","E00010115","E00010115","Total",109,9,4,5,0,87,83,4,11,10,0,1,0,2
"2011","E00010119","E00010119","Total",120,22,4,18,0,71,68,3,23,23,0,0,0,4
"2011","E00010120","E00010120","Total",136,16,2,14,2,97,80,17,15,12,0,1,2,6
"2011","E00010124","E00010124","Total",123,16,6,10,1,89,73,16,16,15,0,1,0,1
"2011","E00010141","E00010141","Total",121,60,20,40,0,28,6,22,33,33,0,0,0,0
"2011","E00010145","E00010145","Total",115,67,26,41,0,4,2,2,43,43,0,0,0,1
"2011","E00010149","E00010149","Total",141,69,30,39,0,4,0,4,68,68,0,0,0,0
"2011","E00010153","E00010153","Total",110,46,26,20,2,26,21,5,32,31,0,1,0,4
"2011","E00010155","E00010155","Total",112,31,12,19,1,16,6,10,64,64,0,0,0,0
"2011","E00010173","E00010173","Total",107,58,27,31,0,40,19,21,8,8,0,0,0,1
"2011","E00010142","E00010142","Total",220,55,22,33,0,13,10,3,149,140,0,9,0,3
"2011","E00010150","E00010150","Total",155,80,34,46,0,3,1,2,70,66,0,3,1,2
"2011","E00010151","E00010151","Total",129,45,20,25,0,6,4,2,75,65,7,0,3,3
"2011","E00010154","E00010154","Total",117,55,26,29,0,2,1,1,60,59,0,1,0,0
"2011","E00010165","E00010165","Total",127,39,18,21,0,7,6,1,80,79,0,1,0,1
"2011","E00010174","E00010174","Total",119,34,8,26,1,0,0,0,82,77,1,3,1,2
"2011","E00010140","E00010140","Total",128,112,61,51,1,3,2,1,10,9,0,0,1,2
"2011","E00010143","E00010143","Total",121,75,31,44,0,1,1,0,44,40,0,4,0,1
"2011","E00010146","E00010146","Total",128,88,54,34,0,11,10,1,23,22,0,1,0,6
"2011","E00010160","E00010160","Total",122,51,21,30,0,42,31,11,28,27,0,1,0,1
"2011","E00010161","E00010161","Total",110,88,38,50,1,1,1,0,19,19,0,0,0,1
"2011","E00010164","E00010164","Total",143,127,85,42,0,1,1,0,13,12,0,1,0,2
"2011","E00010166","E00010166","Total",111,75,31,44,0,0,0,0,36,35,0,1,0,0
"2011","E00010167","E00010167","Total",140,74,29,45,0,4,4,0,62,57,0,4,1,0
"2011","E00010168","E00010168","Total",127,81,43,38,0,3,2,1,42,42,0,0,0,1
"2011","E00010171","E00010171","Total",149,90,57,33,1,19,4,15,37,31,0,5,1,2
"2011","E00010121","E00010121","Total",129,55,19,36,2,58,56,2,14,13,0,1,0,0
"2011","E00010122","E00010122","Total",128,103,35,68,2,0,0,0,22,21,0,0,1,1
"2011","E00010125","E00010125","Total",116,97,37,60,0,3,2,1,16,16,0,0,0,0
"2011","E00010126","E00010126","Total",106,87,23,64,0,1,1,0,18,17,0,1,0,0
"2011","E00010130","E00010130","Total",116,56,19,37,1,5,2,3,52,48,1,1,2,2
"2011","E00010156","E00010156","Total",127,110,63,47,0,0,0,0,17,17,0,0,0,0
"2011","E00010157","E00010157","Total",126,113,56,57,0,1,1,0,10,9,0,1,0,2
"2011","E00010162","E00010162","Total",128,75,23,52,1,16,14,2,36,35,0,1,0,0
"2011","E00010163","E00010163","Total",122,98,40,58,0,3,1,2,20,19,0,1,0,1
"2011","E00010144","E00010144","Total",112,81,49,32,0,3,2,1,28,27,0,1,0,0
"2011","E00010147","E00010147","Total",117,91,59,32,0,5,1,4,20,19,1,0,0,1
"2011","E00010148","E00010148","Total",107,46,20,26,1,46,44,2,14,13,0,0,1,0
"2011","E00010152","E00010152","Total",136,109,44,65,1,2,2,0,23,21,0,2,0,1
"2011","E00010159","E00010159","Total",131,105,46,59,1,4,1,3,21,21,0,0,0,0
"2011","E00010158","E00010158","Total",147,108,51,57,0,5,5,0,32,31,0,1,0,2
"2011","E00010169","E00010169","Total",141,88,37,51,1,14,14,0,36,34,0,2,0,2
"2011","E00010170","E00010170","Total",113,50,19,31,1,52,44,8,6,4,0,1,1,4
"2011","E00010172","E00010172","Total",133,52,18,34,8,37,36,1,31,30,0,0,1,5
"2011","E00010032","E00010032","Total",150,76,41,35,0,12,3,9,61,59,0,1,1,1
"2011","E00010033","E00010033","Total",198,61,21,40,0,19,9,10,116,112,1,0,3,2
"2011","E00010035","E00010035","Total",173,75,20,55,0,4,2,2,91,86,0,1,4,3
"2011","E00010038","E00010038","Total",177,70,31,39,1,12,6,6,93,91,0,2,0,1
"2011","E00010041","E00010041","Total",167,73,26,47,3,22,7,15,62,61,0,1,0,7
"2011","E00010040","E00010040","Total",196,75,39,36,0,14,2,12,105,104,1,0,0,2
"2011","E00010047","E00010047","Total",123,62,17,45,0,18,3,15,40,40,0,0,0,3
"2011","E00010049","E00010049","Total",151,80,31,49,0,12,7,5,55,53,0,2,0,4
"2011","E00010052","E00010052","Total",128,74,30,44,1,11,6,5,37,37,0,0,0,5
"2011","E00010055","E00010055","Total",221,52,24,28,1,20,11,9,143,137,2,3,1,5
"2011","E00010027","E00010027","Total",213,31,16,15,2,56,32,24,122,121,0,0,1,2
"2011","E00010031","E00010031","Total",204,26,10,16,0,13,6,7,156,154,1,1,0,9
"2011","E00010034","E00010034","Total",188,39,11,28,1,106,23,83,39,37,0,2,0,3
"2011","E00010036","E00010036","Total",150,33,12,21,0,22,9,13,92,91,0,0,1,3
"2011","E00010039","E00010039","Total",174,22,8,14,2,55,53,2,90,89,0,0,1,5
"2011","E00010037","E00010037","Total",161,78,43,35,0,30,6,24,51,49,0,0,2,2
"2011","E00010042","E00010042","Total",162,68,22,46,4,23,15,8,67,67,0,0,0,0
"2011","E00010043","E00010043","Total",116,69,36,33,0,10,4,6,35,34,0,1,0,2
"2011","E00010044","E00010044","Total",146,83,33,50,1,20,11,9,41,41,0,0,0,1
"2011","E00010045","E00010045","Total",125,67,33,34,0,27,8,19,31,30,0,1,0,0
"2011","E00010380","E00010380","Total",140,68,32,36,0,21,10,11,49,48,0,0,1,2
"2011","E00010406","E00010406","Total",142,49,16,33,1,39,12,27,49,46,0,2,1,4
"2011","E00010409","E00010409","Total",164,34,13,21,4,91,22,69,30,29,0,1,0,5
"2011","E00010410","E00010410","Total",121,5,3,2,0,101,27,74,13,13,0,0,0,2
"2011","E00010413","E00010413","Total",133,25,9,16,3,88,54,34,16,15,0,0,1,1
"2011","E00010374","E00010374","Total",194,26,9,17,1,29,14,15,134,133,0,0,1,4
"2011","E00010375","E00010375","Total",159,51,17,34,3,49,15,34,54,54,0,0,0,2
"2011","E00010382","E00010382","Total",125,31,13,18,0,76,14,62,17,15,0,0,2,1
"2011","E00010385","E00010385","Total",126,26,6,20,0,42,31,11,56,53,1,0,2,2
"2011","E00010386","E00010386","Total",146,52,20,32,1,38,7,31,52,50,0,2,0,3
"2011","E00010407","E00010407","Total",130,22,9,13,0,71,31,40,34,34,0,0,0,3
"2011","E00010384","E00010384","Total",187,50,24,26,1,62,39,23,69,68,0,0,1,5
"2011","E00010389","E00010389","Total",131,70,34,36,0,18,11,7,42,38,0,4,0,1
"2011","E00010391","E00010391","Total",181,108,33,75,1,19,13,6,52,51,0,1,0,1
"2011","E00010399","E00010399","Total",144,78,28,50,1,22,2,20,43,39,0,2,2,0
"2011","E00010411","E00010411","Total",146,52,19,33,3,22,10,12,67,65,0,1,1,2
"2011","E00010390","E00010390","Total",146,30,11,19,0,85,76,9,27,27,0,0,0,4
"2011","E00010395","E00010395","Total",132,51,16,35,0,11,6,5,68,66,1,1,0,2
"2011","E00010396","E00010396","Total",141,29,10,19,1,77,38,39,30,29,0,0,1,4
"2011","E00010401","E00010401","Total",130,36,13,23,0,67,63,4,25,22,0,1,2,2
"2011","E00010402","E00010402","Total",132,58,16,42,1,31,21,10,42,40,0,1,1,0
"2011","E00010378","E00010378","Total",133,31,8,23,8,66,10,56,28,26,0,1,1,0
"2011","E00010383","E00010383","Total",118,16,6,10,5,72,9,63,25,23,0,2,0,0
"2011","E00010404","E00010404","Total",141,17,6,11,1,89,78,11,32,32,0,0,0,2
"2011","E00010405","E00010405","Total",114,27,8,19,2,62,50,12,18,17,0,1,0,5
"2011","E00170305","E00170305","Total",139,6,1,5,19,82,26,56,31,30,0,0,1,1
"2011","E00170319","E00170319","Total",136,12,6,6,22,68,24,44,31,30,0,0,1,3
"2011","E00010373","E00010373","Total",123,33,13,20,3,41,7,34,45,43,0,2,0,1
"2011","E00010376","E00010376","Total",178,33,14,19,15,36,20,16,92,92,0,0,0,2
"2011","E00010377","E00010377","Total",114,29,11,18,4,39,36,3,40,39,0,1,0,2
"2011","E00010381","E00010381","Total",105,30,10,20,1,30,20,10,42,41,0,0,1,2
"2011","E00010412","E00010412","Total",109,46,17,29,0,19,5,14,43,41,0,1,1,1
"2011","E00010414","E00010414","Total",110,38,14,24,1,28,15,13,43,42,0,1,0,0
"2011","E00010379","E00010379","Total",127,38,11,27,2,57,47,10,27,25,0,1,1,3
"2011","E00010387","E00010387","Total",141,30,16,14,1,33,10,23,73,71,0,2,0,4
"2011","E00010388","E00010388","Total",165,23,4,19,20,93,48,45,28,26,0,1,1,1
"2011","E00010392","E00010392","Total",112,19,5,14,0,79,75,4,14,10,0,3,1,0
"2011","E00010393","E00010393","Total",130,17,6,11,2,87,80,7,23,21,0,1,1,1
"2011","E00010394","E00010394","Total",129,46,17,29,1,39,15,24,41,40,0,0,1,2
"2011","E00010397","E00010397","Total",124,26,7,19,0,51,41,10,44,42,0,0,2,3
"2011","E00010398","E00010398","Total",117,47,20,27,2,35,23,12,32,30,0,1,1,1
"2011","E00010400","E00010400","Total",142,32,8,24,1,91,59,32,17,12,0,4,1,1
"2011","E00010403","E00010403","Total",168,42,14,28,12,69,43,26,41,40,0,1,0,4
"2011","E00010258","E00010258","Total",143,50,12,38,0,28,12,16,63,60,0,2,1,2
"2011","E00010266","E00010266","Total",133,54,25,29,3,16,6,10,55,53,2,0,0,5
"2011","E00010269","E00010269","Total",128,61,22,39,0,15,12,3,51,47,1,2,1,1
"2011","E00010290","E00010290","Total",161,45,21,24,0,31,15,16,83,79,1,3,0,2
"2011","E00010292","E00010292","Total",177,69,30,39,3,27,14,13,77,76,0,0,1,1
"2011","E00010256","E00010256","Total",142,37,14,23,5,32,13,19,66,65,1,0,0,2
"2011","E00010257","E00010257","Total",122,16,6,10,2,76,72,4,25,24,0,1,0,3
"2011","E00010265","E00010265","Total",166,43,21,22,13,64,51,13,44,44,0,0,0,2
"2011","E00010267","E00010267","Total",111,43,19,24,2,33,30,3,30,28,1,1,0,3
"2011","E00170317","E00170317","Total",132,19,7,12,19,65,29,36,27,25,0,2,0,2
"2011","E00170318","E00170318","Total",130,36,15,21,2,24,8,16,65,62,1,2,0,3
"2011","E00010264","E00010264","Total",113,39,17,22,1,61,38,23,10,10,0,0,0,2
"2011","E00010273","E00010273","Total",133,28,8,20,1,65,60,5,34,34,0,0,0,5
"2011","E00010274","E00010274","Total",137,66,35,31,3,24,15,9,40,38,0,2,0,4
"2011","E00010275","E00010275","Total",141,36,8,28,0,75,68,7,29,29,0,0,0,1
"2011","E00010276","E00010276","Total",152,57,24,33,3,37,21,16,52,52,0,0,0,3
"2011","E00010254","E00010254","Total",158,36,17,19,12,82,64,18,24,21,0,3,0,4
"2011","E00010262","E00010262","Total",132,35,15,20,4,72,61,11,19,19,0,0,0,2
"2011","E00010263","E00010263","Total",158,56,20,36,0,30,13,17,68,66,0,2,0,4
"2011","E00010288","E00010288","Total",119,49,17,32,0,45,39,6,23,23,0,0,0,2
"2011","E00010291","E00010291","Total",138,91,35,56,2,14,7,7,29,28,0,1,0,2
"2011","E00010268","E00010268","Total",133,76,35,41,2,4,1,3,50,47,1,2,0,1
"2011","E00010270","E00010270","Total",135,69,38,31,1,14,8,6,51,50,0,1,0,0
"2011","E00010271","E00010271","Total",130,49,19,30,0,33,7,26,48,48,0,0,0,0
"2011","E00010279","E00010279","Total",143,66,29,37,1,9,6,3,63,58,0,2,3,4
"2011","E00010272","E00010272","Total",131,66,26,40,2,13,4,9,48,44,0,1,3,2
"2011","E00010277","E00010277","Total",133,55,20,35,0,21,6,15,56,56,0,0,0,1
"2011","E00010278","E00010278","Total",164,31,9,22,0,18,8,10,113,113,0,0,0,2
"2011","E00010280","E00010280","Total",129,60,34,26,2,9,3,6,58,55,1,1,1,0
"2011","E00010281","E00010281","Total",136,72,46,26,0,12,4,8,52,50,0,1,1,0
"2011","E00010282","E00010282","Total",131,74,48,26,0,13,13,0,43,42,0,1,0,1
"2011","E00010283","E00010283","Total",112,69,35,34,0,6,5,1,36,34,0,0,2,1
"2011","E00010284","E00010284","Total",122,40,24,16,4,33,27,6,39,36,0,3,0,6
"2011","E00010285","E00010285","Total",120,25,10,15,0,7,5,2,87,85,0,1,1,1
"2011","E00010286","E00010286","Total",107,36,13,23,0,15,10,5,56,54,0,0,2,0
"2011","E00010259","E00010259","Total",155,93,34,59,0,14,11,3,46,44,0,1,1,2
"2011","E00010260","E00010260","Total",116,61,25,36,0,18,6,12,35,33,2,0,0,2
"2011","E00010261","E00010261","Total",124,72,38,34,1,8,6,2,42,40,0,1,1,1
"2011","E00010287","E00010287","Total",168,51,20,31,0,36,30,6,79,77,0,1,1,2
"2011","E00010289","E00010289","Total",127,18,7,11,0,87,82,5,22,22,0,0,0,0
"2011","E00010104","E00010104","Total",194,94,25,69,0,59,14,45,41,40,0,1,0,0
"2011","E00010105","E00010105","Total",182,76,30,46,1,58,38,20,45,45,0,0,0,2
"2011","E00010106","E00010106","Total",225,73,26,47,5,46,12,34,100,98,0,2,0,1
"2011","E00010107","E00010107","Total",108,44,17,27,1,49,23,26,12,12,0,0,0,2
"2011","E00010109","E00010109","Total",155,66,21,45,1,48,11,37,39,38,0,1,0,1
"2011","E00010103","E00010103","Total",129,41,16,25,0,28,7,21,60,57,0,0,3,0
"2011","E00010110","E00010110","Total",164,82,37,45,0,36,9,27,43,40,0,3,0,3
"2011","E00010111","E00010111","Total",153,60,10,50,1,51,14,37,41,41,0,0,0,0
"2011","E00010112","E00010112","Total",146,75,26,49,0,12,1,11,56,54,0,1,1,3
"2011","E00010138","E00010138","Total",159,77,15,62,11,15,11,4,52,51,0,1,0,4
"2011","E00010339","E00010339","Total",143,81,28,53,10,28,2,26,23,21,0,2,0,1
"2011","E00010343","E00010343","Total",147,19,6,13,3,110,99,11,14,13,0,0,1,1
"2011","E00010344","E00010344","Total",113,62,28,34,0,12,0,12,37,35,0,1,1,2
"2011","E00010371","E00010371","Total",150,103,33,70,0,27,16,11,20,19,0,1,0,0
"2011","E00010372","E00010372","Total",157,57,23,34,0,60,7,53,38,37,0,0,1,2
"2011","E00010334","E00010334","Total",134,82,20,62,0,11,1,10,40,34,0,5,1,1
"2011","E00010338","E00010338","Total",155,93,37,56,0,26,9,17,35,35,0,0,0,1
"2011","E00010340","E00010340","Total",139,69,32,37,1,11,3,8,58,55,0,1,2,0
"2011","E00010341","E00010341","Total",165,97,38,59,1,32,8,24,34,33,0,1,0,1
"2011","E00010342","E00010342","Total",170,87,20,67,1,30,4,26,49,47,0,2,0,3
"2011","E00010301","E00010301","Total",115,45,29,16,1,18,12,6,50,48,0,2,0,1
"2011","E00010303","E00010303","Total",111,55,34,21,0,7,4,3,48,45,0,3,0,1
"2011","E00010330","E00010330","Total",132,61,32,29,3,17,6,11,51,51,0,0,0,0
"2011","E00010332","E00010332","Total",109,52,22,30,2,13,7,6,41,39,0,2,0,1
"2011","E00010296","E00010296","Total",130,44,21,23,0,19,12,7,66,66,0,0,0,1
"2011","E00010300","E00010300","Total",118,35,14,21,1,21,8,13,61,60,0,0,1,0
"2011","E00010304","E00010304","Total",143,35,11,24,1,73,51,22,34,31,0,2,1,0
"2011","E00010309","E00010309","Total",126,13,6,7,0,71,48,23,39,37,0,2,0,3
"2011","E00010331","E00010331","Total",150,33,16,17,6,50,10,40,57,53,0,0,4,4
"2011","E00010299","E00010299","Total",119,68,43,25,0,3,1,2,48,44,0,4,0,0
"2011","E00010320","E00010320","Total",132,64,30,34,0,15,10,5,52,48,0,3,1,1
"2011","E00010329","E00010329","Total",168,25,10,15,37,78,58,20,27,26,1,0,0,1
"2011","E00010333","E00010333","Total",107,51,23,28,0,11,7,4,44,41,0,2,1,1
"2011","E00010293","E00010293","Total",97,45,20,25,3,5,4,1,44,41,0,3,0,0
"2011","E00010307","E00010307","Total",118,53,35,18,2,8,5,3,54,52,0,2,0,1
"2011","E00010317","E00010317","Total",119,58,22,36,3,7,5,2,50,47,0,2,1,1
"2011","E00010324","E00010324","Total",122,38,21,17,1,41,30,11,42,38,0,1,3,0
"2011","E00010013","E00010013","Total",111,99,67,32,0,2,1,1,9,6,0,3,0,1
"2011","E00010014","E00010014","Total",114,68,37,31,0,25,2,23,21,20,0,0,1,0
"2011","E00010015","E00010015","Total",126,59,35,24,0,19,2,17,47,45,0,1,1,1
"2011","E00010016","E00010016","Total",121,66,31,35,0,6,0,6,47,46,0,1,0,2
"2011","E00010017","E00010017","Total",140,76,26,50,1,5,1,4,57,53,2,2,0,1
"2011","E00010018","E00010018","Total",148,53,13,40,0,8,1,7,86,83,0,2,1,1
"2011","E00010064","E00010064","Total",118,93,60,33,0,3,2,1,10,8,2,0,0,12
"2011","E00010067","E00010067","Total",104,78,51,27,0,1,0,1,23,20,2,1,0,2
"2011","E00010078","E00010078","Total",131,59,43,16,1,2,1,1,67,51,11,3,2,2
"2011","E00010084","E00010084","Total",118,92,56,36,0,1,0,1,20,17,0,2,1,5
"2011","E00010089","E00010089","Total",172,56,31,25,0,81,23,58,31,27,1,0,3,4
"2011","E00010072","E00010072","Total",118,46,17,29,1,57,56,1,8,8,0,0,0,6
"2011","E00010073","E00010073","Total",99,73,48,25,1,3,1,2,19,17,2,0,0,3
"2011","E00010079","E00010079","Total",151,85,45,40,0,6,2,4,58,56,0,2,0,2
"2011","E00010093","E00010093","Total",107,69,43,26,0,3,2,1,34,33,0,1,0,1
"2011","E00010100","E00010100","Total",128,60,23,37,2,46,46,0,19,17,0,2,0,1
"2011","E00010102","E00010102","Total",115,27,5,22,0,77,77,0,11,11,0,0,0,0
"2011","E00010069","E00010069","Total",119,42,9,33,1,10,6,4,65,65,0,0,0,1
"2011","E00010070","E00010070","Total",150,68,36,32,3,15,4,11,49,42,2,4,1,15
"2011","E00010071","E00010071","Total",135,69,31,38,2,2,1,1,60,60,0,0,0,2
"2011","E00010077","E00010077","Total",115,39,14,25,0,63,62,1,12,12,0,0,0,1
"2011","E00010099","E00010099","Total",120,65,30,35,0,27,25,2,27,27,0,0,0,1
"2011","E00010101","E00010101","Total",122,75,35,40,0,0,0,0,46,45,0,1,0,1
"2011","E00010046","E00010046","Total",113,40,17,23,0,22,7,15,50,48,2,0,0,1
"2011","E00010048","E00010048","Total",115,59,23,36,0,13,5,8,43,40,0,3,0,0
"2011","E00010050","E00010050","Total",109,54,20,34,1,8,5,3,46,46,0,0,0,0
"2011","E00010051","E00010051","Total",105,81,30,51,0,6,4,2,17,17,0,0,0,1
"2011","E00010053","E00010053","Total",100,50,14,36,0,10,2,8,39,38,0,1,0,1
"2011","E00010054","E00010054","Total",148,52,25,27,4,14,6,8,77,75,0,2,0,1
"2011","E00010056","E00010056","Total",160,72,32,40,2,17,15,2,68,63,0,4,1,1
"2011","E00010057","E00010057","Total",118,36,11,25,0,14,6,8,68,65,0,2,1,0
"2011","E00010059","E00010059","Total",115,52,20,32,1,14,6,8,48,47,0,1,0,0
"2011","E00010061","E00010061","Total",157,54,20,34,2,15,8,7,84,82,0,2,0,2
"2011","E00010062","E00010062","Total",127,82,38,44,1,7,6,1,35,35,0,0,0,2
"2011","E00010029","E00010029","Total",116,47,26,21,0,8,2,6,61,58,0,3,0,0
"2011","E00010030","E00010030","Total",114,72,24,48,0,9,3,6,29,28,0,1,0,4
"2011","E00010058","E00010058","Total",137,32,7,25,14,37,12,25,50,50,0,0,0,4
"2011","E00010060","E00010060","Total",168,41,17,24,0,11,5,6,114,114,0,0,0,2
"2011","E00170301","E00170301","Total",84,3,1,2,0,34,29,5,43,43,0,0,0,4
"2011","E00170307","E00170307","Total",76,18,3,15,0,10,6,4,46,46,0,0,0,2
"2011","E00170308","E00170308","Total",86,29,6,23,2,5,3,2,48,47,0,0,1,2
"2011","E00010319","E00010319","Total",121,24,7,17,14,56,4,52,26,25,0,0,1,1
"2011","E00010326","E00010326","Total",209,63,33,30,9,41,20,21,94,91,1,2,0,2
"2011","E00010327","E00010327","Total",154,72,37,35,3,15,12,3,63,61,0,2,0,1
"2011","E00010328","E00010328","Total",197,51,21,30,14,13,5,8,119,115,0,4,0,0
"2011","E00010298","E00010298","Total",139,47,13,34,2,75,58,17,14,13,0,1,0,1
"2011","E00010313","E00010313","Total",155,18,8,10,3,109,98,11,24,24,0,0,0,1
"2011","E00010316","E00010316","Total",132,32,8,24,2,48,28,20,47,46,0,1,0,3
"2011","E00010321","E00010321","Total",108,37,13,24,0,24,7,17,45,45,0,0,0,2
"2011","E00010322","E00010322","Total",129,46,16,30,1,38,20,18,44,42,0,2,0,0
"2011","E00010295","E00010295","Total",115,18,6,12,1,73,65,8,20,20,0,0,0,3
"2011","E00010297","E00010297","Total",159,26,13,13,0,107,105,2,22,22,0,0,0,4
"2011","E00010302","E00010302","Total",131,3,1,2,0,118,116,2,7,7,0,0,0,3
"2011","E00010305","E00010305","Total",159,49,19,30,1,34,30,4,70,68,0,0,2,5
"2011","E00010306","E00010306","Total",133,30,10,20,1,84,80,4,12,12,0,0,0,6
"2011","E00010308","E00010308","Total",153,79,25,54,8,33,15,18,31,30,0,0,1,2
"2011","E00010312","E00010312","Total",146,14,7,7,3,90,87,3,31,29,1,1,0,8
"2011","E00010314","E00010314","Total",122,11,4,7,0,96,94,2,11,9,0,1,1,4
"2011","E00010315","E00010315","Total",120,51,19,32,2,40,37,3,25,24,0,1,0,2
"2011","E00010323","E00010323","Total",162,42,17,25,3,20,12,8,96,94,1,1,0,1
"2011","E00010325","E00010325","Total",138,39,13,26,2,47,10,37,49,47,0,2,0,1
"2011","E00010294","E00010294","Total",173,35,17,18,14,56,43,13,63,61,0,1,1,5
"2011","E00010310","E00010310","Total",128,81,37,44,0,12,6,6,33,33,0,0,0,2
"2011","E00010311","E00010311","Total",152,33,14,19,0,68,12,56,51,50,0,1,0,0
"2011","E00010318","E00010318","Total",104,57,27,30,0,12,7,5,33,32,0,1,0,2
"2011","E00009950","E00009950","Total",171,48,26,22,0,38,30,8,83,83,0,0,0,2
"2011","E00009973","E00009973","Total",103,63,22,41,0,12,11,1,28,27,0,1,0,0
"2011","E00009978","E00009978","Total",151,50,26,24,1,12,1,11,86,85,0,1,0,2
"2011","E00009979","E00009979","Total",124,66,19,47,3,13,5,8,42,41,0,1,0,0
"2011","E00009982","E00009982","Total",148,56,22,34,3,39,17,22,47,43,0,4,0,3
"2011","E00170299","E00170299","Total",170,114,61,53,0,2,2,0,53,52,0,1,0,1
"2011","E00009952","E00009952","Total",136,94,36,58,0,7,2,5,34,32,0,2,0,1
"2011","E00009958","E00009958","Total",120,71,22,49,1,8,3,5,37,32,0,4,1,3
"2011","E00009959","E00009959","Total",124,65,30,35,0,25,2,23,34,34,0,0,0,0
"2011","E00009960","E00009960","Total",126,79,32,47,0,11,2,9,36,34,0,1,1,0
"2011","E00009965","E00009965","Total",136,82,28,54,0,2,0,2,50,50,0,0,0,2
"2011","E00009969","E00009969","Total",127,74,41,33,0,0,0,0,52,52,0,0,0,1
"2011","E00009948","E00009948","Total",117,82,49,33,0,0,0,0,34,33,0,1,0,1
"2011","E00009949","E00009949","Total",146,111,51,60,1,3,1,2,30,25,0,5,0,1
"2011","E00009955","E00009955","Total",115,69,38,31,0,1,1,0,44,41,0,2,1,1
"2011","E00009964","E00009964","Total",104,71,42,29,0,3,0,3,29,29,0,0,0,1
"2011","E00009968","E00009968","Total",101,59,36,23,1,0,0,0,40,40,0,0,0,1
"2011","E00009971","E00009971","Total",98,54,29,25,0,7,0,7,37,35,1,1,0,0
"2011","E00009974","E00009974","Total",124,63,27,36,0,10,0,10,50,48,0,2,0,1
"2011","E00009951","E00009951","Total",96,44,24,20,9,31,26,5,12,12,0,0,0,0
"2011","E00009954","E00009954","Total",173,96,37,59,0,7,1,6,68,66,0,2,0,2
"2011","E00009963","E00009963","Total",116,72,39,33,1,7,2,5,36,36,0,0,0,0
"2011","E00009983","E00009983","Total",110,74,30,44,0,1,1,0,35,34,1,0,0,0
"2011","E00009986","E00009986","Total",126,95,35,60,1,2,0,2,27,26,0,1,0,1
"2011","E00009987","E00009987","Total",145,58,26,32,0,57,11,46,30,30,0,0,0,0
"2011","E00009957","E00009957","Total",150,92,36,56,0,17,16,1,41,41,0,0,0,0
"2011","E00009961","E00009961","Total",141,59,18,41,2,32,5,27,47,46,0,1,0,1
"2011","E00009962","E00009962","Total",154,73,28,45,0,27,4,23,53,50,0,3,0,1
"2011","E00009970","E00009970","Total",147,83,32,51,0,16,2,14,45,44,0,1,0,3
"2011","E00009972","E00009972","Total",152,84,40,44,9,17,5,12,42,40,0,2,0,0
"2011","E00009946","E00009946","Total",186,84,25,59,2,22,5,17,70,66,2,1,1,8
"2011","E00009947","E00009947","Total",142,41,19,22,0,63,3,60,37,37,0,0,0,1
"2011","E00009967","E00009967","Total",153,80,32,48,0,11,0,11,61,60,0,1,0,1
"2011","E00009975","E00009975","Total",131,52,19,33,1,19,7,12,59,58,0,1,0,0
"2011","E00009976","E00009976","Total",148,59,20,39,0,0,0,0,86,84,0,2,0,3
"2011","E00009980","E00009980","Total",121,71,35,36,1,2,0,2,45,45,0,0,0,2
"2011","E00009945","E00009945","Total",148,17,3,14,0,2,2,0,127,126,1,0,0,2
"2011","E00009953","E00009953","Total",117,60,23,37,0,7,5,2,50,49,0,1,0,0
"2011","E00009956","E00009956","Total",157,86,29,57,1,10,2,8,60,60,0,0,0,0
"2011","E00009984","E00009984","Total",134,62,18,44,0,17,7,10,55,53,0,2,0,0
"2011","E00009985","E00009985","Total",150,26,7,19,0,24,16,8,97,96,0,1,0,3
"2011","E00170297","E00170297","Total",133,59,19,40,4,5,2,3,64,61,0,3,0,1
"2011","E00170320","E00170320","Total",143,42,18,24,21,3,0,3,76,74,1,1,0,1
"2011","E00010349","E00010349","Total",152,66,12,54,0,27,23,4,56,55,0,1,0,3
"2011","E00010350","E00010350","Total",150,65,16,49,2,9,1,8,73,71,0,1,1,1
"2011","E00010351","E00010351","Total",127,60,25,35,0,13,2,11,54,54,0,0,0,0
"2011","E00010355","E00010355","Total",136,59,21,38,1,34,25,9,42,41,0,1,0,0
"2011","E00010357","E00010357","Total",149,65,16,49,1,25,8,17,52,47,0,5,0,6
"2011","E00010358","E00010358","Total",141,79,31,48,0,10,2,8,50,46,0,4,0,2
"2011","E00010066","E00010066","Total",157,56,12,44,1,29,15,14,71,68,0,3,0,0
"2011","E00010074","E00010074","Total",117,74,34,40,0,3,3,0,40,39,1,0,0,0
"2011","E00010082","E00010082","Total",169,27,6,21,0,5,3,2,137,135,0,1,1,0
"2011","E00010086","E00010086","Total",109,58,15,43,0,1,1,0,48,48,0,0,0,2
"2011","E00010088","E00010088","Total",139,42,9,33,1,12,1,11,83,81,0,2,0,1
"2011","E00010092","E00010092","Total",127,44,8,36,0,10,3,7,70,68,0,2,0,3
"2011","E00010080","E00010080","Total",117,56,18,38,1,6,3,3,54,52,0,2,0,0
"2011","E00010083","E00010083","Total",126,74,29,45,0,7,2,5,45,41,0,3,1,0
"2011","E00010087","E00010087","Total",121,56,24,32,1,9,3,6,53,53,0,0,0,2
"2011","E00010091","E00010091","Total",129,76,28,48,0,1,0,1,50,49,0,1,0,2
"2011","E00010094","E00010094","Total",130,32,10,22,0,34,33,1,63,63,0,0,0,1
"2011","E00010095","E00010095","Total",185,88,28,60,0,2,0,2,92,91,0,1,0,3
"2011","E00010065","E00010065","Total",136,101,68,33,1,8,0,8,23,21,0,2,0,3
"2011","E00010075","E00010075","Total",125,56,34,22,0,3,3,0,66,65,0,1,0,0
"2011","E00010076","E00010076","Total",154,109,63,46,0,0,0,0,43,42,0,1,0,2
"2011","E00010081","E00010081","Total",112,87,67,20,0,2,1,1,19,18,0,1,0,4
"2011","E00170300","E00170300","Total",133,60,24,36,1,21,0,21,49,48,0,1,0,2
"2011","E00170321","E00170321","Total",139,6,2,4,0,3,0,3,128,126,1,1,0,2
"2011","E00010068","E00010068","Total",137,92,48,44,0,9,1,8,34,34,0,0,0,2
"2011","E00010085","E00010085","Total",150,83,41,42,0,6,0,6,61,60,0,0,1,0
"2011","E00010090","E00010090","Total",94,74,52,22,0,0,0,0,18,16,0,2,0,2
"2011","E00010096","E00010096","Total",123,68,31,37,0,10,1,9,43,42,0,1,0,2
"2011","E00010097","E00010097","Total",118,68,36,32,0,1,0,1,48,45,0,3,0,1
"2011","E00010098","E00010098","Total",86,15,4,11,0,2,2,0,69,69,0,0,0,0
"2011","E00010345","E00010345","Total",127,75,28,47,1,12,5,7,38,35,0,3,0,1
"2011","E00010346","E00010346","Total",126,77,25,52,0,17,12,5,32,29,0,3,0,0
"2011","E00010347","E00010347","Total",121,62,17,45,1,16,8,8,42,40,0,0,2,0
"2011","E00010348","E00010348","Total",129,87,34,53,0,7,2,5,34,32,0,2,0,1
"2011","E00010352","E00010352","Total",104,38,12,26,0,26,9,17,37,37,0,0,0,3
"2011","E00010354","E00010354","Total",96,29,10,19,1,10,7,3,56,54,0,2,0,0
"2011","E00010335","E00010335","Total",122,51,16,35,0,26,16,10,44,42,0,2,0,1
"2011","E00010353","E00010353","Total",121,41,14,27,0,66,45,21,13,11,0,2,0,1
"2011","E00010356","E00010356","Total",121,49,19,30,0,21,6,15,50,49,0,1,0,1
"2011","E00010359","E00010359","Total",102,51,18,33,2,23,4,19,26,25,0,1,0,0
"2011","E00010360","E00010360","Total",119,28,7,21,0,47,44,3,42,41,0,1,0,2
"2011","E00010363","E00010363","Total",128,58,16,42,2,15,5,10,51,51,0,0,0,2
"2011","E00010336","E00010336","Total",123,42,16,26,1,61,36,25,19,19,0,0,0,0
"2011","E00010361","E00010361","Total",151,59,15,44,0,33,12,21,57,56,0,1,0,2
"2011","E00010364","E00010364","Total",155,71,29,42,1,25,8,17,56,55,0,1,0,2
"2011","E00010365","E00010365","Total",102,18,5,13,0,71,65,6,13,13,0,0,0,0
"2011","E00010369","E00010369","Total",117,37,12,25,0,47,34,13,33,33,0,0,0,0
"2011","E00010337","E00010337","Total",144,52,12,40,0,23,17,6,64,64,0,0,0,5
"2011","E00010362","E00010362","Total",120,57,16,41,1,22,3,19,39,38,0,1,0,1
"2011","E00010366","E00010366","Total",104,29,3,26,1,36,4,32,38,37,0,1,0,0
"2011","E00010367","E00010367","Total",140,41,15,26,0,32,3,29,64,62,1,1,0,3
"2011","E00010368","E00010368","Total",173,28,7,21,0,43,41,2,99,96,0,3,0,3
"2011","E00010370","E00010370","Total",134,41,11,30,2,49,40,9,39,37,0,2,0,3
"2011","E00010213","E00010213","Total",134,5,2,3,1,105,92,13,15,12,0,2,1,8
"2011","E00010218","E00010218","Total",166,15,5,10,13,74,66,8,61,58,1,1,1,3
"2011","E00010222","E00010222","Total",120,27,12,15,9,25,9,16,57,57,0,0,0,2
"2011","E00010246","E00010246","Total",124,10,1,9,1,96,91,5,14,14,0,0,0,3
"2011","E00010247","E00010247","Total",135,25,6,19,1,83,81,2,22,20,0,1,1,4
"2011","E00010253","E00010253","Total",132,25,4,21,1,79,69,10,23,21,0,0,2,4
"2011","E00010219","E00010219","Total",133,13,5,8,6,72,22,50,41,38,0,0,3,1
"2011","E00010227","E00010227","Total",175,15,4,11,21,54,39,15,82,80,0,1,1,3
"2011","E00010235","E00010235","Total",115,29,13,16,2,52,45,7,28,27,0,1,0,4
"2011","E00010238","E00010238","Total",97,16,6,10,1,46,13,33,33,31,0,1,1,1
"2011","E00010244","E00010244","Total",172,13,4,9,0,89,59,30,69,68,0,1,0,1
"2011","E00010225","E00010225","Total",126,21,6,15,2,86,81,5,11,11,0,0,0,6
"2011","E00010230","E00010230","Total",134,26,5,21,4,74,56,18,28,26,0,2,0,2
"2011","E00010232","E00010232","Total",114,39,18,21,1,53,25,28,14,12,0,0,2,7
"2011","E00010236","E00010236","Total",184,34,10,24,32,32,13,19,79,77,0,0,2,7
"2011","E00010241","E00010241","Total",178,71,40,31,6,38,27,11,58,56,0,2,0,5
"2011","E00010226","E00010226","Total",131,26,11,15,2,76,69,7,24,23,0,1,0,3
"2011","E00010252","E00010252","Total",166,36,12,24,15,48,29,19,65,65,0,0,0,2
"2011","E00165800","E00165800","Total",150,9,3,6,10,117,10,107,13,10,0,2,1,1
"2011","E00170323","E00170323","Total",97,6,1,5,37,43,4,39,8,7,0,0,1,3
"2011","E00170324","E00170324","Total",128,32,15,17,0,59,21,38,34,32,0,1,1,3
"2011","E00013708","E00013708","Total",135,36,5,31,0,78,56,22,20,20,0,0,0,1
"2011","E00013733","E00013733","Total",130,33,9,24,0,84,76,8,12,11,0,1,0,1
"2011","E00013734","E00013734","Total",117,14,8,6,1,93,57,36,6,5,0,0,1,3
"2011","E00013736","E00013736","Total",127,34,14,20,0,81,78,3,12,9,0,3,0,0
"2011","E00013740","E00013740","Total",126,18,3,15,1,95,65,30,11,11,0,0,0,1
"2011","E00013710","E00013710","Total",121,49,14,35,1,22,4,18,47,46,0,1,0,2
"2011","E00013730","E00013730","Total",115,59,22,37,1,18,12,6,36,34,0,1,1,1
"2011","E00013731","E00013731","Total",113,42,14,28,5,44,30,14,22,20,0,2,0,0
"2011","E00013735","E00013735","Total",140,48,21,27,1,63,52,11,27,25,0,2,0,1
"2011","E00013739","E00013739","Total",121,48,14,34,0,48,40,8,25,24,0,1,0,0
"2011","E00013714","E00013714","Total",149,21,2,19,1,109,103,6,15,14,0,0,1,3
"2011","E00013724","E00013724","Total",128,34,11,23,1,16,11,5,76,74,0,2,0,1
"2011","E00013732","E00013732","Total",112,5,1,4,0,102,99,3,5,5,0,0,0,0
"2011","E00013737","E00013737","Total",98,17,3,14,0,70,65,5,9,9,0,0,0,2
"2011","E00013741","E00013741","Total",130,16,2,14,0,101,93,8,13,13,0,0,0,0
"2011","E00013742","E00013742","Total",92,15,7,8,0,71,46,25,6,4,0,2,0,0
"2011","E00014000","E00014000","Total",151,38,9,29,0,31,12,19,78,75,1,0,2,4
"2011","E00014001","E00014001","Total",134,27,6,21,1,90,66,24,14,12,0,2,0,2
"2011","E00014010","E00014010","Total",135,19,4,15,0,108,102,6,8,8,0,0,0,0
"2011","E00014013","E00014013","Total",149,32,6,26,1,91,21,70,25,20,0,4,1,0
"2011","E00014018","E00014018","Total",185,34,8,26,0,86,17,69,63,59,1,2,1,2
"2011","E00013996","E00013996","Total",134,35,14,21,1,48,21,27,49,47,0,2,0,1
"2011","E00014021","E00014021","Total",160,28,15,13,8,69,55,14,54,53,0,0,1,1
"2011","E00014022","E00014022","Total",157,36,12,24,0,31,17,14,90,87,0,3,0,0
"2011","E00014026","E00014026","Total",158,43,13,30,3,93,60,33,19,17,0,1,1,0
"2011","E00014027","E00014027","Total",119,19,6,13,1,79,77,2,13,13,0,0,0,7
"2011","E00014030","E00014030","Total",96,12,5,7,0,80,78,2,3,3,0,0,0,1
"2011","E00014003","E00014003","Total",113,11,3,8,0,96,94,2,6,6,0,0,0,0
"2011","E00014004","E00014004","Total",96,12,2,10,1,72,69,3,11,11,0,0,0,0
"2011","E00014005","E00014005","Total",99,33,13,20,0,44,40,4,21,19,0,2,0,1
"2011","E00014006","E00014006","Total",106,5,2,3,1,92,90,2,5,5,0,0,0,3
"2011","E00014007","E00014007","Total",132,74,39,35,0,25,16,9,31,30,0,1,0,2
"2011","E00014009","E00014009","Total",148,63,12,51,0,55,15,40,28,26,0,0,2,2
"2011","E00013706","E00013706","Total",128,24,6,18,3,73,39,34,24,22,0,2,0,4
"2011","E00013723","E00013723","Total",101,17,6,11,7,61,40,21,13,12,0,0,1,3
"2011","E00013726","E00013726","Total",113,29,5,24,0,48,32,16,31,30,0,1,0,5
"2011","E00013728","E00013728","Total",119,37,14,23,0,69,24,45,11,10,0,1,0,2
"2011","E00013729","E00013729","Total",165,40,18,22,0,40,14,26,85,83,0,2,0,0
"2011","E00013712","E00013712","Total",107,70,37,33,2,1,0,1,34,31,1,2,0,0
"2011","E00013713","E00013713","Total",140,88,32,56,0,13,1,12,38,37,0,1,0,1
"2011","E00013715","E00013715","Total",138,69,30,39,1,13,10,3,53,52,0,1,0,2
"2011","E00013722","E00013722","Total",109,48,21,27,0,32,23,9,28,27,0,1,0,1
"2011","E00013727","E00013727","Total",120,20,7,13,0,71,67,4,27,27,0,0,0,2
"2011","E00013707","E00013707","Total",196,63,24,39,0,96,69,27,35,30,0,3,2,2
"2011","E00013711","E00013711","Total",142,105,48,57,1,8,6,2,26,26,0,0,0,2
"2011","E00013738","E00013738","Total",113,39,10,29,0,59,53,6,14,14,0,0,0,1
"2011","E00013743","E00013743","Total",139,38,12,26,0,80,65,15,17,15,0,2,0,4
"2011","E00013709","E00013709","Total",130,56,25,31,1,56,43,13,16,16,0,0,0,1
"2011","E00013716","E00013716","Total",130,64,25,39,1,44,41,3,20,19,0,1,0,1
"2011","E00013717","E00013717","Total",134,85,33,52,0,25,12,13,24,24,0,0,0,0
"2011","E00013719","E00013719","Total",118,72,23,49,0,17,11,6,29,27,0,2,0,0
"2011","E00013725","E00013725","Total",147,61,29,32,0,26,18,8,60,55,2,3,0,0
"2011","E00013704","E00013704","Total",120,44,16,28,0,65,39,26,9,9,0,0,0,2
"2011","E00013705","E00013705","Total",139,23,7,16,1,86,81,5,28,27,0,0,1,1
"2011","E00013718","E00013718","Total",127,28,11,17,4,75,59,16,19,17,0,1,1,1
"2011","E00013720","E00013720","Total",119,24,8,16,1,77,61,16,14,12,1,1,0,3
"2011","E00013721","E00013721","Total",121,32,6,26,0,64,49,15,24,23,0,1,0,1
"2011","E00013790","E00013790","Total",158,80,33,47,0,24,11,13,51,50,0,1,0,3
"2011","E00013808","E00013808","Total",104,22,9,13,0,73,62,11,8,8,0,0,0,1
"2011","E00013809","E00013809","Total",181,44,14,30,7,77,12,65,52,47,0,5,0,1
"2011","E00013811","E00013811","Total",109,19,11,8,0,67,64,3,21,20,0,0,1,2
"2011","E00013812","E00013812","Total",103,53,19,34,2,15,10,5,32,29,0,3,0,1
"2011","E00013818","E00013818","Total",216,64,14,50,12,40,18,22,98,95,0,3,0,2
"2011","E00013600","E00013600","Total",147,22,8,14,0,41,19,22,84,83,0,0,1,0
"2011","E00013601","E00013601","Total",116,29,11,18,0,53,35,18,32,30,0,2,0,2
"2011","E00013602","E00013602","Total",110,31,15,16,0,48,41,7,31,31,0,0,0,0
"2011","E00013603","E00013603","Total",122,19,4,15,2,47,11,36,51,50,0,1,0,3
"2011","E00013604","E00013604","Total",136,30,13,17,0,51,17,34,55,55,0,0,0,0
"2011","E00013607","E00013607","Total",146,19,9,10,1,51,42,9,71,70,0,0,1,4
"2011","E00013999","E00013999","Total",135,22,6,16,0,14,10,4,95,95,0,0,0,4
"2011","E00014008","E00014008","Total",109,28,6,22,1,20,15,5,59,59,0,0,0,1
"2011","E00014011","E00014011","Total",137,46,19,27,1,30,22,8,58,57,1,0,0,2
"2011","E00014012","E00014012","Total",114,23,13,10,0,57,57,0,32,32,0,0,0,2
"2011","E00014016","E00014016","Total",149,27,9,18,2,47,30,17,69,65,0,4,0,4
"2011","E00014020","E00014020","Total",114,39,19,20,0,39,25,14,33,32,0,1,0,3
"2011","E00014002","E00014002","Total",170,91,35,56,0,49,20,29,29,28,0,1,0,1
"2011","E00014014","E00014014","Total",143,58,20,38,0,59,42,17,26,25,0,1,0,0
"2011","E00014015","E00014015","Total",141,48,18,30,0,58,47,11,35,35,0,0,0,0
"2011","E00014017","E00014017","Total",132,62,32,30,1,48,36,12,21,20,0,0,1,0
"2011","E00014019","E00014019","Total",135,53,19,34,0,41,30,11,37,37,0,0,0,4
"2011","E00013997","E00013997","Total",176,46,18,28,12,65,34,31,50,47,1,1,1,3
"2011","E00014023","E00014023","Total",116,48,13,35,1,35,25,10,31,29,0,1,1,1
"2011","E00014024","E00014024","Total",153,76,20,56,0,17,9,8,57,52,0,5,0,3
"2011","E00014025","E00014025","Total",156,50,14,36,0,31,17,14,72,72,0,0,0,3
"2011","E00014032","E00014032","Total",121,38,14,24,2,35,23,12,45,43,0,1,1,1
"2011","E00014037","E00014037","Total",135,38,16,22,2,78,63,15,17,16,1,0,0,0
"2011","E00014028","E00014028","Total",123,52,20,32,2,43,25,18,26,25,0,1,0,0
"2011","E00014029","E00014029","Total",116,30,12,18,4,64,10,54,18,17,0,1,0,0
"2011","E00014031","E00014031","Total",143,45,10,35,1,48,23,25,45,44,0,1,0,4
"2011","E00014033","E00014033","Total",87,28,11,17,3,46,11,35,10,10,0,0,0,0
"2011","E00014035","E00014035","Total",126,33,9,24,0,35,9,26,56,55,0,1,0,2
"2011","E00014036","E00014036","Total",105,44,22,22,0,24,12,12,37,37,0,0,0,0
"2011","E00013998","E00013998","Total",119,40,16,24,0,52,46,6,26,24,0,2,0,1
"2011","E00014034","E00014034","Total",129,26,9,17,8,71,19,52,24,24,0,0,0,0
"2011","E00014038","E00014038","Total",101,23,11,12,3,40,31,9,35,35,0,0,0,0
"2011","E00014039","E00014039","Total",112,37,7,30,1,50,38,12,24,20,1,2,1,0
"2011","E00014040","E00014040","Total",144,51,15,36,1,75,63,12,13,11,0,2,0,4
"2011","E00014041","E00014041","Total",143,35,6,29,0,77,49,28,31,30,0,0,1,0
"2011","E00013786","E00013786","Total",121,45,19,26,1,37,7,30,37,36,0,1,0,1
"2011","E00013787","E00013787","Total",123,36,11,25,2,54,48,6,31,28,0,3,0,0
"2011","E00013799","E00013799","Total",148,62,17,45,34,30,2,28,22,21,0,1,0,0
"2011","E00013800","E00013800","Total",116,3,3,0,0,102,7,95,11,11,0,0,0,0
"2011","E00013803","E00013803","Total",121,1,1,0,0,104,1,103,14,13,0,0,1,2
"2011","E00013804","E00013804","Total",106,9,1,8,2,85,41,44,9,6,0,1,2,1
"2011","E00013805","E00013805","Total",116,37,13,24,1,21,3,18,56,54,2,0,0,1
"2011","E00013788","E00013788","Total",153,88,49,39,0,26,15,11,38,34,0,4,0,1
"2011","E00013789","E00013789","Total",138,19,7,12,0,94,88,6,20,20,0,0,0,5
"2011","E00013806","E00013806","Total",130,54,17,37,0,23,15,8,50,45,0,5,0,3
"2011","E00013807","E00013807","Total",179,86,26,60,1,27,24,3,65,65,0,0,0,0
"2011","E00013813","E00013813","Total",118,11,3,8,0,30,8,22,77,76,1,0,0,0
"2011","E00013785","E00013785","Total",142,33,15,18,1,85,58,27,20,18,0,1,1,3
"2011","E00013794","E00013794","Total",159,40,14,26,0,38,15,23,78,78,0,0,0,3
"2011","E00013797","E00013797","Total",119,24,12,12,0,86,19,67,7,7,0,0,0,2
"2011","E00013817","E00013817","Total",104,31,17,14,1,47,19,28,22,22,0,0,0,3
"2011","E00013827","E00013827","Total",135,55,27,28,1,55,9,46,23,23,0,0,0,1
"2011","E00013810","E00013810","Total",124,24,7,17,1,76,72,4,21,20,0,0,1,2
"2011","E00013814","E00013814","Total",81,26,12,14,0,44,40,4,9,8,0,1,0,2
"2011","E00013816","E00013816","Total",68,8,2,6,0,48,47,1,11,11,0,0,0,1
"2011","E00013819","E00013819","Total",99,18,9,9,0,68,65,3,13,13,0,0,0,0
"2011","E00013820","E00013820","Total",100,23,11,12,5,61,54,7,11,11,0,0,0,0
"2011","E00013822","E00013822","Total",109,14,5,9,1,87,55,32,7,6,0,1,0,0
"2011","E00013823","E00013823","Total",115,20,4,16,0,80,79,1,14,13,1,0,0,1
"2011","E00013791","E00013791","Total",156,18,4,14,0,119,19,100,18,18,0,0,0,1
"2011","E00013792","E00013792","Total",172,21,4,17,1,109,100,9,37,37,0,0,0,4
"2011","E00013815","E00013815","Total",131,46,13,33,0,18,14,4,67,64,1,2,0,0
"2011","E00013821","E00013821","Total",151,42,17,25,3,64,34,30,40,38,0,2,0,2
"2011","E00013824","E00013824","Total",151,35,11,24,0,64,19,45,49,45,1,3,0,3
"2011","E00013825","E00013825","Total",111,55,28,27,1,14,9,5,39,35,0,3,1,2
"2011","E00013826","E00013826","Total",133,23,3,20,1,72,4,68,34,32,0,1,1,3
"2011","E00013580","E00013580","Total",115,2,1,1,4,104,8,96,3,3,0,0,0,2
"2011","E00013584","E00013584","Total",148,17,9,8,0,90,76,14,40,39,1,0,0,1
"2011","E00013588","E00013588","Total",146,34,8,26,1,77,22,55,33,31,1,1,0,1
"2011","E00013598","E00013598","Total",135,10,3,7,5,108,10,98,9,9,0,0,0,3
"2011","E00174767","E00174767","Total",136,31,4,27,1,55,11,44,47,44,0,3,0,2
"2011","E00174815","E00174815","Total",141,20,4,16,0,86,17,69,34,33,1,0,0,1
"2011","E00013606","E00013606","Total",138,17,5,12,0,89,77,12,32,31,0,0,1,0
"2011","E00013612","E00013612","Total",117,4,3,1,1,106,104,2,4,4,0,0,0,2
"2011","E00013614","E00013614","Total",135,7,2,5,1,123,117,6,4,4,0,0,0,0
"2011","E00013615","E00013615","Total",40,2,1,1,0,34,34,0,3,3,0,0,0,1
"2011","E00174769","E00174769","Total",145,4,3,1,0,18,12,6,117,115,0,0,2,6
"2011","E00174817","E00174817","Total",121,10,6,4,0,31,18,13,79,78,0,0,1,1
"2011","E00013605","E00013605","Total",108,24,12,12,0,57,50,7,25,24,0,1,0,2
"2011","E00013609","E00013609","Total",140,26,6,20,0,97,94,3,14,14,0,0,0,3
"2011","E00013611","E00013611","Total",109,4,0,4,1,96,94,2,6,6,0,0,0,2
"2011","E00013616","E00013616","Total",123,6,3,3,0,111,105,6,2,2,0,0,0,4
"2011","E00013617","E00013617","Total",115,10,5,5,0,89,79,10,13,12,0,1,0,3
"2011","E00013582","E00013582","Total",143,26,10,16,0,88,80,8,28,27,0,1,0,1
"2011","E00013608","E00013608","Total",106,24,12,12,0,42,13,29,37,34,0,3,0,3
"2011","E00013610","E00013610","Total",151,36,12,24,1,69,34,35,45,42,1,2,0,0
"2011","E00013613","E00013613","Total",121,18,7,11,0,94,89,5,7,7,0,0,0,2
"2011","E00013619","E00013619","Total",118,23,13,10,0,79,59,20,15,14,0,1,0,1
"2011","E00013620","E00013620","Total",149,16,10,6,0,121,72,49,10,10,0,0,0,2
"2011","E00013668","E00013668","Total",146,9,2,7,4,122,112,10,9,8,0,1,0,2
"2011","E00013671","E00013671","Total",131,5,4,1,0,116,110,6,10,10,0,0,0,0
"2011","E00013673","E00013673","Total",108,7,5,2,0,95,92,3,4,4,0,0,0,2
"2011","E00013675","E00013675","Total",196,58,22,36,2,56,32,24,78,74,0,3,1,2
"2011","E00013679","E00013679","Total",133,11,6,5,0,106,101,5,14,14,0,0,0,2
"2011","E00013680","E00013680","Total",166,52,23,29,2,62,29,33,50,45,0,5,0,0
"2011","E00013627","E00013627","Total",138,80,39,41,0,29,19,10,26,25,0,1,0,3
"2011","E00013632","E00013632","Total",138,77,28,49,0,16,10,6,45,45,0,0,0,0
"2011","E00013634","E00013634","Total",114,60,28,32,0,29,11,18,25,24,0,1,0,0
"2011","E00013638","E00013638","Total",145,41,7,34,0,14,10,4,90,88,0,2,0,0
"2011","E00013639","E00013639","Total",140,82,42,40,1,26,12,14,29,29,0,0,0,2
"2011","E00013663","E00013663","Total",118,23,7,16,1,47,13,34,45,42,1,1,1,2
"2011","E00013664","E00013664","Total",131,75,36,39,0,25,4,21,29,27,0,2,0,2
"2011","E00013665","E00013665","Total",149,95,47,48,1,8,4,4,43,41,0,2,0,2
"2011","E00013693","E00013693","Total",111,40,18,22,1,34,11,23,35,34,0,1,0,1
"2011","E00013700","E00013700","Total",166,64,29,35,0,24,7,17,78,78,0,0,0,0
"2011","E00013694","E00013694","Total",142,19,13,6,2,45,33,12,76,75,0,1,0,0
"2011","E00013695","E00013695","Total",171,55,16,39,2,59,23,36,50,47,0,2,1,5
"2011","E00013696","E00013696","Total",99,4,4,0,2,86,12,74,6,6,0,0,0,1
"2011","E00013697","E00013697","Total",131,65,23,42,1,25,5,20,40,39,0,1,0,0
"2011","E00013699","E00013699","Total",124,16,6,10,2,100,41,59,6,6,0,0,0,0
"2011","E00013667","E00013667","Total",142,68,26,42,0,48,27,21,22,18,0,2,2,4
"2011","E00013701","E00013701","Total",122,68,28,40,0,28,22,6,24,22,0,2,0,2
"2011","E00013702","E00013702","Total",182,28,8,20,0,125,122,3,27,25,1,1,0,2
"2011","E00013703","E00013703","Total",88,26,11,15,2,37,27,10,22,22,0,0,0,1
"2011","E00174820","E00174820","Total",199,43,14,29,0,5,4,1,149,141,0,8,0,2
"2011","E00174822","E00174822","Total",255,47,15,32,15,17,7,10,173,168,1,4,0,3
"2011","E00174828","E00174828","Total",247,50,17,33,34,8,1,7,151,147,0,4,0,4
"2011","E00013669","E00013669","Total",187,71,23,48,0,30,12,18,86,78,0,8,0,0
"2011","E00013670","E00013670","Total",126,73,34,39,1,24,18,6,28,26,0,2,0,0
"2011","E00013676","E00013676","Total",109,57,30,27,0,27,8,19,25,23,0,2,0,0
"2011","E00013698","E00013698","Total",119,87,42,45,0,13,8,5,19,19,0,0,0,0
"2011","E00174831","E00174831","Total",89,26,8,18,1,34,25,9,28,26,0,2,0,0
"2011","E00013581","E00013581","Total",136,44,19,25,0,37,15,22,54,51,0,2,1,1
"2011","E00013587","E00013587","Total",147,28,15,13,2,34,10,24,80,77,0,3,0,3
"2011","E00013589","E00013589","Total",139,33,12,21,1,61,11,50,44,42,1,1,0,0
"2011","E00013593","E00013593","Total",150,36,16,20,1,21,12,9,92,91,0,0,1,0
"2011","E00013595","E00013595","Total",93,33,9,24,1,19,13,6,40,39,0,1,0,0
"2011","E00013599","E00013599","Total",147,51,18,33,2,43,26,17,49,46,0,2,1,2
"2011","E00013590","E00013590","Total",133,48,25,23,0,28,6,22,56,54,0,2,0,1
"2011","E00013592","E00013592","Total",108,17,4,13,1,66,61,5,23,22,0,0,1,1
"2011","E00013596","E00013596","Total",122,33,16,17,2,27,11,16,57,56,0,1,0,3
"2011","E00013597","E00013597","Total",170,39,17,22,0,34,21,13,94,91,0,2,1,3
"2011","E00174787","E00174787","Total",151,24,13,11,1,50,44,6,76,73,0,3,0,0
"2011","E00174789","E00174789","Total",214,104,35,69,1,6,4,2,98,96,0,2,0,5
"2011","E00174791","E00174791","Total",100,24,6,18,0,16,14,2,57,56,0,1,0,3
"2011","E00174814","E00174814","Total",166,103,18,85,0,17,10,7,42,41,0,1,0,4
"2011","E00013583","E00013583","Total",197,102,38,64,0,24,7,17,68,67,0,1,0,3
"2011","E00013585","E00013585","Total",135,41,13,28,8,40,3,37,40,33,1,6,0,6
"2011","E00013586","E00013586","Total",103,53,17,36,0,1,1,0,48,41,0,6,1,1
"2011","E00013591","E00013591","Total",95,54,29,25,2,14,4,10,23,22,0,0,1,2
"2011","E00013622","E00013622","Total",68,25,10,15,0,18,7,11,24,23,0,1,0,1
"2011","E00013763","E00013763","Total",101,23,9,14,1,25,6,19,52,51,0,1,0,0
"2011","E00013764","E00013764","Total",124,42,17,25,0,42,37,5,35,33,0,2,0,5
"2011","E00013765","E00013765","Total",117,12,5,7,0,48,46,2,56,55,0,1,0,1
"2011","E00013768","E00013768","Total",121,29,11,18,1,69,36,33,20,19,0,1,0,2
"2011","E00013771","E00013771","Total",140,36,17,19,0,72,29,43,29,28,0,0,1,3
"2011","E00013793","E00013793","Total",105,35,14,21,0,62,21,41,7,7,0,0,0,1
"2011","E00013795","E00013795","Total",116,37,8,29,2,54,6,48,23,22,0,1,0,0
"2011","E00013796","E00013796","Total",127,36,16,20,1,54,6,48,35,32,0,1,2,1
"2011","E00013798","E00013798","Total",87,63,28,35,0,13,8,5,10,9,0,1,0,1
"2011","E00013802","E00013802","Total",143,77,42,35,0,31,6,25,31,30,0,1,0,4
"2011","E00174739","E00174739","Total",122,64,15,49,1,29,6,23,27,27,0,0,0,1
"2011","E00174825","E00174825","Total",147,4,3,1,2,36,1,35,104,98,0,0,6,1
"2011","E00013886","E00013886","Total",160,44,22,22,0,49,9,40,65,65,0,0,0,2
"2011","E00013887","E00013887","Total",161,92,44,48,5,25,5,20,37,35,0,2,0,2
"2011","E00013888","E00013888","Total",167,107,54,53,2,20,6,14,37,34,0,2,1,1
"2011","E00013889","E00013889","Total",175,68,29,39,0,60,53,7,45,43,0,1,1,2
"2011","E00013890","E00013890","Total",177,65,32,33,3,58,16,42,51,48,0,1,2,0
"2011","E00013872","E00013872","Total",138,67,25,42,1,37,8,29,30,29,0,1,0,3
"2011","E00013873","E00013873","Total",145,48,19,29,0,60,31,29,35,35,0,0,0,2
"2011","E00013876","E00013876","Total",151,44,13,31,2,19,9,10,83,79,1,2,1,3
"2011","E00013893","E00013893","Total",154,59,19,40,0,32,11,21,59,55,0,4,0,4
"2011","E00013895","E00013895","Total",123,53,18,35,3,30,7,23,35,33,0,2,0,2
"2011","E00013896","E00013896","Total",90,38,15,23,0,30,19,11,22,17,1,4,0,0
"2011","E00013901","E00013901","Total",115,72,28,44,1,14,7,7,26,23,0,3,0,2
"2011","E00013898","E00013898","Total",118,65,33,32,0,10,1,9,41,39,1,1,0,2
"2011","E00013900","E00013900","Total",140,91,53,38,0,25,11,14,22,21,0,1,0,2
"2011","E00013902","E00013902","Total",140,97,38,59,0,15,5,10,28,25,0,2,1,0
"2011","E00013903","E00013903","Total",117,77,31,46,1,20,4,16,18,18,0,0,0,1
"2011","E00013905","E00013905","Total",171,75,23,52,0,43,11,32,51,48,0,2,1,2
"2011","E00013906","E00013906","Total",124,55,25,30,1,24,9,15,44,43,0,1,0,0
"2011","E00013650","E00013650","Total",118,45,19,26,0,49,40,9,23,23,0,0,0,1
"2011","E00013651","E00013651","Total",153,67,36,31,0,46,11,35,38,35,1,2,0,2
"2011","E00013652","E00013652","Total",160,74,27,47,1,47,21,26,35,34,0,0,1,3
"2011","E00013656","E00013656","Total",159,73,42,31,0,42,29,13,39,37,0,2,0,5
"2011","E00013658","E00013658","Total",130,46,20,26,2,54,30,24,27,26,0,0,1,1
"2011","E00013660","E00013660","Total",119,33,21,12,0,51,43,8,33,31,0,2,0,2
"2011","E00013628","E00013628","Total",112,19,8,11,4,72,69,3,17,17,0,0,0,0
"2011","E00013633","E00013633","Total",140,27,9,18,1,78,73,5,32,28,0,3,1,2
"2011","E00013635","E00013635","Total",120,27,11,16,1,72,65,7,20,18,0,2,0,0
"2011","E00013636","E00013636","Total",134,40,18,22,0,65,61,4,26,25,0,0,1,3
"2011","E00013637","E00013637","Total",150,34,9,25,0,89,88,1,25,23,0,2,0,2
"2011","E00013629","E00013629","Total",150,33,19,14,0,66,33,33,51,49,0,0,2,0
"2011","E00013640","E00013640","Total",159,88,37,51,1,30,17,13,39,37,0,2,0,1
"2011","E00013641","E00013641","Total",126,39,10,29,0,51,36,15,35,34,0,1,0,1
"2011","E00013642","E00013642","Total",148,70,31,39,0,32,11,21,46,43,0,2,1,0
"2011","E00013644","E00013644","Total",143,34,7,27,0,71,67,4,35,33,0,2,0,3
"2011","E00013643","E00013643","Total",113,66,32,34,0,17,10,7,29,28,0,1,0,1
"2011","E00013645","E00013645","Total",125,31,14,17,1,46,37,9,42,42,0,0,0,5
"2011","E00013646","E00013646","Total",131,81,26,55,0,21,9,12,27,26,0,1,0,2
"2011","E00013647","E00013647","Total",127,56,8,48,0,39,24,15,31,27,1,3,0,1
"2011","E00013648","E00013648","Total",102,19,6,13,1,65,63,2,15,15,0,0,0,2
"2011","E00013649","E00013649","Total",124,26,7,19,0,67,66,1,27,26,0,1,0,4
"2011","E00013672","E00013672","Total",146,55,19,36,0,53,34,19,37,36,0,1,0,1
"2011","E00013677","E00013677","Total",130,27,13,14,0,89,84,5,14,14,0,0,0,0
"2011","E00013678","E00013678","Total",134,73,21,52,0,31,16,15,27,25,0,2,0,3
"2011","E00013683","E00013683","Total",124,27,9,18,0,78,60,18,18,17,0,0,1,1
"2011","E00013684","E00013684","Total",117,36,9,27,0,60,46,14,19,17,0,2,0,2
"2011","E00013749","E00013749","Total",114,23,9,14,0,65,11,54,24,24,0,0,0,2
"2011","E00013774","E00013774","Total",150,33,12,21,1,56,38,18,59,56,0,1,2,1
"2011","E00013777","E00013777","Total",130,55,25,30,0,24,9,15,49,49,0,0,0,2
"2011","E00013781","E00013781","Total",137,55,20,35,0,50,42,8,28,28,0,0,0,4
"2011","E00013782","E00013782","Total",127,19,13,6,2,88,75,13,15,14,0,1,0,3
"2011","E00013784","E00013784","Total",138,40,15,25,0,80,8,72,12,8,0,0,4,6
"2011","E00013877","E00013877","Total",235,61,13,48,2,124,108,16,45,41,0,2,2,3
"2011","E00013881","E00013881","Total",99,16,1,15,0,66,64,2,16,16,0,0,0,1
"2011","E00013882","E00013882","Total",118,29,13,16,1,52,41,11,32,28,0,4,0,4
"2011","E00013883","E00013883","Total",112,17,8,9,0,79,75,4,15,12,1,2,0,1
"2011","E00013884","E00013884","Total",75,14,8,6,1,47,46,1,10,8,0,2,0,3
"2011","E00013885","E00013885","Total",79,22,7,15,5,18,14,4,34,33,0,1,0,0
"2011","E00013878","E00013878","Total",110,15,5,10,0,81,77,4,14,13,0,0,1,0
"2011","E00013880","E00013880","Total",88,5,0,5,0,69,66,3,12,12,0,0,0,2
"2011","E00013908","E00013908","Total",192,63,24,39,16,57,43,14,55,53,0,2,0,1
"2011","E00013909","E00013909","Total",114,49,20,29,2,23,12,11,40,38,0,2,0,0
"2011","E00013910","E00013910","Total",110,17,3,14,0,65,58,7,27,25,0,0,2,1
"2011","E00013912","E00013912","Total",118,27,8,19,0,82,81,1,8,8,0,0,0,1
"2011","E00013874","E00013874","Total",117,43,18,25,0,12,12,0,60,58,0,1,1,2
"2011","E00013891","E00013891","Total",160,21,4,17,0,60,58,2,77,74,1,1,1,2
"2011","E00013892","E00013892","Total",146,23,10,13,1,80,58,22,38,34,0,3,1,4
"2011","E00013894","E00013894","Total",141,13,4,9,0,115,52,63,10,9,0,0,1,3
"2011","E00013897","E00013897","Total",142,24,6,18,0,92,85,7,21,20,0,1,0,5
"2011","E00013899","E00013899","Total",122,37,7,30,2,59,35,24,23,23,0,0,0,1
"2011","E00013875","E00013875","Total",155,35,6,29,2,67,9,58,50,47,1,2,0,1
"2011","E00013879","E00013879","Total",96,10,4,6,0,68,63,5,18,18,0,0,0,0
"2011","E00013904","E00013904","Total",116,31,13,18,1,39,18,21,44,42,0,1,1,1
"2011","E00013907","E00013907","Total",110,20,7,13,1,57,31,26,28,16,0,3,9,4
"2011","E00013911","E00013911","Total",101,13,4,9,0,80,78,2,7,6,0,0,1,1
"2011","E00013745","E00013745","Total",138,61,18,43,0,28,15,13,46,43,0,1,2,3
"2011","E00013746","E00013746","Total",141,25,11,14,0,54,23,31,62,59,0,3,0,0
"2011","E00013747","E00013747","Total",166,43,15,28,2,59,32,27,58,56,0,2,0,4
"2011","E00013776","E00013776","Total",148,64,25,39,2,32,15,17,48,47,0,1,0,2
"2011","E00013778","E00013778","Total",158,66,27,39,3,32,23,9,57,51,0,6,0,0
"2011","E00013780","E00013780","Total",138,40,11,29,2,41,10,31,55,53,0,2,0,0
"2011","E00013744","E00013744","Total",189,62,21,41,30,46,9,37,50,46,0,4,0,1
"2011","E00013766","E00013766","Total",126,25,9,16,0,80,77,3,19,15,0,3,1,2
"2011","E00013767","E00013767","Total",161,25,7,18,0,124,120,4,8,8,0,0,0,4
"2011","E00013769","E00013769","Total",135,32,5,27,0,70,55,15,29,28,0,1,0,4
"2011","E00013770","E00013770","Total",137,69,36,33,0,30,27,3,34,32,0,1,1,4
"2011","E00013772","E00013772","Total",117,26,15,11,0,66,63,3,21,20,0,1,0,4
"2011","E00013773","E00013773","Total",117,22,4,18,0,75,72,3,17,17,0,0,0,3
"2011","E00013748","E00013748","Total",117,22,6,16,1,81,64,17,11,8,0,3,0,2
"2011","E00013783","E00013783","Total",169,50,14,36,7,61,31,30,50,47,0,3,0,1
"2011","E00174745","E00174745","Total",139,27,8,19,2,71,54,17,36,35,0,1,0,3
"2011","E00174750","E00174750","Total",265,79,25,54,2,16,5,11,168,163,0,5,0,0
"2011","E00174759","E00174759","Total",170,48,14,34,27,6,4,2,88,84,0,3,1,1
"2011","E00174794","E00174794","Total",160,7,1,6,38,94,5,89,20,19,0,1,0,1
"2011","E00013752","E00013752","Total",110,28,8,20,0,39,11,28,41,41,0,0,0,2
"2011","E00013760","E00013760","Total",138,20,4,16,0,99,43,56,17,15,0,0,2,2
"2011","E00174755","E00174755","Total",125,18,6,12,0,76,59,17,26,25,0,1,0,5
"2011","E00174756","E00174756","Total",184,23,2,21,1,107,7,100,51,50,0,0,1,2
"2011","E00013674","E00013674","Total",159,53,21,32,2,61,37,24,42,42,0,0,0,1
"2011","E00013682","E00013682","Total",164,41,24,17,0,23,8,15,95,94,0,1,0,5
"2011","E00013691","E00013691","Total",171,48,13,35,1,83,62,21,37,32,1,4,0,2
"2011","E00174792","E00174792","Total",132,23,8,15,2,34,17,17,70,70,0,0,0,3
"2011","E00174826","E00174826","Total",121,6,1,5,2,26,8,18,82,80,0,1,1,5
"2011","E00174837","E00174837","Total",122,18,5,13,17,21,20,1,65,61,1,1,2,1
"2011","E00174819","E00174819","Total",317,47,11,36,97,113,5,108,59,57,0,2,0,1
"2011","E00174834","E00174834","Total",276,20,3,17,2,39,7,32,214,209,0,4,1,1
"2011","E00174845","E00174845","Total",94,24,15,9,0,22,5,17,48,46,0,2,0,0
"2011","E00013830","E00013830","Total",118,50,19,31,2,48,42,6,18,17,1,0,0,0
"2011","E00013831","E00013831","Total",214,56,9,47,17,76,29,47,51,46,0,4,1,14
"2011","E00013844","E00013844","Total",128,55,15,40,0,21,6,15,51,47,1,3,0,1
"2011","E00013852","E00013852","Total",120,27,7,20,0,60,39,21,32,32,0,0,0,1
"2011","E00013854","E00013854","Total",111,18,5,13,0,72,20,52,21,19,0,2,0,0
"2011","E00013867","E00013867","Total",142,48,14,34,0,54,14,40,38,38,0,0,0,2
"2011","E00013829","E00013829","Total",126,25,10,15,1,65,51,14,35,34,0,0,1,0
"2011","E00013835","E00013835","Total",209,27,4,23,1,133,114,19,45,44,0,1,0,3
"2011","E00013857","E00013857","Total",131,18,7,11,0,99,72,27,12,12,0,0,0,2
"2011","E00013869","E00013869","Total",142,26,8,18,3,89,56,33,24,23,0,1,0,0
"2011","E00013871","E00013871","Total",135,15,1,14,0,97,61,36,20,18,0,0,2,3
"2011","E00013838","E00013838","Total",160,51,12,39,4,69,61,8,35,32,0,1,2,1
"2011","E00013840","E00013840","Total",135,52,23,29,7,40,34,6,35,32,0,2,1,1
"2011","E00013841","E00013841","Total",156,66,23,43,7,34,18,16,49,47,0,2,0,0
"2011","E00013842","E00013842","Total",121,66,23,43,0,27,18,9,27,27,0,0,0,1
"2011","E00013843","E00013843","Total",93,19,6,13,1,52,48,4,21,21,0,0,0,0
"2011","E00013859","E00013859","Total",155,31,8,23,1,31,7,24,91,88,0,3,0,1
"2011","E00013839","E00013839","Total",123,31,10,21,0,71,66,5,21,20,0,1,0,0
"2011","E00013845","E00013845","Total",108,42,10,32,0,35,20,15,28,28,0,0,0,3
"2011","E00013856","E00013856","Total",103,25,10,15,0,63,60,3,13,13,0,0,0,2
"2011","E00013858","E00013858","Total",128,17,2,15,1,91,88,3,18,17,0,1,0,1
"2011","E00013860","E00013860","Total",136,32,12,20,0,79,75,4,24,24,0,0,0,1
"2011","E00013846","E00013846","Total",164,40,12,28,1,80,64,16,42,40,0,2,0,1
"2011","E00013847","E00013847","Total",104,13,4,9,0,74,71,3,15,15,0,0,0,2
"2011","E00013848","E00013848","Total",120,5,0,5,0,99,98,1,12,9,0,1,2,4
"2011","E00013849","E00013849","Total",121,18,2,16,3,87,80,7,7,7,0,0,0,6
"2011","E00013850","E00013850","Total",107,24,11,13,0,71,70,1,10,9,0,1,0,2
"2011","E00013624","E00013624","Total",104,43,31,12,1,42,7,35,15,14,0,1,0,3
"2011","E00013626","E00013626","Total",141,73,34,39,0,31,18,13,37,36,0,1,0,0
"2011","E00013653","E00013653","Total",124,75,33,42,0,28,15,13,20,20,0,0,0,1
"2011","E00013654","E00013654","Total",93,55,28,27,0,25,16,9,13,12,0,1,0,0
"2011","E00013655","E00013655","Total",211,70,21,49,11,62,25,37,68,67,0,0,1,0
"2011","E00013657","E00013657","Total",143,56,21,35,0,31,9,22,53,51,0,1,1,3
"2011","E00013625","E00013625","Total",145,67,32,35,1,28,12,16,47,43,0,3,1,2
"2011","E00013630","E00013630","Total",99,52,22,30,0,17,8,9,30,28,1,1,0,0
"2011","E00013631","E00013631","Total",150,49,24,25,0,33,11,22,66,64,0,1,1,2
"2011","E00013659","E00013659","Total",148,88,55,33,0,24,17,7,35,32,1,1,1,1
"2011","E00013661","E00013661","Total",144,69,36,33,1,16,15,1,58,54,0,2,2,0
"2011","E00013662","E00013662","Total",120,91,52,39,0,8,3,5,19,18,0,1,0,2
"2011","E00013681","E00013681","Total",64,21,6,15,0,23,16,7,19,19,0,0,0,1
"2011","E00013685","E00013685","Total",118,60,32,28,0,32,19,13,25,24,0,1,0,1
"2011","E00013687","E00013687","Total",128,76,20,56,1,24,8,16,24,23,0,1,0,3
"2011","E00013688","E00013688","Total",120,45,20,25,1,45,42,3,28,25,0,3,0,1
"2011","E00013689","E00013689","Total",98,28,15,13,0,53,6,47,17,17,0,0,0,0
"2011","E00013690","E00013690","Total",153,77,33,44,1,23,6,17,49,48,0,1,0,3
"2011","E00013933","E00013933","Total",150,29,10,19,1,86,73,13,32,32,0,0,0,2
"2011","E00013934","E00013934","Total",121,15,5,10,0,79,75,4,24,21,0,3,0,3
"2011","E00013935","E00013935","Total",114,36,17,19,0,9,6,3,67,64,1,2,0,2
"2011","E00013939","E00013939","Total",116,27,11,16,0,67,20,47,21,21,0,0,0,1
"2011","E00013941","E00013941","Total",99,42,16,26,0,19,5,14,37,37,0,0,0,1
"2011","E00174742","E00174742","Total",147,41,16,25,5,20,8,12,79,71,0,7,1,2
"2011","E00174752","E00174752","Total",116,43,16,27,2,41,19,22,27,23,0,4,0,3
"2011","E00013936","E00013936","Total",139,29,8,21,0,43,23,20,65,65,0,0,0,2
"2011","E00013938","E00013938","Total",124,46,26,20,1,53,50,3,24,24,0,0,0,0
"2011","E00013940","E00013940","Total",90,50,24,26,0,10,7,3,29,27,1,1,0,1
"2011","E00013943","E00013943","Total",143,31,11,20,1,89,18,71,21,21,0,0,0,1
"2011","E00013525","E00013525","Total",149,20,4,16,1,72,40,32,54,50,0,4,0,2
"2011","E00013526","E00013526","Total",235,26,7,19,19,156,87,69,31,29,1,1,0,3
"2011","E00013527","E00013527","Total",143,14,7,7,0,109,102,7,16,15,0,1,0,4
"2011","E00013528","E00013528","Total",129,28,9,19,1,74,65,9,26,25,0,1,0,0
"2011","E00013531","E00013531","Total",150,26,5,21,0,111,98,13,13,12,0,1,0,0
"2011","E00174833","E00174833","Total",136,28,6,22,3,62,16,46,38,34,0,2,2,5
"2011","E00174842","E00174842","Total",137,36,15,21,11,30,26,4,59,57,0,2,0,1
"2011","E00013512","E00013512","Total",156,43,18,25,1,21,9,12,88,84,0,4,0,3
"2011","E00013532","E00013532","Total",141,84,41,43,0,19,8,11,36,36,0,0,0,2
"2011","E00013535","E00013535","Total",128,41,18,23,0,31,19,12,55,53,0,1,1,1
"2011","E00013536","E00013536","Total",125,51,25,26,1,31,14,17,42,40,0,2,0,0
"2011","E00013539","E00013539","Total",128,38,12,26,0,42,20,22,48,48,0,0,0,0
"2011","E00013542","E00013542","Total",121,54,29,25,0,40,9,31,26,26,0,0,0,1
"2011","E00013508","E00013508","Total",142,38,11,27,0,79,74,5,24,24,0,0,0,1
"2011","E00013509","E00013509","Total",115,28,6,22,0,69,63,6,17,14,1,2,0,1
"2011","E00013510","E00013510","Total",95,32,6,26,1,49,49,0,12,12,0,0,0,1
"2011","E00013514","E00013514","Total",176,67,16,51,1,60,54,6,47,45,0,1,1,1
"2011","E00013517","E00013517","Total",120,42,17,25,0,53,47,6,25,25,0,0,0,0
"2011","E00013520","E00013520","Total",191,49,17,32,1,92,70,22,47,43,0,4,0,2
"2011","E00013828","E00013828","Total",136,38,11,27,1,62,46,16,35,35,0,0,0,0
"2011","E00013836","E00013836","Total",127,45,16,29,0,32,24,8,48,46,0,2,0,2
"2011","E00013866","E00013866","Total",152,53,18,35,1,50,45,5,48,47,0,1,0,0
"2011","E00013868","E00013868","Total",128,51,12,39,3,41,37,4,33,30,0,3,0,0
"2011","E00013870","E00013870","Total",140,45,13,32,2,28,22,6,65,63,0,2,0,0
"2011","E00013832","E00013832","Total",126,22,5,17,2,68,65,3,33,32,0,1,0,1
"2011","E00013833","E00013833","Total",107,34,13,21,0,45,14,31,27,27,0,0,0,1
"2011","E00013834","E00013834","Total",115,67,28,39,0,29,27,2,18,16,0,2,0,1
"2011","E00013837","E00013837","Total",151,25,9,16,0,104,85,19,18,17,0,1,0,4
"2011","E00013861","E00013861","Total",140,37,15,22,0,67,64,3,35,33,0,1,1,1
"2011","E00013865","E00013865","Total",135,44,10,34,0,44,14,30,47,47,0,0,0,0
"2011","E00013851","E00013851","Total",131,48,16,32,5,50,44,6,27,25,1,1,0,1
"2011","E00013853","E00013853","Total",119,44,14,30,2,40,28,12,33,29,0,3,1,0
"2011","E00013855","E00013855","Total",149,53,12,41,1,72,48,24,21,20,0,1,0,2
"2011","E00013862","E00013862","Total",102,25,5,20,0,54,40,14,23,23,0,0,0,0
"2011","E00013863","E00013863","Total",115,28,5,23,0,73,55,18,13,12,0,0,1,1
"2011","E00013864","E00013864","Total",147,42,15,27,0,63,45,18,41,39,1,1,0,1
"2011","E00013467","E00013467","Total",169,39,12,27,0,84,72,12,44,42,0,1,1,2
"2011","E00013497","E00013497","Total",121,44,12,32,2,58,55,3,16,13,0,3,0,1
"2011","E00013499","E00013499","Total",136,44,23,21,3,46,38,8,43,41,0,2,0,0
"2011","E00013501","E00013501","Total",103,23,5,18,10,47,44,3,23,22,0,1,0,0
"2011","E00174798","E00174798","Total",60,9,3,6,1,4,2,2,44,44,0,0,0,2
"2011","E00174800","E00174800","Total",328,38,16,22,6,127,61,66,154,152,1,0,1,3
"2011","E00013468","E00013468","Total",127,30,11,19,1,58,43,15,34,29,0,2,3,4
"2011","E00013495","E00013495","Total",89,39,8,31,2,17,9,8,31,30,0,1,0,0
"2011","E00013496","E00013496","Total",115,36,15,21,0,61,6,55,17,13,0,4,0,1
"2011","E00174795","E00174795","Total",106,21,5,16,3,32,11,21,49,46,0,3,0,1
"2011","E00174797","E00174797","Total",98,22,7,15,0,16,11,5,58,56,0,1,1,2
"2011","E00013466","E00013466","Total",161,29,9,20,2,119,64,55,10,7,0,0,3,1
"2011","E00013490","E00013490","Total",126,18,11,7,0,95,91,4,11,11,0,0,0,2
"2011","E00013491","E00013491","Total",138,23,11,12,1,91,82,9,22,21,0,1,0,1
"2011","E00013492","E00013492","Total",138,29,10,19,0,83,81,2,24,23,0,1,0,2
"2011","E00013493","E00013493","Total",125,34,16,18,3,69,61,8,16,12,0,3,1,3
"2011","E00013494","E00013494","Total",132,19,9,10,0,92,47,45,19,12,4,0,3,2
"2011","E00013753","E00013753","Total",131,31,15,16,1,81,74,7,17,14,0,0,3,1
"2011","E00013754","E00013754","Total",161,31,18,13,0,90,28,62,36,29,0,2,5,4
"2011","E00013755","E00013755","Total",125,34,16,18,3,68,37,31,19,19,0,0,0,1
"2011","E00013757","E00013757","Total",101,11,6,5,2,74,11,63,12,11,0,0,1,2
"2011","E00174741","E00174741","Total",93,12,7,5,16,39,12,27,26,23,0,0,3,0
"2011","E00174744","E00174744","Total",85,12,4,8,3,25,14,11,44,42,0,1,1,1
"2011","E00174747","E00174747","Total",178,8,2,6,2,151,21,130,10,10,0,0,0,7
"2011","E00174749","E00174749","Total",106,12,1,11,56,21,0,21,16,15,0,0,1,1
"2011","E00013751","E00013751","Total",186,22,5,17,3,86,33,53,74,67,1,0,6,1
"2011","E00013756","E00013756","Total",158,29,11,18,0,113,26,87,14,13,0,1,0,2
"2011","E00013758","E00013758","Total",156,4,3,1,12,130,14,116,5,4,0,0,1,5
"2011","E00013762","E00013762","Total",104,10,2,8,0,77,36,41,15,9,0,1,5,2
"2011","E00174758","E00174758","Total",207,23,12,11,1,123,31,92,58,52,1,0,5,2
"2011","E00013521","E00013521","Total",153,19,9,10,2,116,114,2,14,13,0,1,0,2
"2011","E00013522","E00013522","Total",142,28,10,18,1,78,76,2,32,29,0,3,0,3
"2011","E00013524","E00013524","Total",130,76,37,39,0,8,3,5,46,42,0,3,1,0
"2011","E00013533","E00013533","Total",165,95,52,43,0,15,12,3,40,31,7,1,1,15
"2011","E00013507","E00013507","Total",128,34,9,25,0,42,39,3,47,44,0,3,0,5
"2011","E00013511","E00013511","Total",124,57,29,28,1,47,20,27,17,16,0,1,0,2
"2011","E00013515","E00013515","Total",113,22,6,16,0,70,32,38,20,18,0,2,0,1
"2011","E00013523","E00013523","Total",139,73,47,26,1,35,30,5,25,24,0,1,0,5
"2011","E00013529","E00013529","Total",129,96,58,38,0,3,1,2,28,24,1,3,0,2
"2011","E00013538","E00013538","Total",104,70,38,32,1,9,6,3,23,22,0,1,0,1
"2011","E00013506","E00013506","Total",149,31,13,18,1,101,96,5,14,13,0,0,1,2
"2011","E00013530","E00013530","Total",178,12,2,10,0,152,141,11,13,12,0,1,0,1
"2011","E00013534","E00013534","Total",206,11,4,7,21,155,117,38,19,18,0,1,0,0
"2011","E00013540","E00013540","Total",139,22,7,15,2,99,97,2,14,13,0,1,0,2
"2011","E00174823","E00174823","Total",108,11,3,8,15,67,58,9,14,13,0,1,0,1
"2011","E00174829","E00174829","Total",105,15,4,11,2,76,13,63,12,11,0,1,0,0
"2011","E00174840","E00174840","Total",108,30,12,18,1,22,7,15,54,53,0,1,0,1
"2011","E00013945","E00013945","Total",92,1,1,0,0,87,4,83,2,0,0,0,2,2
"2011","E00013946","E00013946","Total",92,6,4,2,1,75,27,48,8,8,0,0,0,2
"2011","E00013947","E00013947","Total",126,32,15,17,0,38,4,34,54,51,0,3,0,2
"2011","E00013948","E00013948","Total",138,9,3,6,0,120,38,82,9,5,1,3,0,0
"2011","E00013952","E00013952","Total",126,6,3,3,0,110,14,96,9,9,0,0,0,1
"2011","E00013953","E00013953","Total",132,12,5,7,0,97,55,42,20,19,0,1,0,3
"2011","E00013917","E00013917","Total",103,44,26,18,0,34,32,2,24,21,0,3,0,1
"2011","E00013920","E00013920","Total",129,49,27,22,0,48,30,18,31,28,1,2,0,1
"2011","E00013942","E00013942","Total",127,42,17,25,0,42,36,6,39,38,0,1,0,4
"2011","E00013944","E00013944","Total",143,61,27,34,1,47,44,3,34,27,1,5,1,0
"2011","E00013949","E00013949","Total",137,66,35,31,1,9,1,8,57,56,0,1,0,4
"2011","E00013950","E00013950","Total",123,17,8,9,0,40,33,7,65,61,0,1,3,1
"2011","E00013914","E00013914","Total",155,35,13,22,1,98,67,31,19,17,0,2,0,2
"2011","E00013919","E00013919","Total",112,8,1,7,1,89,86,3,8,8,0,0,0,6
"2011","E00013922","E00013922","Total",145,11,2,9,1,111,109,2,22,22,0,0,0,0
"2011","E00013923","E00013923","Total",114,40,17,23,0,47,47,0,25,22,0,2,1,2
"2011","E00013927","E00013927","Total",130,30,10,20,1,26,19,7,72,70,0,2,0,1
"2011","E00013928","E00013928","Total",138,40,20,20,2,51,18,33,44,43,0,1,0,1
"2011","E00013930","E00013930","Total",163,30,12,18,0,90,4,86,41,38,1,2,0,2
"2011","E00013397","E00013397","Total",227,84,29,55,0,52,23,29,89,84,0,3,2,2
"2011","E00013398","E00013398","Total",122,59,21,38,0,30,22,8,33,31,0,2,0,0
"2011","E00013399","E00013399","Total",217,73,20,53,0,100,58,42,43,42,0,0,1,1
"2011","E00013400","E00013400","Total",108,34,17,17,0,48,45,3,25,24,0,1,0,1
"2011","E00013401","E00013401","Total",120,67,31,36,0,15,9,6,36,35,0,1,0,2
"2011","E00174836","E00174836","Total",182,80,29,51,1,30,21,9,68,64,0,4,0,3
"2011","E00174847","E00174847","Total",80,13,5,8,0,43,13,30,24,23,0,1,0,0
"2011","E00013386","E00013386","Total",116,63,32,31,2,28,27,1,21,20,0,1,0,2
"2011","E00013387","E00013387","Total",117,10,7,3,0,83,1,82,24,20,0,3,1,0
"2011","E00013402","E00013402","Total",98,6,3,3,0,91,4,87,1,1,0,0,0,0
"2011","E00013403","E00013403","Total",137,55,21,34,0,34,19,15,48,47,0,1,0,0
"2011","E00013405","E00013405","Total",137,57,23,34,1,29,21,8,49,47,0,2,0,1
"2011","E00013406","E00013406","Total",170,93,48,45,0,15,9,6,62,60,1,1,0,0
"2011","E00013404","E00013404","Total",127,84,44,40,0,10,4,6,30,30,0,0,0,3
"2011","E00013407","E00013407","Total",109,81,57,24,0,7,4,3,20,19,0,1,0,1
"2011","E00013408","E00013408","Total",153,99,55,44,0,15,12,3,34,33,1,0,0,5
"2011","E00013410","E00013410","Total",113,71,39,32,0,11,7,4,31,29,2,0,0,0
"2011","E00013412","E00013412","Total",138,57,26,31,0,39,35,4,39,38,0,1,0,3
"2011","E00013469","E00013469","Total",142,64,24,40,0,33,6,27,42,40,1,1,0,3
"2011","E00013474","E00013474","Total",206,37,23,14,0,23,6,17,146,145,0,1,0,0
"2011","E00013479","E00013479","Total",148,82,37,45,1,34,20,14,30,30,0,0,0,1
"2011","E00013500","E00013500","Total",132,63,27,36,0,25,13,12,43,43,0,0,0,1
"2011","E00013504","E00013504","Total",143,77,40,37,1,26,16,10,35,34,0,1,0,4
"2011","E00013913","E00013913","Total",111,50,30,20,0,28,4,24,31,31,0,0,0,2
"2011","E00013915","E00013915","Total",130,43,18,25,1,17,3,14,69,66,0,3,0,0
"2011","E00013918","E00013918","Total",173,59,27,32,1,24,15,9,86,82,0,4,0,3
"2011","E00013921","E00013921","Total",112,26,11,15,1,53,50,3,32,31,0,1,0,0
"2011","E00013924","E00013924","Total",128,45,23,22,0,68,59,9,13,11,0,0,2,2
"2011","E00013925","E00013925","Total",115,47,22,25,0,18,8,10,50,47,0,3,0,0
"2011","E00013951","E00013951","Total",108,36,15,21,0,42,9,33,29,28,0,1,0,1
"2011","E00013513","E00013513","Total",122,42,11,31,0,66,64,2,14,12,0,2,0,0
"2011","E00013516","E00013516","Total",157,35,22,13,0,78,68,10,43,42,1,0,0,1
"2011","E00013518","E00013518","Total",124,17,7,10,4,79,67,12,23,22,0,1,0,1
"2011","E00013519","E00013519","Total",109,13,3,10,0,84,80,4,10,9,0,1,0,2
"2011","E00013541","E00013541","Total",156,32,15,17,0,92,84,8,31,30,0,1,0,1
"2011","E00013954","E00013954","Total",157,40,13,27,2,60,55,5,44,42,1,1,0,11
"2011","E00013962","E00013962","Total",169,32,6,26,26,86,60,26,24,21,0,2,1,1
"2011","E00013969","E00013969","Total",128,15,6,9,0,92,63,29,19,19,0,0,0,2
"2011","E00013970","E00013970","Total",137,19,3,16,0,102,102,0,12,12,0,0,0,4
"2011","E00013971","E00013971","Total",127,33,7,26,0,66,61,5,28,28,0,0,0,0
"2011","E00013972","E00013972","Total",154,38,10,28,0,48,12,36,66,61,0,5,0,2
"2011","E00013975","E00013975","Total",127,43,17,26,0,42,40,2,42,39,0,2,1,0
"2011","E00013978","E00013978","Total",125,42,11,31,0,50,47,3,33,30,0,3,0,0
"2011","E00013981","E00013981","Total",101,70,22,48,1,6,3,3,24,23,0,1,0,0
"2011","E00013982","E00013982","Total",133,67,22,45,0,33,27,6,33,30,0,2,1,0
"2011","E00013983","E00013983","Total",115,64,32,32,0,18,15,3,32,28,2,1,1,1
"2011","E00013984","E00013984","Total",114,81,30,51,0,3,1,2,30,25,0,5,0,0
"2011","E00013991","E00013991","Total",207,87,35,52,1,84,42,42,26,24,0,2,0,9
"2011","E00013973","E00013973","Total",124,27,7,20,0,51,29,22,45,43,0,2,0,1
"2011","E00013974","E00013974","Total",123,11,3,8,0,106,41,65,4,4,0,0,0,2
"2011","E00013977","E00013977","Total",123,26,9,17,1,82,49,33,14,13,0,1,0,0
"2011","E00013979","E00013979","Total",133,36,15,21,0,56,48,8,40,38,0,2,0,1
"2011","E00013980","E00013980","Total",114,11,2,9,1,84,79,5,14,13,0,1,0,4
"2011","E00174801","E00174801","Total",114,50,16,34,0,25,10,15,33,31,0,2,0,6
"2011","E00174806","E00174806","Total",71,5,2,3,0,56,50,6,8,6,0,1,1,2
"2011","E00174812","E00174812","Total",78,9,3,6,1,61,34,27,6,2,1,0,3,1
"2011","E00013957","E00013957","Total",140,7,5,2,0,130,11,119,2,2,0,0,0,1
"2011","E00013989","E00013989","Total",46,6,5,1,0,39,8,31,1,1,0,0,0,0
"2011","E00013994","E00013994","Total",156,23,7,16,1,110,107,3,19,17,0,2,0,3
"2011","E00174803","E00174803","Total",93,19,8,11,2,58,8,50,14,12,1,0,1,0
"2011","E00013411","E00013411","Total",140,27,9,18,0,78,11,67,32,30,0,2,0,3
"2011","E00013414","E00013414","Total",151,13,2,11,17,101,18,83,17,16,0,1,0,3
"2011","E00013415","E00013415","Total",113,12,6,6,0,80,10,70,18,14,0,3,1,3
"2011","E00013416","E00013416","Total",136,13,4,9,0,103,14,89,16,15,0,1,0,4
"2011","E00013418","E00013418","Total",129,12,3,9,0,102,8,94,15,15,0,0,0,0
"2011","E00013391","E00013391","Total",137,18,10,8,1,99,17,82,16,15,0,0,1,3
"2011","E00013392","E00013392","Total",119,10,6,4,0,89,14,75,18,16,1,0,1,2
"2011","E00013393","E00013393","Total",100,6,2,4,0,80,8,72,12,12,0,0,0,2
"2011","E00013395","E00013395","Total",101,14,7,7,0,72,8,64,12,11,0,0,1,3
"2011","E00013417","E00013417","Total",137,26,14,12,2,79,7,72,28,25,0,1,2,2
"2011","E00174805","E00174805","Total",68,11,5,6,0,38,3,35,17,16,0,1,0,2
"2011","E00174843","E00174843","Total",47,5,3,2,0,7,2,5,35,34,0,0,1,0
"2011","E00013470","E00013470","Total",227,23,12,11,13,73,44,29,117,114,0,1,2,1
"2011","E00013471","E00013471","Total",139,20,4,16,1,79,62,17,38,37,0,1,0,1
"2011","E00013475","E00013475","Total",87,18,5,13,2,51,12,39,15,14,0,0,1,1
"2011","E00013478","E00013478","Total",162,31,15,16,2,106,19,87,22,20,0,0,2,1
"2011","E00013481","E00013481","Total",136,19,11,8,1,86,40,46,28,28,0,0,0,2
"2011","E00013464","E00013464","Total",149,14,0,14,0,124,54,70,7,6,0,1,0,4
"2011","E00013480","E00013480","Total",127,45,13,32,2,50,46,4,26,26,0,0,0,4
"2011","E00013482","E00013482","Total",161,29,12,17,0,93,63,30,35,33,0,2,0,4
"2011","E00013483","E00013483","Total",123,14,3,11,0,89,88,1,19,17,0,2,0,1
"2011","E00013485","E00013485","Total",119,46,22,24,8,42,21,21,22,20,0,2,0,1
"2011","E00013472","E00013472","Total",100,8,4,4,0,77,74,3,12,12,0,0,0,3
"2011","E00013473","E00013473","Total",114,11,7,4,2,76,72,4,24,24,0,0,0,1
"2011","E00013477","E00013477","Total",152,28,6,22,6,84,47,37,34,34,0,0,0,0
"2011","E00013502","E00013502","Total",188,23,11,12,1,81,70,11,83,81,0,1,1,0
"2011","E00013503","E00013503","Total",128,17,5,12,3,96,88,8,11,10,0,1,0,1
"2011","E00013388","E00013388","Total",135,41,14,27,0,71,59,12,23,21,0,2,0,0
"2011","E00013389","E00013389","Total",100,48,23,25,1,17,7,10,30,28,0,2,0,4
"2011","E00013409","E00013409","Total",173,67,27,40,0,71,60,11,34,33,0,1,0,1
"2011","E00013413","E00013413","Total",111,65,38,27,0,14,2,12,32,31,1,0,0,0
"2011","E00013419","E00013419","Total",185,43,18,25,21,18,7,11,101,99,0,2,0,2
"2011","E00013420","E00013420","Total",191,74,31,43,2,50,26,24,64,62,0,2,0,1
"2011","E00013916","E00013916","Total",139,60,39,21,0,46,6,40,33,31,0,2,0,0
"2011","E00013926","E00013926","Total",127,49,32,17,0,10,6,4,68,65,0,3,0,0
"2011","E00013929","E00013929","Total",126,75,47,28,0,28,10,18,19,18,0,1,0,4
"2011","E00013932","E00013932","Total",203,26,11,15,0,148,12,136,29,28,0,0,1,0
"2011","E00174753","E00174753","Total",128,25,8,17,0,21,17,4,75,71,0,0,4,7
"2011","E00174839","E00174839","Total",139,25,9,16,0,12,3,9,99,97,0,2,0,3
"2011","E00013958","E00013958","Total",113,53,29,24,0,27,19,8,31,30,0,1,0,2
"2011","E00013985","E00013985","Total",139,43,16,27,0,57,42,15,39,36,0,3,0,0
"2011","E00013986","E00013986","Total",133,43,21,22,1,35,32,3,52,47,2,2,1,2
"2011","E00013988","E00013988","Total",135,55,25,30,0,39,14,25,37,37,0,0,0,4
"2011","E00013990","E00013990","Total",133,71,44,27,0,22,6,16,39,38,0,1,0,1
"2011","E00013995","E00013995","Total",153,65,39,26,0,42,25,17,42,42,0,0,0,4
"2011","E00013956","E00013956","Total",78,18,8,10,0,30,5,25,30,30,0,0,0,0
"2011","E00013960","E00013960","Total",122,31,15,16,0,59,49,10,26,26,0,0,0,6
"2011","E00013963","E00013963","Total",134,39,14,25,1,12,7,5,79,76,1,2,0,3
"2011","E00013965","E00013965","Total",165,106,56,50,0,16,8,8,40,38,0,1,1,3
"2011","E00013992","E00013992","Total",82,41,21,20,0,26,8,18,13,13,0,0,0,2
"2011","E00013993","E00013993","Total",125,68,28,40,0,24,11,13,29,29,0,0,0,4
"2011","E00013959","E00013959","Total",126,46,21,25,0,57,51,6,20,18,0,2,0,3
"2011","E00013961","E00013961","Total",172,53,20,33,1,71,65,6,47,47,0,0,0,0
"2011","E00013964","E00013964","Total",119,37,25,12,0,28,26,2,52,51,0,1,0,2
"2011","E00013966","E00013966","Total",116,90,57,33,1,5,5,0,18,17,0,1,0,2
"2011","E00013967","E00013967","Total",127,14,1,13,1,69,64,5,41,39,0,2,0,2
"2011","E00174808","E00174808","Total",92,33,15,18,0,32,25,7,25,25,0,0,0,2
"2011","E00174809","E00174809","Total",78,27,14,13,0,19,2,17,29,28,0,1,0,3
"2011","E00174811","E00174811","Total",105,49,17,32,0,25,20,5,31,29,0,2,0,0
"2011","E00013385","E00013385","Total",189,27,6,21,0,108,13,95,53,52,1,0,0,1
"2011","E00013390","E00013390","Total",184,46,19,27,18,32,3,29,86,80,0,6,0,2
"2011","E00013421","E00013421","Total",142,36,14,22,1,83,21,62,20,19,0,1,0,2
"2011","E00013422","E00013422","Total",151,19,7,12,0,9,7,2,120,114,1,4,1,3
"2011","E00013423","E00013423","Total",129,38,13,25,2,51,21,30,36,36,0,0,0,2
"2011","E00013465","E00013465","Total",132,47,27,20,13,19,8,11,53,50,0,1,2,0
"2011","E00013484","E00013484","Total",117,54,19,35,0,13,1,12,48,45,0,2,1,2
"2011","E00013486","E00013486","Total",175,27,6,21,0,84,10,74,62,60,0,0,2,2
"2011","E00013487","E00013487","Total",181,48,13,35,2,69,47,22,59,55,0,4,0,3
"2011","E00013488","E00013488","Total",182,23,7,16,18,81,36,45,59,56,0,0,3,1
"2011","E00013489","E00013489","Total",176,18,8,10,0,20,2,18,137,131,1,4,1,1
"2011","E00013551","E00013551","Total",125,47,29,18,0,43,41,2,31,30,0,1,0,4
"2011","E00013552","E00013552","Total",135,32,10,22,1,76,69,7,23,19,0,4,0,3
"2011","E00013556","E00013556","Total",142,54,21,33,0,49,49,0,39,38,0,1,0,0
"2011","E00013557","E00013557","Total",211,78,33,45,0,23,1,22,106,101,0,5,0,4
"2011","E00013559","E00013559","Total",130,21,6,15,1,70,55,15,37,36,0,1,0,1
"2011","E00013562","E00013562","Total",128,28,8,20,0,79,53,26,19,19,0,0,0,2
"2011","E00013543","E00013543","Total",144,25,10,15,8,80,77,3,28,27,0,1,0,3
"2011","E00013553","E00013553","Total",165,60,17,43,0,56,53,3,47,44,0,2,1,2
"2011","E00013554","E00013554","Total",119,20,11,9,0,77,76,1,19,19,0,0,0,3
"2011","E00013555","E00013555","Total",81,7,5,2,0,39,23,16,35,33,0,1,1,0
"2011","E00013544","E00013544","Total",157,68,31,37,1,62,57,5,25,25,0,0,0,1
"2011","E00013558","E00013558","Total",130,31,14,17,0,57,52,5,41,40,0,1,0,1
"2011","E00013560","E00013560","Total",126,51,26,25,1,35,32,3,38,34,0,4,0,1
"2011","E00013564","E00013564","Total",142,64,42,22,0,38,33,5,38,38,0,0,0,2
"2011","E00013567","E00013567","Total",147,35,12,23,2,79,53,26,30,30,0,0,0,1
"2011","E00013435","E00013435","Total",211,32,18,14,0,150,146,4,28,21,0,4,3,1
"2011","E00013437","E00013437","Total",102,9,6,3,0,76,73,3,16,16,0,0,0,1
"2011","E00013439","E00013439","Total",143,27,10,17,0,32,2,30,83,78,0,1,4,1
"2011","E00013441","E00013441","Total",88,17,10,7,1,51,51,0,18,17,0,1,0,1
"2011","E00174761","E00174761","Total",118,37,11,26,1,19,13,6,58,54,0,3,1,3
"2011","E00174763","E00174763","Total",120,35,11,24,0,5,2,3,77,75,1,1,0,3
"2011","E00174764","E00174764","Total",119,27,10,17,0,53,36,17,36,35,0,0,1,3
"2011","E00013561","E00013561","Total",134,36,21,15,0,75,71,4,22,18,0,4,0,1
"2011","E00013563","E00013563","Total",124,30,12,18,2,51,48,3,38,34,1,3,0,3
"2011","E00013566","E00013566","Total",117,21,8,13,1,70,69,1,22,21,0,1,0,3
"2011","E00013570","E00013570","Total",176,35,18,17,0,84,68,16,56,54,0,0,2,1
"2011","E00013574","E00013574","Total",104,28,12,16,0,62,60,2,14,13,0,0,1,0
"2011","E00013576","E00013576","Total",126,21,10,11,1,82,79,3,21,19,1,1,0,1
"2011","E00013545","E00013545","Total",132,53,19,34,0,4,2,2,73,68,2,1,2,2
"2011","E00013546","E00013546","Total",127,69,28,41,0,4,1,3,48,43,1,3,1,6
"2011","E00013547","E00013547","Total",217,105,54,51,1,48,19,29,58,54,0,3,1,5
"2011","E00013548","E00013548","Total",159,11,3,8,0,134,25,109,12,9,0,1,2,2
"2011","E00013549","E00013549","Total",186,108,49,59,1,10,8,2,63,58,1,4,0,4
"2011","E00013550","E00013550","Total",204,83,42,41,2,13,2,11,103,99,0,0,4,3
"2011","E00013569","E00013569","Total",113,27,4,23,2,59,44,15,23,21,0,2,0,2
"2011","E00013571","E00013571","Total",138,7,2,5,0,118,117,1,12,11,0,1,0,1
"2011","E00013577","E00013577","Total",168,13,7,6,0,141,137,4,12,9,1,2,0,2
"2011","E00013579","E00013579","Total",153,49,15,34,0,68,63,5,35,32,0,3,0,1
"2011","E00013565","E00013565","Total",172,57,22,35,0,62,59,3,52,48,0,3,1,1
"2011","E00013568","E00013568","Total",114,20,9,11,0,72,71,1,21,20,0,1,0,1
"2011","E00013572","E00013572","Total",182,66,32,34,0,13,5,8,97,91,2,3,1,6
"2011","E00013573","E00013573","Total",120,19,7,12,0,82,80,2,16,16,0,0,0,3
"2011","E00013575","E00013575","Total",130,38,17,21,0,66,59,7,21,20,0,1,0,5
"2011","E00013578","E00013578","Total",107,14,6,8,10,56,33,23,26,26,0,0,0,1
"2011","E00013431","E00013431","Total",151,51,26,25,0,21,1,20,78,66,0,0,12,1
"2011","E00174773","E00174773","Total",131,54,21,33,1,5,0,5,69,67,0,2,0,2
"2011","E00174781","E00174781","Total",123,48,18,30,8,38,4,34,29,29,0,0,0,0
"2011","E00174783","E00174783","Total",134,58,16,42,1,1,0,1,72,66,0,6,0,2
"2011","E00174784","E00174784","Total",135,66,29,37,1,8,0,8,58,52,0,2,4,2
"2011","E00174786","E00174786","Total",102,42,19,23,0,8,1,7,51,51,0,0,0,1
"2011","E00013430","E00013430","Total",43,13,7,6,0,3,1,2,25,23,0,2,0,2
"2011","E00013434","E00013434","Total",158,63,35,28,1,2,1,1,88,81,1,3,3,4
"2011","E00013447","E00013447","Total",170,24,9,15,0,96,96,0,46,42,1,3,0,4
"2011","E00174775","E00174775","Total",130,40,7,33,0,43,41,2,46,43,0,1,2,1
"2011","E00174778","E00174778","Total",96,13,6,7,0,42,3,39,39,39,0,0,0,2
"2011","E00174780","E00174780","Total",106,4,3,1,0,33,1,32,68,63,0,0,5,1
"2011","E00013442","E00013442","Total",186,32,14,18,0,108,7,101,45,44,0,0,1,1
"2011","E00013445","E00013445","Total",101,11,7,4,0,76,71,5,14,10,0,1,3,0
"2011","E00013446","E00013446","Total",60,29,8,21,0,5,3,2,26,25,0,1,0,0
"2011","E00013448","E00013448","Total",117,17,9,8,0,90,87,3,9,9,0,0,0,1
"2011","E00013450","E00013450","Total",92,16,8,8,0,69,35,34,6,5,0,1,0,1
"2011","E00013452","E00013452","Total",162,26,11,15,1,110,108,2,24,23,0,1,0,1
"2011","E00013425","E00013425","Total",224,21,11,10,1,113,87,26,89,85,0,2,2,0
"2011","E00013438","E00013438","Total",229,12,6,6,1,146,83,63,53,46,0,0,7,17
"2011","E00013440","E00013440","Total",158,36,10,26,0,73,66,7,48,45,0,2,1,1
"2011","E00013443","E00013443","Total",158,21,10,11,0,115,111,4,19,17,0,2,0,3
"2011","E00013449","E00013449","Total",101,11,5,6,0,80,79,1,9,9,0,0,0,1
"2011","E00013444","E00013444","Total",157,17,12,5,0,131,128,3,9,9,0,0,0,0
"2011","E00013453","E00013453","Total",139,21,8,13,0,100,82,18,18,18,0,0,0,0
"2011","E00013456","E00013456","Total",124,19,3,16,0,84,80,4,21,20,0,0,1,0
"2011","E00013457","E00013457","Total",99,17,10,7,0,65,61,4,13,12,0,0,1,4
"2011","E00174766","E00174766","Total",115,28,11,17,0,43,42,1,43,42,0,0,1,1
"2011","E00174777","E00174777","Total",140,44,17,27,10,15,14,1,69,67,0,2,0,2
"2011","E00013428","E00013428","Total",92,20,10,10,5,36,19,17,28,25,0,1,2,3
"2011","E00013429","E00013429","Total",123,22,9,13,0,72,63,9,26,22,0,2,2,3
"2011","E00013455","E00013455","Total",153,64,27,37,0,37,36,1,51,48,0,3,0,1
"2011","E00013461","E00013461","Total",164,26,10,16,0,114,85,29,21,18,0,2,1,3
"2011","E00013462","E00013462","Total",115,1,1,0,0,111,6,105,2,2,0,0,0,1
"2011","E00013463","E00013463","Total",134,4,4,0,0,120,5,115,6,4,0,2,0,4
"2011","E00174770","E00174770","Total",132,59,18,41,1,5,4,1,64,63,0,1,0,3
"2011","E00174772","E00174772","Total",122,25,7,18,12,46,7,39,35,31,2,1,1,4
"2011","E00013424","E00013424","Total",135,31,12,19,1,54,43,11,46,45,0,1,0,3
"2011","E00013426","E00013426","Total",116,6,1,5,1,93,7,86,16,15,0,1,0,0
"2011","E00013432","E00013432","Total",158,8,1,7,0,136,10,126,13,9,1,2,1,1
"2011","E00013454","E00013454","Total",151,28,16,12,2,63,56,7,57,54,1,1,1,1
"2011","E00013458","E00013458","Total",181,39,12,27,4,100,64,36,37,36,0,0,1,1
"2011","E00013460","E00013460","Total",184,47,18,29,0,77,69,8,59,52,0,6,1,1
"2011","E00014303","E00014303","Total",98,14,2,12,2,65,51,14,16,11,0,5,0,1
"2011","E00014307","E00014307","Total",158,14,10,4,2,121,69,52,20,16,1,0,3,1
"2011","E00014311","E00014311","Total",99,1,1,0,1,97,18,79,0,0,0,0,0,0
"2011","E00014312","E00014312","Total",169,46,14,32,15,90,71,19,18,15,0,3,0,0
"2011","E00175093","E00175093","Total",120,10,7,3,1,80,34,46,24,23,0,0,1,5
"2011","E00175094","E00175094","Total",109,1,1,0,3,26,2,24,79,77,0,0,2,0
"2011","E00175095","E00175095","Total",108,9,5,4,16,78,10,68,5,5,0,0,0,0
"2011","E00014316","E00014316","Total",113,14,2,12,2,41,5,36,53,49,0,2,2,3
"2011","E00014317","E00014317","Total",97,2,2,0,1,87,7,80,6,4,0,0,2,1
"2011","E00014318","E00014318","Total",82,0,0,0,0,80,5,75,1,0,0,0,1,1
"2011","E00014319","E00014319","Total",74,1,1,0,0,73,8,65,0,0,0,0,0,0
"2011","E00014320","E00014320","Total",104,1,0,1,0,99,42,57,3,3,0,0,0,1
"2011","E00014309","E00014309","Total",204,23,6,17,0,170,161,9,8,7,0,0,1,3
"2011","E00014314","E00014314","Total",101,19,6,13,2,70,64,6,10,9,0,1,0,0
"2011","E00014315","E00014315","Total",65,6,3,3,3,51,48,3,2,2,0,0,0,3
"2011","E00014321","E00014321","Total",118,19,5,14,3,73,64,9,21,21,0,0,0,2
"2011","E00014300","E00014300","Total",194,36,16,20,1,109,93,16,48,47,0,1,0,0
"2011","E00014301","E00014301","Total",150,24,5,19,4,116,111,5,6,6,0,0,0,0
"2011","E00014323","E00014323","Total",163,8,4,4,0,149,49,100,5,5,0,0,0,1
"2011","E00014324","E00014324","Total",124,20,8,12,2,81,74,7,19,17,1,0,1,2
"2011","E00014327","E00014327","Total",133,22,12,10,1,84,60,24,23,23,0,0,0,3
"2011","E00014304","E00014304","Total",105,2,1,1,0,102,43,59,1,0,0,0,1,0
"2011","E00014305","E00014305","Total",107,11,6,5,0,91,50,41,5,5,0,0,0,0
"2011","E00014308","E00014308","Total",127,14,4,10,0,104,94,10,8,6,0,2,0,1
"2011","E00014310","E00014310","Total",114,3,1,2,1,99,87,12,9,9,0,0,0,2
"2011","E00014313","E00014313","Total",127,10,5,5,0,108,101,7,6,5,0,0,1,3
"2011","E00014615","E00014615","Total",127,3,0,3,3,108,8,100,8,5,0,2,1,5
"2011","E00014620","E00014620","Total",112,1,0,1,4,100,3,97,7,5,0,1,1,0
"2011","E00014624","E00014624","Total",97,0,0,0,6,84,10,74,6,1,0,2,3,1
"2011","E00014629","E00014629","Total",105,1,1,0,0,101,5,96,2,1,0,0,1,1
"2011","E00014630","E00014630","Total",83,0,0,0,0,78,5,73,4,3,0,0,1,1
"2011","E00014621","E00014621","Total",145,33,13,20,16,78,60,18,15,13,0,1,1,3
"2011","E00014623","E00014623","Total",125,11,8,3,0,106,7,99,5,4,0,0,1,3
"2011","E00014626","E00014626","Total",128,13,5,8,2,101,84,17,11,11,0,0,0,1
"2011","E00014628","E00014628","Total",135,25,7,18,0,87,49,38,21,19,0,1,1,2
"2011","E00014634","E00014634","Total",139,29,20,9,1,83,12,71,22,22,0,0,0,4
"2011","E00014616","E00014616","Total",127,41,19,22,3,38,11,27,41,40,0,1,0,4
"2011","E00014622","E00014622","Total",196,56,22,34,14,84,51,33,39,36,0,2,1,3
"2011","E00014625","E00014625","Total",100,7,2,5,8,76,13,63,6,6,0,0,0,3
"2011","E00014633","E00014633","Total",125,31,12,19,21,50,41,9,21,21,0,0,0,2
"2011","E00014636","E00014636","Total",159,43,20,23,1,103,63,40,11,10,0,1,0,1
"2011","E00014619","E00014619","Total",107,0,0,0,1,101,7,94,2,2,0,0,0,3
"2011","E00014627","E00014627","Total",106,1,0,1,0,102,6,96,1,1,0,0,0,2
"2011","E00014631","E00014631","Total",142,2,2,0,1,130,15,115,8,7,0,0,1,1
"2011","E00014632","E00014632","Total",115,0,0,0,0,114,11,103,1,1,0,0,0,0
"2011","E00014641","E00014641","Total",81,13,4,9,0,54,8,46,7,7,0,0,0,7
"2011","E00014450","E00014450","Total",109,28,16,12,0,61,3,58,20,19,0,1,0,0
"2011","E00014451","E00014451","Total",130,48,19,29,4,36,4,32,42,41,0,1,0,0
"2011","E00014452","E00014452","Total",130,79,50,29,0,12,2,10,38,35,0,1,2,1
"2011","E00014453","E00014453","Total",119,20,8,12,0,60,9,51,39,38,0,1,0,0
"2011","E00014456","E00014456","Total",126,73,43,30,0,26,3,23,24,22,0,2,0,3
"2011","E00014458","E00014458","Total",130,89,54,35,0,20,3,17,21,21,0,0,0,0
"2011","E00014445","E00014445","Total",124,9,5,4,1,105,95,10,7,5,0,0,2,2
"2011","E00014446","E00014446","Total",114,12,9,3,0,95,87,8,7,7,0,0,0,0
"2011","E00014460","E00014460","Total",168,74,39,35,2,59,26,33,30,30,0,0,0,3
"2011","E00014462","E00014462","Total",127,17,9,8,0,91,20,71,13,9,0,4,0,6
"2011","E00014465","E00014465","Total",114,9,6,3,10,93,83,10,1,1,0,0,0,1
"2011","E00014454","E00014454","Total",147,40,19,21,1,61,8,53,43,42,0,0,1,2
"2011","E00014455","E00014455","Total",196,89,48,41,6,53,1,52,44,43,1,0,0,4
"2011","E00014457","E00014457","Total",146,41,18,23,5,63,22,41,35,33,1,1,0,2
"2011","E00014459","E00014459","Total",124,26,18,8,3,68,0,68,23,22,0,1,0,4
"2011","E00014463","E00014463","Total",117,19,9,10,5,76,37,39,14,12,0,1,1,3
"2011","E00014464","E00014464","Total",138,77,39,38,5,29,27,2,26,26,0,0,0,1
"2011","E00014635","E00014635","Total",103,27,15,12,6,60,6,54,8,8,0,0,0,2
"2011","E00014637","E00014637","Total",131,53,31,22,0,12,1,11,64,63,0,1,0,2
"2011","E00014638","E00014638","Total",124,45,24,21,2,62,34,28,14,13,0,1,0,1
"2011","E00014640","E00014640","Total",124,66,26,40,2,19,5,14,37,35,0,2,0,0
"2011","E00014643","E00014643","Total",120,50,18,32,7,22,2,20,40,40,0,0,0,1
"2011","E00014614","E00014614","Total",212,45,23,22,8,114,15,99,45,44,1,0,0,0
"2011","E00014617","E00014617","Total",179,59,24,35,0,63,1,62,53,49,0,3,1,4
"2011","E00014618","E00014618","Total",147,31,22,9,2,84,8,76,28,25,0,2,1,2
"2011","E00014639","E00014639","Total",201,89,50,39,4,70,13,57,36,35,0,1,0,2
"2011","E00014642","E00014642","Total",205,57,23,34,7,80,5,75,60,52,0,8,0,1
"2011","E00014644","E00014644","Total",208,44,20,24,6,106,2,104,47,47,0,0,0,5
"2011","E00014163","E00014163","Total",142,32,17,15,2,77,6,71,29,23,0,5,1,2
"2011","E00014168","E00014168","Total",145,39,24,15,0,64,4,60,42,38,0,4,0,0
"2011","E00014170","E00014170","Total",109,26,13,13,0,55,3,52,27,24,0,3,0,1
"2011","E00014171","E00014171","Total",138,10,2,8,2,96,2,94,28,28,0,0,0,2
"2011","E00014173","E00014173","Total",107,9,7,2,3,77,2,75,18,17,0,1,0,0
"2011","E00014175","E00014175","Total",147,40,16,24,0,39,20,19,65,62,1,1,1,3
"2011","E00014150","E00014150","Total",173,33,13,20,1,112,77,35,27,27,0,0,0,0
"2011","E00014151","E00014151","Total",166,40,24,16,0,106,45,61,19,18,0,0,1,1
"2011","E00014162","E00014162","Total",156,40,17,23,12,56,20,36,47,45,0,2,0,1
"2011","E00014164","E00014164","Total",142,19,13,6,0,102,5,97,20,19,0,1,0,1
"2011","E00014165","E00014165","Total",134,25,12,13,0,78,11,67,30,28,0,2,0,1
"2011","E00014167","E00014167","Total",146,40,19,21,1,73,5,68,27,23,0,3,1,5
"2011","E00014153","E00014153","Total",129,36,23,13,3,64,20,44,26,26,0,0,0,0
"2011","E00014166","E00014166","Total",101,11,2,9,0,67,9,58,23,23,0,0,0,0
"2011","E00014169","E00014169","Total",176,57,25,32,0,62,5,57,55,51,2,2,0,2
"2011","E00014172","E00014172","Total",165,35,19,16,0,50,15,35,79,74,3,0,2,1
"2011","E00014174","E00014174","Total",138,55,36,19,2,45,5,40,35,33,0,1,1,1
"2011","E00014177","E00014177","Total",127,13,5,8,0,100,88,12,14,14,0,0,0,0
"2011","E00014178","E00014178","Total",125,16,12,4,1,98,14,84,10,10,0,0,0,0
"2011","E00014152","E00014152","Total",233,67,36,31,5,51,3,48,108,106,0,2,0,2
"2011","E00014154","E00014154","Total",153,36,24,12,2,82,49,33,32,32,0,0,0,1
"2011","E00014157","E00014157","Total",166,35,23,12,1,100,68,32,28,28,0,0,0,2
"2011","E00014176","E00014176","Total",170,22,16,6,0,99,3,96,46,45,1,0,0,3
"2011","E00014179","E00014179","Total",77,9,5,4,0,55,20,35,13,12,1,0,0,0
"2011","E00014181","E00014181","Total",111,34,19,15,4,29,1,28,44,43,0,1,0,0
"2011","E00014302","E00014302","Total",142,28,13,15,1,64,4,60,48,44,0,3,1,1
"2011","E00014322","E00014322","Total",126,47,32,15,3,27,3,24,46,44,0,2,0,3
"2011","E00014325","E00014325","Total",145,37,16,21,0,53,7,46,55,53,0,2,0,0
"2011","E00014326","E00014326","Total",149,15,9,6,2,40,2,38,91,89,0,2,0,1
"2011","E00014328","E00014328","Total",201,25,11,14,1,127,23,104,46,43,1,0,2,2
"2011","E00014329","E00014329","Total",178,10,3,7,4,127,8,119,34,29,0,4,1,3
"2011","E00014412","E00014412","Total",140,13,6,7,5,106,96,10,16,14,0,1,1,0
"2011","E00014415","E00014415","Total",170,14,9,5,15,120,38,82,17,16,0,1,0,4
"2011","E00014419","E00014419","Total",118,7,4,3,0,97,50,47,11,11,0,0,0,3
"2011","E00014438","E00014438","Total",128,4,2,2,2,108,46,62,12,8,2,0,2,2
"2011","E00014439","E00014439","Total",137,5,3,2,0,119,62,57,13,12,0,1,0,0
"2011","E00014413","E00014413","Total",105,46,36,10,0,37,4,33,20,20,0,0,0,2
"2011","E00014414","E00014414","Total",111,18,13,5,0,87,16,71,6,6,0,0,0,0
"2011","E00014418","E00014418","Total",125,4,2,2,0,112,5,107,6,5,0,0,1,3
"2011","E00014422","E00014422","Total",119,5,1,4,0,103,47,56,9,7,0,0,2,2
"2011","E00014423","E00014423","Total",153,26,16,10,1,106,7,99,19,18,0,0,1,1
"2011","E00014425","E00014425","Total",113,18,9,9,0,81,20,61,13,12,0,1,0,1
"2011","E00014440","E00014440","Total",195,25,13,12,7,48,16,32,111,110,0,1,0,4
"2011","E00014442","E00014442","Total",123,24,10,14,2,85,78,7,10,9,0,0,1,2
"2011","E00014461","E00014461","Total",124,11,5,6,0,101,36,65,9,8,0,1,0,3
"2011","E00014468","E00014468","Total",118,13,6,7,1,88,79,9,13,13,0,0,0,3
"2011","E00014470","E00014470","Total",135,16,7,9,3,99,88,11,16,14,1,0,1,1
"2011","E00014443","E00014443","Total",128,6,2,4,0,113,105,8,6,5,1,0,0,3
"2011","E00014444","E00014444","Total",110,6,2,4,0,98,91,7,2,2,0,0,0,4
"2011","E00014466","E00014466","Total",144,7,2,5,0,124,85,39,8,6,0,2,0,5
"2011","E00014467","E00014467","Total",149,19,10,9,4,110,100,10,12,11,0,0,1,4
"2011","E00014469","E00014469","Total",122,22,7,15,17,67,50,17,16,16,0,0,0,0
"2011","E00014441","E00014441","Total",166,35,21,14,2,106,95,11,20,17,0,3,0,3
"2011","E00014447","E00014447","Total",129,17,8,9,1,92,78,14,17,16,0,1,0,2
"2011","E00014448","E00014448","Total",121,8,2,6,0,113,45,68,0,0,0,0,0,0
"2011","E00014449","E00014449","Total",128,44,22,22,0,63,27,36,19,16,0,1,2,2
"2011","E00014477","E00014477","Total",85,53,41,12,0,6,5,1,22,22,0,0,0,4
"2011","E00014490","E00014490","Total",99,25,10,15,1,57,53,4,15,14,0,1,0,1
"2011","E00014492","E00014492","Total",85,39,23,16,3,0,0,0,40,38,2,0,0,3
"2011","E00014494","E00014494","Total",155,39,28,11,1,89,8,81,23,21,0,2,0,3
"2011","E00014497","E00014497","Total",113,51,38,13,0,15,0,15,46,44,1,0,1,1
"2011","E00014498","E00014498","Total",76,34,24,10,0,19,0,19,18,16,0,0,2,5
"2011","E00014502","E00014502","Total",90,43,34,9,1,21,0,21,18,18,0,0,0,7
"2011","E00014473","E00014473","Total",141,63,39,24,0,10,0,10,66,57,2,6,1,2
"2011","E00014481","E00014481","Total",69,49,39,10,0,2,0,2,13,12,0,1,0,5
"2011","E00014484","E00014484","Total",109,76,61,15,2,0,0,0,29,28,0,1,0,2
"2011","E00014485","E00014485","Total",124,60,49,11,0,13,1,12,43,40,0,3,0,8
"2011","E00014486","E00014486","Total",139,66,38,28,0,1,0,1,68,61,0,5,2,4
"2011","E00014501","E00014501","Total",109,49,37,12,0,2,0,2,53,30,20,1,2,5
"2011","E00014506","E00014506","Total",111,66,50,16,1,0,0,0,41,35,3,3,0,3
"2011","E00014475","E00014475","Total",121,17,7,10,26,12,2,10,61,61,0,0,0,5
"2011","E00014482","E00014482","Total",143,32,14,18,1,38,0,38,71,69,0,1,1,1
"2011","E00014483","E00014483","Total",105,25,18,7,0,3,0,3,75,69,2,2,2,2
"2011","E00014495","E00014495","Total",129,33,22,11,0,34,6,28,62,62,0,0,0,0
"2011","E00014500","E00014500","Total",101,41,30,11,0,16,16,0,43,43,0,0,0,1
"2011","E00175087","E00175087","Total",111,45,30,15,0,13,0,13,51,47,0,4,0,2
"2011","E00014474","E00014474","Total",177,68,35,33,0,2,0,2,105,98,3,4,0,2
"2011","E00014476","E00014476","Total",130,47,33,14,0,3,1,2,78,73,0,2,3,2
"2011","E00014478","E00014478","Total",155,45,19,26,0,5,0,5,100,98,0,0,2,5
"2011","E00014479","E00014479","Total",135,38,22,16,0,21,1,20,75,73,1,1,0,1
"2011","E00014480","E00014480","Total",107,39,22,17,0,10,0,10,57,55,0,1,1,1
"2011","E00014496","E00014496","Total",117,40,25,15,0,20,5,15,57,53,0,4,0,0
"2011","E00014505","E00014505","Total",129,39,30,9,1,12,0,12,73,57,12,1,3,4
"2011","E00014471","E00014471","Total",72,44,24,20,1,2,2,0,22,22,0,0,0,3
"2011","E00014487","E00014487","Total",147,63,29,34,1,10,1,9,70,68,0,1,1,3
"2011","E00014488","E00014488","Total",102,41,31,10,1,7,0,7,52,44,3,2,3,1
"2011","E00014489","E00014489","Total",101,44,25,19,1,25,0,25,28,28,0,0,0,3
"2011","E00014491","E00014491","Total",156,71,45,26,2,15,0,15,61,59,0,1,1,7
"2011","E00014493","E00014493","Total",111,61,41,20,1,4,0,4,42,40,0,2,0,3
"2011","E00014499","E00014499","Total",92,55,40,15,0,15,10,5,20,17,1,1,1,2
"2011","E00014155","E00014155","Total",99,25,9,16,0,21,1,20,51,48,0,2,1,2
"2011","E00014156","E00014156","Total",105,43,28,15,0,2,1,1,60,57,2,1,0,0
"2011","E00014158","E00014158","Total",104,58,27,31,0,5,1,4,41,39,0,2,0,0
"2011","E00014159","E00014159","Total",93,52,35,17,0,14,1,13,26,25,1,0,0,1
"2011","E00014160","E00014160","Total",107,51,33,18,0,24,2,22,30,30,0,0,0,2
"2011","E00014161","E00014161","Total",134,56,35,21,2,15,4,11,60,52,0,8,0,1
"2011","E00014180","E00014180","Total",151,26,11,15,1,55,10,45,68,63,0,2,3,1
"2011","E00014408","E00014408","Total",92,42,20,22,0,22,0,22,26,24,0,1,1,2
"2011","E00014409","E00014409","Total",139,81,57,24,0,5,0,5,51,47,1,3,0,2
"2011","E00014410","E00014410","Total",140,75,50,25,0,0,0,0,62,59,1,2,0,3
"2011","E00014421","E00014421","Total",124,72,54,18,0,10,1,9,38,38,0,0,0,4
"2011","E00014426","E00014426","Total",127,61,55,6,0,7,0,7,50,45,2,3,0,9
"2011","E00014428","E00014428","Total",120,76,52,24,0,4,0,4,38,37,1,0,0,2
"2011","E00014407","E00014407","Total",121,23,11,12,1,67,4,63,28,28,0,0,0,2
"2011","E00014424","E00014424","Total",104,40,27,13,0,53,1,52,10,10,0,0,0,1
"2011","E00014427","E00014427","Total",128,83,62,21,3,5,0,5,33,31,0,1,1,4
"2011","E00014429","E00014429","Total",139,66,42,24,9,17,4,13,42,40,0,1,1,5
"2011","E00014430","E00014430","Total",140,73,40,33,0,19,0,19,48,47,0,1,0,0
"2011","E00014431","E00014431","Total",151,37,15,22,3,44,15,29,65,64,0,1,0,2
"2011","E00014432","E00014432","Total",126,43,24,19,0,37,1,36,45,43,0,2,0,1
"2011","E00014433","E00014433","Total",151,28,12,16,0,75,14,61,47,44,2,1,0,1
"2011","E00014434","E00014434","Total",108,71,52,19,0,16,1,15,18,17,0,1,0,3
"2011","E00014435","E00014435","Total",112,52,30,22,0,25,17,8,33,27,0,5,1,2
"2011","E00014411","E00014411","Total",121,61,46,15,0,18,1,17,38,38,0,0,0,4
"2011","E00014416","E00014416","Total",112,50,39,11,1,36,18,18,23,21,1,1,0,2
"2011","E00014417","E00014417","Total",100,71,51,20,0,2,0,2,22,20,1,0,1,5
"2011","E00014420","E00014420","Total",128,59,43,16,0,29,0,29,37,35,1,0,1,3
"2011","E00014436","E00014436","Total",114,62,48,14,1,10,0,10,36,34,0,2,0,5
"2011","E00014437","E00014437","Total",106,53,33,20,0,11,0,11,40,39,0,0,1,2
"2011","E00014120","E00014120","Total",115,53,35,18,0,3,0,3,52,49,0,2,1,7
"2011","E00014121","E00014121","Total",92,42,31,11,0,4,0,4,45,44,0,0,1,1
"2011","E00014125","E00014125","Total",125,67,43,24,0,36,35,1,18,18,0,0,0,4
"2011","E00014127","E00014127","Total",111,56,37,19,0,0,0,0,52,38,11,1,2,3
"2011","E00014130","E00014130","Total",115,51,37,14,1,5,0,5,55,54,0,0,1,3
"2011","E00014132","E00014132","Total",126,50,29,21,0,3,1,2,69,67,0,2,0,4
"2011","E00014122","E00014122","Total",83,51,31,20,0,1,1,0,27,26,0,0,1,4
"2011","E00014123","E00014123","Total",153,95,61,34,0,1,1,0,47,46,1,0,0,10
"2011","E00014124","E00014124","Total",170,92,77,15,0,34,4,30,27,25,1,0,1,17
"2011","E00014126","E00014126","Total",128,64,47,17,1,14,10,4,45,41,1,3,0,4
"2011","E00014129","E00014129","Total",169,79,65,14,0,0,0,0,76,74,0,2,0,14
"2011","E00014135","E00014135","Total",124,46,34,12,0,6,0,6,64,64,0,0,0,8
"2011","E00014118","E00014118","Total",111,28,20,8,1,1,1,0,72,52,10,3,7,9
"2011","E00014128","E00014128","Total",124,65,38,27,0,2,0,2,49,48,0,0,1,8
"2011","E00014131","E00014131","Total",120,60,43,17,0,1,0,1,48,45,0,3,0,11
"2011","E00014133","E00014133","Total",110,41,25,16,0,1,1,0,62,57,1,2,2,6
"2011","E00014134","E00014134","Total",105,44,30,14,1,2,0,2,54,52,0,2,0,4
"2011","E00014136","E00014136","Total",113,41,26,15,1,16,7,9,51,47,2,2,0,4
"2011","E00014137","E00014137","Total",115,49,41,8,0,6,4,2,51,49,1,1,0,9
"2011","E00014117","E00014117","Total",109,77,50,27,0,0,0,0,25,23,0,2,0,7
"2011","E00014138","E00014138","Total",125,66,48,18,1,1,0,1,54,48,0,0,6,3
"2011","E00014139","E00014139","Total",126,37,21,16,1,3,1,2,78,78,0,0,0,7
"2011","E00014142","E00014142","Total",124,50,35,15,3,1,0,1,66,62,1,2,1,4
"2011","E00014144","E00014144","Total",111,80,61,19,1,1,1,0,28,28,0,0,0,1
"2011","E00014145","E00014145","Total",104,46,28,18,0,8,0,8,47,45,0,2,0,3
"2011","E00014147","E00014147","Total",100,58,39,19,0,0,0,0,39,39,0,0,0,3
"2011","E00014148","E00014148","Total",104,76,54,22,0,0,0,0,26,24,0,2,0,2
"2011","E00014119","E00014119","Total",125,87,62,25,1,10,1,9,21,20,0,1,0,6
"2011","E00014140","E00014140","Total",122,39,26,13,1,9,1,8,67,67,0,0,0,6
"2011","E00014141","E00014141","Total",115,80,62,18,0,1,0,1,27,27,0,0,0,7
"2011","E00014143","E00014143","Total",120,43,33,10,0,2,0,2,65,64,0,1,0,10
"2011","E00014146","E00014146","Total",100,52,42,10,1,1,0,1,37,36,0,1,0,9
"2011","E00014149","E00014149","Total",128,5,3,2,0,103,97,6,15,15,0,0,0,5
"2011","E00014377","E00014377","Total",138,93,73,20,0,6,0,6,32,29,0,3,0,7
"2011","E00014384","E00014384","Total",131,75,60,15,2,4,0,4,39,37,1,1,0,11
"2011","E00014390","E00014390","Total",115,61,44,17,0,11,9,2,34,33,0,1,0,9
"2011","E00014392","E00014392","Total",90,56,36,20,0,3,0,3,31,31,0,0,0,0
"2011","E00014393","E00014393","Total",106,79,50,29,0,2,0,2,22,21,0,1,0,3
"2011","E00014378","E00014378","Total",213,83,34,49,5,45,8,37,73,66,0,6,1,7
"2011","E00014381","E00014381","Total",117,55,20,35,1,28,18,10,32,28,0,2,2,1
"2011","E00014386","E00014386","Total",180,54,19,35,3,42,7,35,73,70,0,2,1,8
"2011","E00014387","E00014387","Total",107,76,54,22,1,0,0,0,22,22,0,0,0,8
"2011","E00014388","E00014388","Total",119,44,22,22,0,19,16,3,55,53,0,2,0,1
"2011","E00014394","E00014394","Total",112,29,12,17,1,43,6,37,39,34,0,2,3,0
"2011","E00014375","E00014375","Total",179,51,27,24,13,63,4,59,49,48,0,1,0,3
"2011","E00014376","E00014376","Total",193,31,6,25,0,33,5,28,126,123,0,1,2,3
"2011","E00014395","E00014395","Total",124,35,9,26,1,17,5,12,68,64,1,1,2,3
"2011","E00014396","E00014396","Total",136,77,54,23,1,11,8,3,41,41,0,0,0,6
"2011","E00014397","E00014397","Total",207,63,28,35,1,24,5,19,115,109,0,4,2,4
"2011","E00014398","E00014398","Total",159,75,46,29,1,1,0,1,77,76,0,1,0,5
"2011","E00014380","E00014380","Total",112,82,67,15,0,2,1,1,26,25,0,1,0,2
"2011","E00014382","E00014382","Total",143,100,80,20,0,1,1,0,35,31,2,2,0,7
"2011","E00014383","E00014383","Total",140,70,56,14,0,1,0,1,58,57,1,0,0,11
"2011","E00014399","E00014399","Total",124,62,34,28,0,9,0,9,49,48,0,0,1,4
"2011","E00014400","E00014400","Total",115,43,32,11,1,9,0,9,59,55,0,2,2,3
"2011","E00014401","E00014401","Total",91,54,39,15,0,0,0,0,29,26,3,0,0,8
"2011","E00014372","E00014372","Total",128,62,45,17,1,12,1,11,49,49,0,0,0,4
"2011","E00014373","E00014373","Total",102,54,35,19,0,8,0,8,35,33,0,2,0,5
"2011","E00014402","E00014402","Total",115,16,8,8,0,74,3,71,24,23,0,1,0,1
"2011","E00014403","E00014403","Total",100,73,52,21,0,1,0,1,26,26,0,0,0,0
"2011","E00014404","E00014404","Total",124,43,21,22,1,34,25,9,42,41,0,1,0,4
"2011","E00014405","E00014405","Total",86,28,13,15,1,1,1,0,53,50,0,3,0,3
"2011","E00014406","E00014406","Total",113,33,17,16,2,18,2,16,56,55,1,0,0,4
"2011","E00014508","E00014508","Total",116,62,49,13,1,1,0,1,43,39,1,2,1,9
"2011","E00014509","E00014509","Total",147,55,32,23,0,1,0,1,82,81,0,1,0,9
"2011","E00014510","E00014510","Total",141,45,31,14,1,13,1,12,76,75,1,0,0,6
"2011","E00014511","E00014511","Total",122,23,12,11,1,0,0,0,93,87,0,4,2,5
"2011","E00014514","E00014514","Total",138,60,40,20,1,3,1,2,69,67,0,1,1,5
"2011","E00014535","E00014535","Total",143,60,43,17,1,5,0,5,71,66,4,0,1,6
"2011","E00014518","E00014518","Total",71,28,19,9,0,1,0,1,36,36,0,0,0,6
"2011","E00014519","E00014519","Total",76,30,26,4,0,15,0,15,26,24,1,0,1,5
"2011","E00014520","E00014520","Total",99,37,20,17,1,0,0,0,61,61,0,0,0,0
"2011","E00014526","E00014526","Total",116,53,36,17,1,0,0,0,55,50,3,1,1,7
"2011","E00014530","E00014530","Total",109,53,33,20,1,1,0,1,50,48,0,1,1,4
"2011","E00014531","E00014531","Total",108,43,36,7,0,1,0,1,58,58,0,0,0,6
"2011","E00014523","E00014523","Total",124,91,70,21,1,1,0,1,25,24,0,0,1,6
"2011","E00014524","E00014524","Total",119,68,51,17,1,1,0,1,43,42,0,0,1,6
"2011","E00014532","E00014532","Total",113,60,49,11,0,7,1,6,42,36,1,5,0,4
"2011","E00014537","E00014537","Total",128,61,53,8,0,3,2,1,59,57,1,0,1,5
"2011","E00014538","E00014538","Total",103,73,47,26,0,1,1,0,26,21,1,4,0,3
"2011","E00014539","E00014539","Total",118,67,55,12,1,11,0,11,26,23,0,2,1,13
"2011","E00014507","E00014507","Total",135,69,50,19,0,10,0,10,43,38,1,2,2,13
"2011","E00014521","E00014521","Total",104,45,29,16,0,8,5,3,45,44,0,1,0,6
"2011","E00014522","E00014522","Total",97,27,18,9,0,8,0,8,46,43,2,0,1,16
"2011","E00014525","E00014525","Total",140,39,23,16,2,0,0,0,96,93,2,0,1,3
"2011","E00014528","E00014528","Total",137,48,27,21,2,23,0,23,55,55,0,0,0,9
"2011","E00014529","E00014529","Total",105,26,17,9,2,6,1,5,64,64,0,0,0,7
"2011","E00014512","E00014512","Total",132,49,28,21,0,4,0,4,67,64,1,1,1,12
"2011","E00014527","E00014527","Total",111,59,33,26,0,1,1,0,42,41,1,0,0,9
"2011","E00014533","E00014533","Total",136,53,40,13,1,2,0,2,75,74,0,1,0,5
"2011","E00014534","E00014534","Total",142,55,22,33,0,17,2,15,65,59,2,1,3,5
"2011","E00014536","E00014536","Total",140,41,17,24,0,3,0,3,94,92,0,1,1,2
"2011","E00014540","E00014540","Total",134,45,32,13,0,0,0,0,83,82,0,0,1,6
"2011","E00014541","E00014541","Total",125,62,48,14,1,1,0,1,49,45,0,2,2,12
"2011","E00014044","E00014044","Total",124,77,62,15,0,0,0,0,45,42,1,2,0,2
"2011","E00014045","E00014045","Total",125,72,56,16,0,3,2,1,50,47,0,3,0,0
"2011","E00014047","E00014047","Total",131,71,50,21,0,0,0,0,57,54,0,2,1,3
"2011","E00014049","E00014049","Total",190,71,41,30,1,38,10,28,77,72,1,1,3,3
"2011","E00014067","E00014067","Total",140,69,34,35,1,2,0,2,65,63,0,1,1,3
"2011","E00014070","E00014070","Total",125,72,60,12,0,0,0,0,47,47,0,0,0,6
"2011","E00014052","E00014052","Total",168,40,28,12,3,47,1,46,73,72,0,1,0,5
"2011","E00014053","E00014053","Total",111,42,20,22,0,2,2,0,66,64,1,1,0,1
"2011","E00014054","E00014054","Total",111,50,26,24,0,1,0,1,57,54,1,0,2,3
"2011","E00014055","E00014055","Total",109,76,55,21,0,1,0,1,31,31,0,0,0,1
"2011","E00014057","E00014057","Total",104,49,35,14,0,1,0,1,49,46,0,3,0,5
"2011","E00014077","E00014077","Total",152,64,32,32,0,3,1,2,81,80,0,1,0,4
"2011","E00014043","E00014043","Total",146,48,29,19,0,4,0,4,84,82,0,1,1,10
"2011","E00014061","E00014061","Total",110,55,43,12,0,0,0,0,54,53,0,0,1,1
"2011","E00014063","E00014063","Total",207,33,15,18,1,2,0,2,170,163,0,4,3,1
"2011","E00014064","E00014064","Total",122,53,42,11,0,0,0,0,65,64,0,0,1,4
"2011","E00014066","E00014066","Total",108,69,54,15,0,1,1,0,33,31,0,1,1,5
"2011","E00014056","E00014056","Total",104,57,33,24,0,2,1,1,40,40,0,0,0,5
"2011","E00014062","E00014062","Total",132,62,54,8,0,2,1,1,63,61,1,1,0,5
"2011","E00014065","E00014065","Total",124,47,32,15,1,10,0,10,61,56,1,3,1,5
"2011","E00014068","E00014068","Total",109,66,48,18,1,0,0,0,37,36,0,1,0,5
"2011","E00014072","E00014072","Total",131,92,72,20,1,0,0,0,32,30,0,0,2,6
"2011","E00014076","E00014076","Total",109,86,69,17,0,0,0,0,18,17,1,0,0,5
"2011","E00014374","E00014374","Total",106,70,50,20,1,4,0,4,26,25,1,0,0,5
"2011","E00014379","E00014379","Total",103,67,45,22,0,0,0,0,34,30,2,1,1,2
"2011","E00014385","E00014385","Total",98,60,37,23,0,0,0,0,37,35,1,1,0,1
"2011","E00014389","E00014389","Total",128,19,13,6,1,3,0,3,101,96,1,1,3,4
"2011","E00014391","E00014391","Total",109,58,39,19,1,4,2,2,39,36,2,0,1,7
"2011","E00014083","E00014083","Total",93,32,22,10,0,1,0,1,51,47,0,3,1,9
"2011","E00014084","E00014084","Total",173,33,25,8,1,9,0,9,115,109,1,2,3,15
"2011","E00014085","E00014085","Total",116,37,23,14,0,7,0,7,59,55,0,1,3,13
"2011","E00014086","E00014086","Total",190,54,37,17,0,15,0,15,102,98,2,2,0,19
"2011","E00014087","E00014087","Total",167,38,29,9,1,19,0,19,99,96,0,1,2,10
"2011","E00014092","E00014092","Total",151,56,31,25,0,1,0,1,83,81,0,0,2,11
"2011","E00014095","E00014095","Total",144,44,27,17,0,1,0,1,88,86,0,1,1,11
"2011","E00014096","E00014096","Total",136,45,33,12,1,1,0,1,76,74,0,0,2,13
"2011","E00014088","E00014088","Total",107,47,32,15,0,1,0,1,55,49,0,6,0,4
"2011","E00014089","E00014089","Total",166,48,33,15,2,0,0,0,108,107,0,1,0,8
"2011","E00014090","E00014090","Total",133,27,17,10,0,5,0,5,92,87,1,1,3,9
"2011","E00014091","E00014091","Total",114,45,38,7,0,1,1,0,55,53,0,1,1,13
"2011","E00014093","E00014093","Total",98,53,40,13,0,0,0,0,32,30,0,1,1,13
"2011","E00014097","E00014097","Total",131,30,20,10,1,5,0,5,87,86,0,1,0,8
"2011","E00014098","E00014098","Total",104,53,38,15,1,6,1,5,38,31,0,7,0,6
"2011","E00014339","E00014339","Total",107,54,39,15,1,0,0,0,44,42,0,2,0,8
"2011","E00014342","E00014342","Total",130,41,24,17,0,1,0,1,84,81,0,2,1,4
"2011","E00014347","E00014347","Total",168,54,37,17,0,5,0,5,99,86,8,2,3,10
"2011","E00014363","E00014363","Total",105,37,29,8,0,13,0,13,43,40,1,0,2,12
"2011","E00014367","E00014367","Total",101,33,25,8,1,14,0,14,45,43,1,0,1,8
"2011","E00014368","E00014368","Total",142,43,26,17,0,15,0,15,78,74,3,0,1,6
"2011","E00014371","E00014371","Total",113,47,25,22,3,0,0,0,44,42,2,0,0,19
"2011","E00014338","E00014338","Total",89,66,52,14,0,1,0,1,20,20,0,0,0,2
"2011","E00014358","E00014358","Total",100,46,39,7,0,1,0,1,43,42,0,1,0,10
"2011","E00014361","E00014361","Total",135,63,47,16,0,0,0,0,67,65,0,2,0,5
"2011","E00014362","E00014362","Total",121,58,47,11,0,0,0,0,61,61,0,0,0,2
"2011","E00014365","E00014365","Total",86,52,38,14,0,0,0,0,28,27,0,1,0,6
"2011","E00014366","E00014366","Total",94,53,39,14,0,5,0,5,32,31,0,1,0,4
"2011","E00014370","E00014370","Total",152,61,40,21,1,1,0,1,85,83,0,1,1,4
"2011","E00014330","E00014330","Total",139,59,38,21,0,0,0,0,64,62,0,1,1,16
"2011","E00014331","E00014331","Total",122,41,27,14,0,7,0,7,62,60,0,1,1,12
"2011","E00014332","E00014332","Total",125,44,38,6,0,3,0,3,67,65,0,2,0,11
"2011","E00014356","E00014356","Total",85,31,19,12,2,6,0,6,43,41,1,1,0,3
"2011","E00014357","E00014357","Total",85,21,15,6,1,0,0,0,48,48,0,0,0,15
"2011","E00014359","E00014359","Total",99,37,31,6,1,0,0,0,42,41,0,1,0,19
"2011","E00014360","E00014360","Total",137,64,52,12,1,0,0,0,59,59,0,0,0,13
"2011","E00014048","E00014048","Total",116,60,39,21,0,2,0,2,52,50,0,2,0,2
"2011","E00014050","E00014050","Total",139,19,14,5,0,48,41,7,68,67,0,1,0,4
"2011","E00014069","E00014069","Total",119,41,36,5,0,1,1,0,71,70,1,0,0,6
"2011","E00014071","E00014071","Total",115,42,30,12,0,1,0,1,64,62,0,0,2,8
"2011","E00014073","E00014073","Total",154,70,47,23,1,3,0,3,75,72,0,3,0,5
"2011","E00014074","E00014074","Total",127,34,16,18,3,2,0,2,87,87,0,0,0,1
"2011","E00014075","E00014075","Total",125,55,43,12,0,0,0,0,66,63,0,3,0,4
"2011","E00014183","E00014183","Total",89,52,31,21,0,2,1,1,33,32,0,1,0,2
"2011","E00014189","E00014189","Total",116,40,23,17,0,1,0,1,68,63,3,1,1,7
"2011","E00014199","E00014199","Total",94,42,23,19,1,1,0,1,45,42,1,2,0,5
"2011","E00014200","E00014200","Total",104,28,18,10,0,18,1,17,55,53,1,0,1,3
"2011","E00014202","E00014202","Total",103,42,20,22,0,1,0,1,58,54,1,1,2,2
"2011","E00014206","E00014206","Total",103,26,21,5,2,33,2,31,38,36,0,1,1,4
"2011","E00014207","E00014207","Total",109,44,26,18,0,29,4,25,30,24,2,2,2,6
"2011","E00014184","E00014184","Total",139,20,9,11,0,35,0,35,81,80,0,1,0,3
"2011","E00014185","E00014185","Total",159,46,29,17,0,22,0,22,87,86,0,1,0,4
"2011","E00014186","E00014186","Total",119,40,24,16,0,9,9,0,68,64,0,2,2,2
"2011","E00014187","E00014187","Total",137,51,27,24,3,10,0,10,67,65,0,2,0,6
"2011","E00014188","E00014188","Total",101,43,32,11,1,1,0,1,52,51,0,1,0,4
"2011","E00014195","E00014195","Total",83,42,23,19,0,1,0,1,36,29,1,5,1,4
"2011","E00014219","E00014219","Total",97,3,2,1,0,90,10,80,4,4,0,0,0,0
"2011","E00014220","E00014220","Total",143,34,18,16,0,18,2,16,89,87,0,1,1,2
"2011","E00014259","E00014259","Total",55,5,3,2,1,14,2,12,35,31,1,2,1,0
"2011","E00014281","E00014281","Total",81,34,16,18,0,1,0,1,43,39,0,1,3,3
"2011","E00014282","E00014282","Total",114,45,27,18,0,37,1,36,32,30,0,2,0,0
"2011","E00014284","E00014284","Total",99,36,18,18,1,1,0,1,60,57,0,2,1,1
"2011","E00014286","E00014286","Total",119,34,20,14,1,21,1,20,63,62,0,1,0,0
"2011","E00014290","E00014290","Total",95,41,28,13,1,4,3,1,47,43,2,1,1,2
"2011","E00014292","E00014292","Total",119,22,6,16,4,10,5,5,77,72,3,0,2,6
"2011","E00014513","E00014513","Total",133,34,19,15,0,1,0,1,94,86,0,8,0,4
"2011","E00014515","E00014515","Total",105,41,24,17,1,6,0,6,56,55,0,1,0,1
"2011","E00014516","E00014516","Total",143,48,31,17,0,39,7,32,52,48,0,4,0,4
"2011","E00014517","E00014517","Total",384,141,79,62,4,0,0,0,225,220,0,2,3,14
"2011","E00014542","E00014542","Total",132,54,32,22,1,1,0,1,67,67,0,0,0,9
"2011","E00014543","E00014543","Total",130,58,39,19,0,0,0,0,69,68,1,0,0,3
"2011","E00014544","E00014544","Total",122,62,48,14,0,2,0,2,44,44,0,0,0,14
"2011","E00014078","E00014078","Total",84,43,38,5,0,2,1,1,36,33,0,2,1,3
"2011","E00014079","E00014079","Total",122,52,37,15,1,12,0,12,48,44,0,2,2,9
"2011","E00014094","E00014094","Total",105,51,32,19,0,5,1,4,42,37,3,1,1,7
"2011","E00014099","E00014099","Total",139,43,25,18,1,8,1,7,82,80,0,1,1,5
"2011","E00014100","E00014100","Total",119,66,44,22,0,2,0,2,45,44,0,0,1,6
"2011","E00014102","E00014102","Total",123,21,14,7,1,36,0,36,63,53,4,1,5,2
"2011","E00014108","E00014108","Total",116,72,53,19,0,4,0,4,33,32,0,0,1,7
"2011","E00014109","E00014109","Total",126,56,42,14,0,8,0,8,55,52,1,1,1,7
"2011","E00014110","E00014110","Total",120,3,2,1,0,112,2,110,1,1,0,0,0,4
"2011","E00014112","E00014112","Total",144,24,16,8,0,87,44,43,30,30,0,0,0,3
"2011","E00014113","E00014113","Total",90,7,7,0,0,70,36,34,13,13,0,0,0,0
"2011","E00014115","E00014115","Total",105,4,3,1,0,93,4,89,8,7,0,0,1,0
"2011","E00014346","E00014346","Total",156,63,44,19,1,5,3,2,86,85,0,1,0,1
"2011","E00014348","E00014348","Total",116,64,56,8,0,1,0,1,47,47,0,0,0,4
"2011","E00014349","E00014349","Total",231,65,45,20,0,11,2,9,147,142,0,2,3,8
"2011","E00014364","E00014364","Total",114,22,16,6,2,80,74,6,8,8,0,0,0,2
"2011","E00175096","E00175096","Total",132,14,7,7,0,85,80,5,29,27,0,0,2,4
"2011","E00014334","E00014334","Total",55,12,7,5,0,31,3,28,12,10,0,0,2,0
"2011","E00014336","E00014336","Total",124,85,67,18,0,1,0,1,31,30,0,1,0,7
"2011","E00014337","E00014337","Total",93,3,3,0,0,81,2,79,9,5,0,0,4,0
"2011","E00014345","E00014345","Total",123,41,33,8,0,18,0,18,62,59,1,0,2,2
"2011","E00014351","E00014351","Total",126,46,31,15,3,0,0,0,67,64,0,2,1,10
"2011","E00014353","E00014353","Total",143,83,77,6,1,4,1,3,48,46,0,2,0,7
"2011","E00014354","E00014354","Total",107,69,54,15,0,1,1,0,34,34,0,0,0,3
"2011","E00014335","E00014335","Total",150,9,8,1,0,113,5,108,28,26,0,0,2,0
"2011","E00014341","E00014341","Total",134,47,36,11,0,37,34,3,43,43,0,0,0,7
"2011","E00014344","E00014344","Total",384,72,42,30,0,8,1,7,297,276,1,6,14,7
"2011","E00014350","E00014350","Total",107,1,0,1,0,98,4,94,5,5,0,0,0,3
"2011","E00014352","E00014352","Total",102,8,7,1,0,69,29,40,22,19,0,1,2,3
"2011","E00014355","E00014355","Total",100,1,1,0,0,92,17,75,5,4,1,0,0,2
"2011","E00014046","E00014046","Total",126,83,65,18,0,4,0,4,32,27,1,1,3,7
"2011","E00014051","E00014051","Total",84,34,17,17,0,12,9,3,34,32,0,1,1,4
"2011","E00014058","E00014058","Total",147,31,13,18,0,33,1,32,83,80,0,3,0,0
"2011","E00014059","E00014059","Total",96,26,16,10,0,53,45,8,16,15,0,1,0,1
"2011","E00014060","E00014060","Total",151,7,5,2,1,97,3,94,43,41,0,1,1,3
"2011","E00175099","E00175099","Total",70,7,3,4,13,36,0,36,14,12,0,2,0,0
"2011","E00175100","E00175100","Total",231,59,37,22,17,40,1,39,106,102,1,1,2,9
"2011","E00014263","E00014263","Total",134,48,24,24,0,29,3,26,55,55,0,0,0,2
"2011","E00014264","E00014264","Total",128,90,56,34,0,2,1,1,33,31,0,2,0,3
"2011","E00014267","E00014267","Total",189,51,22,29,0,12,0,12,121,121,0,0,0,5
"2011","E00014268","E00014268","Total",133,75,46,29,0,5,2,3,49,49,0,0,0,4
"2011","E00014293","E00014293","Total",148,57,27,30,0,19,3,16,68,64,1,1,2,4
"2011","E00014299","E00014299","Total",140,46,18,28,1,17,0,17,74,74,0,0,0,2
"2011","E00014261","E00014261","Total",131,37,25,12,2,21,14,7,69,69,0,0,0,2
"2011","E00014262","E00014262","Total",125,27,16,11,0,23,4,19,72,71,0,0,1,3
"2011","E00014265","E00014265","Total",108,24,7,17,1,29,3,26,49,47,1,1,0,5
"2011","E00014266","E00014266","Total",139,54,34,20,0,27,1,26,51,47,3,1,0,7
"2011","E00014296","E00014296","Total",145,45,37,8,1,56,8,48,42,40,0,0,2,1
"2011","E00014297","E00014297","Total",144,46,27,19,4,43,3,40,47,45,0,1,1,4
"2011","E00014298","E00014298","Total",102,13,8,5,1,52,0,52,33,32,0,1,0,3
"2011","E00014260","E00014260","Total",135,28,17,11,0,43,4,39,64,63,0,0,1,0
"2011","E00014283","E00014283","Total",108,23,12,11,1,38,1,37,44,43,0,1,0,2
"2011","E00014287","E00014287","Total",117,13,3,10,0,56,1,55,48,48,0,0,0,0
"2011","E00014288","E00014288","Total",113,5,2,3,1,90,1,89,16,14,0,2,0,1
"2011","E00014289","E00014289","Total",117,51,32,19,3,15,0,15,48,47,0,1,0,0
"2011","E00014291","E00014291","Total",95,10,4,6,0,50,3,47,29,29,0,0,0,6
"2011","E00014294","E00014294","Total",135,3,1,2,2,104,0,104,26,22,0,0,4,0
"2011","E00014295","E00014295","Total",98,19,11,8,2,26,3,23,51,49,0,2,0,0
"2011","E00014101","E00014101","Total",134,42,33,9,2,0,0,0,85,80,3,1,1,5
"2011","E00014104","E00014104","Total",98,19,11,8,0,6,0,6,71,66,4,0,1,2
"2011","E00014105","E00014105","Total",152,52,30,22,1,3,0,3,90,85,0,3,2,6
"2011","E00014116","E00014116","Total",143,69,44,25,1,10,0,10,58,58,0,0,0,5
"2011","E00175090","E00175090","Total",139,42,28,14,0,7,2,5,89,88,0,1,0,1
"2011","E00014080","E00014080","Total",88,38,30,8,1,6,0,6,35,32,0,0,3,8
"2011","E00014081","E00014081","Total",123,45,25,20,0,7,0,7,66,33,21,5,7,5
"2011","E00014082","E00014082","Total",94,60,46,14,0,4,0,4,24,22,0,0,2,6
"2011","E00014103","E00014103","Total",105,36,21,15,0,9,1,8,60,58,0,1,1,0
"2011","E00014107","E00014107","Total",105,57,52,5,1,7,0,7,30,28,1,1,0,10
"2011","E00014111","E00014111","Total",106,57,48,9,1,8,0,8,35,34,1,0,0,5
"2011","E00014190","E00014190","Total",158,56,30,26,0,2,0,2,93,92,0,1,0,7
"2011","E00014191","E00014191","Total",123,70,50,20,0,2,1,1,42,38,0,2,2,9
"2011","E00014192","E00014192","Total",93,45,29,16,0,3,1,2,44,43,0,1,0,1
"2011","E00014193","E00014193","Total",148,62,40,22,0,3,0,3,68,66,0,2,0,15
"2011","E00014217","E00014217","Total",114,53,36,17,0,2,2,0,55,53,0,2,0,4
"2011","E00014218","E00014218","Total",148,72,49,23,0,0,0,0,64,64,0,0,0,12
"2011","E00014194","E00014194","Total",65,33,22,11,0,1,0,1,30,29,0,1,0,1
"2011","E00014197","E00014197","Total",136,51,37,14,0,8,0,8,76,74,0,2,0,1
"2011","E00014198","E00014198","Total",117,38,19,19,0,8,0,8,65,60,4,1,0,6
"2011","E00014201","E00014201","Total",104,29,22,7,1,2,0,2,71,70,0,1,0,1
"2011","E00014203","E00014203","Total",116,51,29,22,0,26,0,26,38,37,0,1,0,1
"2011","E00014204","E00014204","Total",124,68,48,20,0,0,0,0,55,53,1,0,1,1
"2011","E00014210","E00014210","Total",133,47,26,21,1,15,0,15,66,66,0,0,0,4
"2011","E00014196","E00014196","Total",91,31,22,9,1,8,1,7,49,48,0,1,0,2
"2011","E00014205","E00014205","Total",118,60,44,16,0,1,0,1,52,52,0,0,0,5
"2011","E00014208","E00014208","Total",96,33,18,15,0,9,1,8,52,51,0,0,1,2
"2011","E00014209","E00014209","Total",175,44,32,12,1,15,1,14,113,112,1,0,0,2
"2011","E00014213","E00014213","Total",117,48,38,10,0,8,1,7,60,59,0,1,0,1
"2011","E00014214","E00014214","Total",120,86,65,21,0,1,0,1,27,22,0,3,2,6
"2011","E00014270","E00014270","Total",91,9,4,5,1,42,1,41,38,37,0,1,0,1
"2011","E00014271","E00014271","Total",111,36,15,21,5,12,0,12,57,52,1,3,1,1
"2011","E00014274","E00014274","Total",131,24,14,10,1,24,4,20,81,81,0,0,0,1
"2011","E00014276","E00014276","Total",139,43,18,25,1,33,4,29,58,53,1,3,1,4
"2011","E00014277","E00014277","Total",129,35,14,21,1,20,7,13,70,68,0,2,0,3
"2011","E00014279","E00014279","Total",106,19,7,12,5,39,3,36,41,40,0,0,1,2
"2011","E00014280","E00014280","Total",74,24,9,15,0,5,0,5,43,42,1,0,0,2
"2011","E00014258","E00014258","Total",157,61,31,30,0,37,0,37,54,54,0,0,0,5
"2011","E00014269","E00014269","Total",118,36,18,18,1,42,0,42,38,35,0,3,0,1
"2011","E00014272","E00014272","Total",90,42,17,25,3,3,0,3,42,40,0,2,0,0
"2011","E00014273","E00014273","Total",95,45,24,21,1,2,1,1,46,43,1,2,0,1
"2011","E00014275","E00014275","Total",138,71,43,28,0,1,0,1,63,59,0,4,0,3
"2011","E00014278","E00014278","Total",91,43,20,23,0,11,1,10,37,35,0,2,0,0
"2011","E00014285","E00014285","Total",98,41,15,26,0,6,1,5,49,46,0,1,2,2
"2011","E00014545","E00014545","Total",160,62,33,29,2,12,6,6,78,74,2,2,0,6
"2011","E00014561","E00014561","Total",141,23,10,13,0,84,9,75,26,26,0,0,0,8
"2011","E00014563","E00014563","Total",119,47,20,27,1,13,6,7,54,47,0,7,0,4
"2011","E00014564","E00014564","Total",147,61,27,34,0,17,5,12,67,65,1,1,0,2
"2011","E00014567","E00014567","Total",164,73,41,32,1,9,3,6,75,70,0,5,0,6
"2011","E00014568","E00014568","Total",129,63,27,36,1,5,1,4,59,55,0,4,0,1
"2011","E00014569","E00014569","Total",127,36,17,19,1,60,56,4,28,26,0,2,0,2
"2011","E00014551","E00014551","Total",147,61,28,33,0,4,1,3,82,79,1,0,2,0
"2011","E00014554","E00014554","Total",115,63,39,24,0,0,0,0,51,45,1,4,1,1
"2011","E00014555","E00014555","Total",127,53,27,26,1,20,0,20,53,53,0,0,0,0
"2011","E00014556","E00014556","Total",142,55,32,23,2,8,0,8,73,69,1,3,0,4
"2011","E00014557","E00014557","Total",147,54,28,26,1,31,13,18,56,53,0,3,0,5
"2011","E00014577","E00014577","Total",95,35,19,16,5,0,0,0,53,51,0,1,1,2
"2011","E00014550","E00014550","Total",129,75,43,32,1,0,0,0,46,45,0,1,0,7
"2011","E00014553","E00014553","Total",101,53,32,21,0,6,0,6,41,41,0,0,0,1
"2011","E00014575","E00014575","Total",154,84,49,35,1,12,0,12,55,53,0,0,2,2
"2011","E00014576","E00014576","Total",125,33,23,10,1,64,2,62,21,21,0,0,0,6
"2011","E00014579","E00014579","Total",122,79,51,28,0,1,0,1,34,34,0,0,0,8
"2011","E00014580","E00014580","Total",108,62,39,23,0,1,1,0,43,36,3,2,2,2
"2011","E00014581","E00014581","Total",127,47,37,10,0,25,0,25,52,46,1,5,0,3
"2011","E00014595","E00014595","Total",116,49,38,11,1,4,3,1,51,49,0,1,1,11
"2011","E00014597","E00014597","Total",112,54,42,12,0,3,1,2,46,42,1,2,1,9
"2011","E00014600","E00014600","Total",85,24,16,8,0,36,35,1,23,20,2,1,0,2
"2011","E00014602","E00014602","Total",87,9,4,5,0,71,30,41,7,7,0,0,0,0
"2011","E00014604","E00014604","Total",113,12,8,4,1,90,37,53,8,8,0,0,0,2
"2011","E00014605","E00014605","Total",128,55,37,18,3,6,1,5,58,52,0,6,0,6
"2011","E00014603","E00014603","Total",104,81,59,22,1,1,1,0,20,19,0,1,0,1
"2011","E00014607","E00014607","Total",113,67,38,29,0,2,1,1,40,38,0,2,0,4
"2011","E00014609","E00014609","Total",101,47,26,21,0,0,0,0,49,48,0,0,1,5
"2011","E00014611","E00014611","Total",117,62,41,21,0,4,2,2,44,42,0,2,0,7
"2011","E00014612","E00014612","Total",107,76,62,14,0,2,1,1,25,22,0,2,1,4
"2011","E00014613","E00014613","Total",140,80,61,19,1,0,0,0,46,42,1,2,1,13
"2011","E00014594","E00014594","Total",118,61,37,24,0,1,0,1,49,46,2,1,0,7
"2011","E00014596","E00014596","Total",86,42,27,15,0,4,1,3,34,18,14,0,2,6
"2011","E00014601","E00014601","Total",102,64,37,27,1,0,0,0,33,27,0,6,0,4
"2011","E00014606","E00014606","Total",89,23,19,4,0,39,6,33,23,20,0,1,2,4
"2011","E00175091","E00175091","Total",165,57,40,17,1,75,1,74,28,26,1,0,1,4
"2011","E00014582","E00014582","Total",137,51,31,20,2,1,0,1,70,68,1,0,1,13
"2011","E00014583","E00014583","Total",119,34,23,11,0,16,0,16,54,49,3,2,0,15
"2011","E00014584","E00014584","Total",157,45,24,21,1,12,0,12,88,88,0,0,0,11
"2011","E00014585","E00014585","Total",174,58,45,13,0,4,0,4,105,102,0,2,1,7
"2011","E00014586","E00014586","Total",88,54,40,14,0,1,1,0,29,28,1,0,0,4
"2011","E00014587","E00014587","Total",104,9,7,2,1,81,3,78,7,7,0,0,0,6
"2011","E00014588","E00014588","Total",104,49,42,7,0,8,0,8,43,42,0,1,0,4
"2011","E00014589","E00014589","Total",126,57,39,18,0,14,0,14,43,39,1,3,0,12
"2011","E00014590","E00014590","Total",129,70,52,18,1,0,0,0,56,54,0,2,0,2
"2011","E00014591","E00014591","Total",126,78,58,20,1,0,0,0,43,43,0,0,0,4
"2011","E00014592","E00014592","Total",102,71,56,15,0,1,1,0,26,24,1,1,0,4
"2011","E00014593","E00014593","Total",109,67,51,16,0,2,1,1,38,37,1,0,0,2
"2011","E00014598","E00014598","Total",121,64,51,13,1,0,0,0,55,52,0,2,1,1
"2011","E00014599","E00014599","Total",104,64,40,24,1,2,0,2,36,36,0,0,0,1
"2011","E00014223","E00014223","Total",122,62,47,15,0,3,2,1,51,51,0,0,0,6
"2011","E00014224","E00014224","Total",115,50,35,15,0,4,0,4,59,56,0,2,1,2
"2011","E00014225","E00014225","Total",124,65,45,20,0,9,1,8,45,37,2,4,2,5
"2011","E00014226","E00014226","Total",96,33,27,6,0,32,2,30,29,29,0,0,0,2
"2011","E00014228","E00014228","Total",88,32,27,5,0,38,2,36,12,12,0,0,0,6
"2011","E00014229","E00014229","Total",100,55,44,11,0,1,0,1,42,40,1,1,0,2
"2011","E00014232","E00014232","Total",100,64,52,12,1,2,0,2,27,25,2,0,0,6
"2011","E00014227","E00014227","Total",127,72,38,34,1,22,18,4,30,29,0,1,0,2
"2011","E00014230","E00014230","Total",128,59,37,22,2,1,0,1,59,59,0,0,0,7
"2011","E00014231","E00014231","Total",92,65,50,15,0,2,1,1,20,20,0,0,0,5
"2011","E00014233","E00014233","Total",121,17,10,7,0,81,76,5,18,16,0,2,0,5
"2011","E00014234","E00014234","Total",129,60,38,22,2,35,29,6,29,26,0,1,2,3
"2011","E00014236","E00014236","Total",141,20,13,7,0,97,84,13,22,22,0,0,0,2
"2011","E00014651","E00014651","Total",115,31,22,9,0,73,59,14,9,8,0,1,0,2
"2011","E00014652","E00014652","Total",112,62,55,7,0,9,3,6,37,32,1,0,4,4
"2011","E00014654","E00014654","Total",128,63,46,17,1,32,31,1,32,32,0,0,0,0
"2011","E00014655","E00014655","Total",132,63,41,22,0,21,20,1,43,41,0,2,0,5
"2011","E00014656","E00014656","Total",130,45,32,13,1,38,37,1,41,36,2,3,0,5
"2011","E00014658","E00014658","Total",139,78,56,22,0,1,0,1,54,51,1,1,1,6
"2011","E00014657","E00014657","Total",122,62,37,25,1,1,1,0,54,49,0,4,1,4
"2011","E00014659","E00014659","Total",147,44,22,22,0,17,17,0,80,79,0,0,1,6
"2011","E00014660","E00014660","Total",156,78,54,24,1,6,2,4,63,62,1,0,0,8
"2011","E00014662","E00014662","Total",127,86,55,31,1,0,0,0,37,35,0,2,0,3
"2011","E00014668","E00014668","Total",92,70,40,30,0,1,0,1,17,16,0,1,0,4
"2011","E00014669","E00014669","Total",123,60,39,21,0,4,3,1,57,52,0,5,0,2
"2011","E00014646","E00014646","Total",153,69,46,23,0,4,2,2,79,74,1,3,1,1
"2011","E00014647","E00014647","Total",114,59,47,12,0,2,1,1,51,50,0,1,0,2
"2011","E00014648","E00014648","Total",132,90,75,15,0,2,1,1,35,34,1,0,0,5
"2011","E00014649","E00014649","Total",105,67,53,14,0,2,2,0,31,27,1,2,1,5
"2011","E00014650","E00014650","Total",124,44,36,8,1,4,3,1,67,64,0,1,2,8
"2011","E00014653","E00014653","Total",113,38,24,14,1,1,0,1,67,61,1,5,0,6
"2011","E00014182","E00014182","Total",115,55,34,21,0,2,0,2,52,50,0,1,1,6
"2011","E00014211","E00014211","Total",130,72,54,18,0,3,1,2,45,43,2,0,0,10
"2011","E00014212","E00014212","Total",99,26,19,7,0,17,0,17,53,51,0,0,2,3
"2011","E00014215","E00014215","Total",116,53,39,14,1,1,1,0,52,48,0,3,1,9
"2011","E00175097","E00175097","Total",70,24,17,7,0,6,1,5,36,35,1,0,0,4
"2011","E00175098","E00175098","Total",49,20,14,6,0,2,0,2,27,25,0,2,0,0
"2011","E00014546","E00014546","Total",122,75,56,19,1,10,9,1,30,29,0,1,0,6
"2011","E00014558","E00014558","Total",110,62,34,28,1,4,1,3,37,36,0,1,0,6
"2011","E00014560","E00014560","Total",128,73,52,21,2,0,0,0,48,44,0,4,0,5
"2011","E00014562","E00014562","Total",105,63,43,20,0,3,0,3,34,33,1,0,0,5
"2011","E00014578","E00014578","Total",145,77,55,22,0,2,0,2,61,58,0,3,0,5
"2011","E00014547","E00014547","Total",186,87,52,35,0,19,1,18,76,71,0,4,1,4
"2011","E00014548","E00014548","Total",133,64,39,25,1,3,0,3,61,57,2,2,0,4
"2011","E00014552","E00014552","Total",129,76,52,24,2,2,0,2,42,37,1,0,4,7
"2011","E00014559","E00014559","Total",161,74,45,29,0,1,0,1,85,84,1,0,0,1
"2011","E00014565","E00014565","Total",112,71,35,36,2,3,3,0,36,35,0,1,0,0
"2011","E00014566","E00014566","Total",154,83,47,36,0,13,12,1,57,56,0,0,1,1
"2011","E00014549","E00014549","Total",125,53,41,12,0,8,0,8,61,57,0,3,1,3
"2011","E00014570","E00014570","Total",141,67,32,35,1,1,0,1,70,67,0,3,0,2
"2011","E00014571","E00014571","Total",124,46,25,21,0,25,1,24,52,52,0,0,0,1
"2011","E00014572","E00014572","Total",108,46,31,15,0,32,32,0,28,28,0,0,0,2
"2011","E00014573","E00014573","Total",140,47,20,27,1,3,0,3,89,86,0,2,1,0
"2011","E00014574","E00014574","Total",94,44,26,18,0,13,9,4,35,32,0,1,2,2
"2011","E00014661","E00014661","Total",148,58,37,21,0,17,13,4,73,72,0,1,0,0
"2011","E00014663","E00014663","Total",113,53,34,19,0,1,0,1,57,55,0,2,0,2
"2011","E00014664","E00014664","Total",163,60,42,18,0,55,2,53,44,39,0,0,5,4
"2011","E00014665","E00014665","Total",111,56,36,20,0,18,4,14,34,33,0,1,0,3
"2011","E00014666","E00014666","Total",146,69,50,19,0,16,16,0,57,55,0,2,0,4
"2011","E00014667","E00014667","Total",128,32,14,18,1,56,52,4,36,34,0,2,0,3
"2011","E00014235","E00014235","Total",103,78,65,13,2,3,3,0,19,18,0,1,0,1
"2011","E00014237","E00014237","Total",60,18,13,5,1,37,33,4,3,3,0,0,0,1
"2011","E00014238","E00014238","Total",100,22,15,7,0,55,50,5,17,15,0,0,2,6
"2011","E00014239","E00014239","Total",96,10,8,2,0,81,29,52,4,3,1,0,0,1
"2011","E00014241","E00014241","Total",113,19,13,6,0,72,66,6,17,17,0,0,0,5
"2011","E00014244","E00014244","Total",103,25,17,8,0,60,46,14,16,15,0,0,1,2
"2011","E00014250","E00014250","Total",116,46,37,9,1,48,48,0,19,17,0,2,0,2
"2011","E00014221","E00014221","Total",145,57,26,31,4,44,34,10,39,39,0,0,0,1
"2011","E00014251","E00014251","Total",80,32,15,17,2,12,1,11,34,33,0,1,0,0
"2011","E00014252","E00014252","Total",105,50,23,27,1,26,13,13,28,26,0,2,0,0
"2011","E00014254","E00014254","Total",92,25,14,11,1,48,35,13,18,16,0,2,0,0
"2011","E00014255","E00014255","Total",74,41,17,24,0,3,2,1,27,21,1,4,1,3
"2011","E00014256","E00014256","Total",116,40,19,21,4,39,28,11,31,30,0,1,0,2
"2011","E00014257","E00014257","Total",100,33,15,18,3,38,19,19,25,25,0,0,0,1
"2011","E00014243","E00014243","Total",158,16,9,7,0,128,120,8,12,12,0,0,0,2
"2011","E00014246","E00014246","Total",51,15,8,7,0,28,26,2,8,8,0,0,0,0
"2011","E00014247","E00014247","Total",197,17,10,7,0,171,158,13,7,7,0,0,0,2
"2011","E00014249","E00014249","Total",108,17,10,7,0,84,72,12,7,7,0,0,0,0
"2011","E00014222","E00014222","Total",93,9,6,3,0,74,8,66,4,4,0,0,0,6
"2011","E00014240","E00014240","Total",133,16,6,10,0,103,86,17,12,9,3,0,0,2
"2011","E00014242","E00014242","Total",123,3,1,2,1,115,13,102,3,2,1,0,0,1
"2011","E00014248","E00014248","Total",95,44,22,22,0,25,7,18,25,22,0,3,0,1
"2011","E00175101","E00175101","Total",166,21,12,9,1,121,6,115,20,18,0,2,0,3
"2011","E00014645","E00014645","Total",114,39,21,18,0,24,14,10,48,48,0,0,0,3
"2011","E00014670","E00014670","Total",127,57,25,32,0,22,15,7,46,41,1,1,3,2
"2011","E00014671","E00014671","Total",115,35,20,15,0,17,2,15,61,58,0,3,0,2
"2011","E00014672","E00014672","Total",120,50,31,19,0,12,5,7,54,51,0,3,0,4
"2011","E00014673","E00014673","Total",108,55,25,30,0,15,9,6,37,33,0,4,0,1
"2011","E00175088","E00175088","Total",118,57,41,16,0,3,1,2,51,51,0,0,0,7
"2011","E00175089","E00175089","Total",127,53,33,20,1,6,4,2,65,65,0,0,0,2
"2011","E00175092","E00175092","Total",103,37,15,22,1,45,22,23,18,17,0,1,0,2
"2011","E00015169","E00015169","Total",113,30,15,15,1,60,11,49,22,21,0,1,0,0
"2011","E00015189","E00015189","Total",116,21,8,13,0,64,62,2,30,28,0,0,2,1
"2011","E00015190","E00015190","Total",172,26,6,20,1,116,113,3,29,26,0,2,1,0
"2011","E00015191","E00015191","Total",81,13,8,5,1,53,41,12,14,13,0,0,1,0
"2011","E00015192","E00015192","Total",99,10,5,5,1,70,67,3,14,14,0,0,0,4
"2011","E00015193","E00015193","Total",55,21,11,10,0,21,6,15,12,12,0,0,0,1
"2011","E00015194","E00015194","Total",94,8,3,5,0,76,28,48,10,10,0,0,0,0
"2011","E00015668","E00015668","Total",103,20,13,7,7,44,29,15,30,29,1,0,0,2
"2011","E00015688","E00015688","Total",158,89,40,49,1,0,0,0,65,61,0,4,0,3
"2011","E00015689","E00015689","Total",105,12,5,7,0,86,86,0,7,5,0,1,1,0
"2011","E00015695","E00015695","Total",143,19,8,11,1,106,94,12,17,16,0,1,0,0
"2011","E00015700","E00015700","Total",134,18,6,12,2,105,103,2,8,8,0,0,0,1
"2011","E00015702","E00015702","Total",112,18,5,13,0,80,63,17,14,12,0,2,0,0
"2011","E00015679","E00015679","Total",141,69,27,42,6,19,16,3,40,36,0,4,0,7
"2011","E00015680","E00015680","Total",125,42,11,31,0,56,39,17,24,24,0,0,0,3
"2011","E00015684","E00015684","Total",165,99,41,58,8,28,8,20,29,26,2,1,0,1
"2011","E00015686","E00015686","Total",128,44,22,22,0,57,6,51,25,23,0,1,1,2
"2011","E00171543","E00171543","Total",95,45,13,32,14,22,3,19,12,11,0,1,0,2
"2011","E00171546","E00171546","Total",90,23,9,14,1,26,24,2,39,37,0,1,1,1
"2011","E00171549","E00171549","Total",105,43,19,24,4,41,24,17,15,14,0,1,0,2
"2011","E00015690","E00015690","Total",127,18,9,9,0,98,93,5,10,9,0,1,0,1
"2011","E00015691","E00015691","Total",116,8,3,5,1,100,94,6,7,7,0,0,0,0
"2011","E00015692","E00015692","Total",149,36,11,25,0,97,86,11,16,14,0,2,0,0
"2011","E00015697","E00015697","Total",126,23,6,17,1,88,83,5,11,11,0,0,0,3
"2011","E00015699","E00015699","Total",120,14,5,9,1,86,82,4,19,17,1,0,1,0
"2011","E00015681","E00015681","Total",134,64,31,33,0,4,1,3,61,55,1,4,1,5
"2011","E00015682","E00015682","Total",130,19,4,15,0,94,84,10,16,15,0,0,1,1
"2011","E00015683","E00015683","Total",85,15,5,10,0,57,30,27,13,11,0,1,1,0
"2011","E00015687","E00015687","Total",176,38,10,28,4,109,70,39,21,19,1,0,1,4
"2011","E00015693","E00015693","Total",125,33,15,18,0,75,68,7,15,15,0,0,0,2
"2011","E00015701","E00015701","Total",121,22,4,18,1,77,70,7,19,18,0,1,0,2
"2011","E00015629","E00015629","Total",118,13,4,9,0,88,25,63,16,15,0,0,1,1
"2011","E00015660","E00015660","Total",137,23,6,17,0,60,8,52,52,50,0,1,1,2
"2011","E00015661","E00015661","Total",159,58,17,41,1,3,3,0,94,89,0,5,0,3
"2011","E00015662","E00015662","Total",142,18,5,13,1,93,24,69,29,28,0,1,0,1
"2011","E00015663","E00015663","Total",129,27,9,18,0,72,19,53,29,27,1,0,1,1
"2011","E00015667","E00015667","Total",115,30,14,16,14,50,20,30,21,20,0,1,0,0
"2011","E00015698","E00015698","Total",123,19,2,17,0,94,90,4,10,7,0,2,1,0
"2011","E00015704","E00015704","Total",108,13,4,9,1,78,76,2,16,16,0,0,0,0
"2011","E00015708","E00015708","Total",119,6,2,4,2,104,29,75,7,3,4,0,0,0
"2011","E00171547","E00171547","Total",195,64,10,54,41,62,12,50,26,25,0,0,1,2
"2011","E00171548","E00171548","Total",120,31,19,12,2,60,56,4,26,25,0,1,0,1
"2011","E00015664","E00015664","Total",147,47,20,27,3,65,63,2,30,29,0,1,0,2
"2011","E00015670","E00015670","Total",113,28,20,8,1,71,60,11,12,11,1,0,0,1
"2011","E00015694","E00015694","Total",137,43,17,26,24,26,2,24,43,37,0,3,3,1
"2011","E00015696","E00015696","Total",133,26,16,10,0,75,61,14,28,23,0,4,1,4
"2011","E00015703","E00015703","Total",177,68,24,44,21,45,3,42,39,36,0,1,2,4
"2011","E00015706","E00015706","Total",204,37,17,20,24,113,69,44,29,28,0,0,1,1
"2011","E00015665","E00015665","Total",125,35,15,20,0,55,4,51,31,19,9,0,3,4
"2011","E00015672","E00015672","Total",187,81,25,56,14,15,3,12,72,70,0,2,0,5
"2011","E00015673","E00015673","Total",125,29,12,17,0,69,41,28,23,23,0,0,0,4
"2011","E00015674","E00015674","Total",129,70,36,34,0,6,2,4,52,48,1,3,0,1
"2011","E00015677","E00015677","Total",144,34,8,26,0,87,86,1,23,23,0,0,0,0
"2011","E00015678","E00015678","Total",219,117,36,81,7,15,7,8,80,75,1,4,0,0
"2011","E00015669","E00015669","Total",105,18,5,13,1,70,69,1,16,15,0,1,0,0
"2011","E00015671","E00015671","Total",118,19,4,15,1,85,85,0,13,13,0,0,0,0
"2011","E00015675","E00015675","Total",161,33,16,17,9,94,90,4,23,22,0,0,1,2
"2011","E00015676","E00015676","Total",147,31,7,24,1,81,80,1,33,33,0,0,0,1
"2011","E00015707","E00015707","Total",156,21,7,14,0,107,101,6,26,25,0,1,0,2
"2011","E00171542","E00171542","Total",192,61,21,40,26,30,2,28,74,68,0,6,0,1
"2011","E00171544","E00171544","Total",145,37,19,18,11,28,20,8,66,60,2,4,0,3
"2011","E00171545","E00171545","Total",69,4,3,1,14,31,5,26,19,16,0,1,2,1
"2011","E00015622","E00015622","Total",134,43,8,35,0,40,34,6,51,47,0,3,1,0
"2011","E00015623","E00015623","Total",208,43,12,31,16,65,10,55,84,80,1,3,0,0
"2011","E00015624","E00015624","Total",151,38,11,27,1,61,4,57,50,48,0,2,0,1
"2011","E00015628","E00015628","Total",193,67,26,41,4,54,3,51,67,62,0,3,2,1
"2011","E00015630","E00015630","Total",158,31,18,13,0,91,19,72,36,29,0,2,5,0
"2011","E00015621","E00015621","Total",119,45,18,27,1,6,0,6,66,63,0,3,0,1
"2011","E00015637","E00015637","Total",132,34,8,26,0,21,19,2,73,71,0,2,0,4
"2011","E00015640","E00015640","Total",95,45,21,24,0,9,8,1,39,35,0,4,0,2
"2011","E00015642","E00015642","Total",164,41,11,30,1,68,17,51,53,53,0,0,0,1
"2011","E00015647","E00015647","Total",111,32,12,20,1,6,1,5,71,69,1,1,0,1
"2011","E00015655","E00015655","Total",156,39,12,27,3,57,53,4,55,53,0,1,1,2
"2011","E00015788","E00015788","Total",182,41,6,35,1,103,97,6,35,35,0,0,0,2
"2011","E00015793","E00015793","Total",114,65,26,39,0,11,7,4,37,35,0,2,0,1
"2011","E00015795","E00015795","Total",115,11,6,5,0,94,43,51,5,5,0,0,0,5
"2011","E00015797","E00015797","Total",113,35,17,18,5,27,17,10,43,43,0,0,0,3
"2011","E00171526","E00171526","Total",143,70,13,57,2,9,4,5,58,51,0,6,1,4
"2011","E00171527","E00171527","Total",111,29,11,18,7,37,2,35,37,31,0,5,1,1
"2011","E00171528","E00171528","Total",92,17,7,10,12,24,9,15,39,37,0,1,1,0
"2011","E00015789","E00015789","Total",200,46,24,22,1,13,12,1,139,136,0,3,0,1
"2011","E00015790","E00015790","Total",133,33,9,24,0,59,21,38,39,38,1,0,0,2
"2011","E00015791","E00015791","Total",137,13,2,11,3,90,21,69,29,27,0,2,0,2
"2011","E00015792","E00015792","Total",181,61,28,33,3,50,13,37,64,48,14,2,0,3
"2011","E00015796","E00015796","Total",157,64,23,41,1,5,1,4,86,70,10,3,3,1
"2011","E00015620","E00015620","Total",123,16,6,10,0,92,23,69,14,13,0,0,1,1
"2011","E00015627","E00015627","Total",126,60,29,31,0,15,1,14,50,46,0,4,0,1
"2011","E00015632","E00015632","Total",112,24,5,19,0,70,16,54,18,17,0,1,0,0
"2011","E00015636","E00015636","Total",140,42,22,20,1,73,23,50,22,21,0,0,1,2
"2011","E00015639","E00015639","Total",127,7,4,3,0,104,25,79,16,16,0,0,0,0
"2011","E00171529","E00171529","Total",138,31,6,25,0,66,49,17,40,38,0,2,0,1
"2011","E00171536","E00171536","Total",401,71,30,41,77,99,5,94,147,138,4,5,0,7
"2011","E00171537","E00171537","Total",128,37,20,17,2,40,7,33,43,41,0,2,0,6
"2011","E00171538","E00171538","Total",174,25,13,12,79,47,6,41,20,19,0,1,0,3
"2011","E00171539","E00171539","Total",162,50,27,23,1,9,6,3,93,84,3,3,3,9
"2011","E00171540","E00171540","Total",153,64,32,32,3,4,0,4,75,71,2,1,1,7
"2011","E00015641","E00015641","Total",145,81,52,29,3,15,8,7,45,43,0,2,0,1
"2011","E00015643","E00015643","Total",124,28,11,17,0,72,16,56,24,23,0,0,1,0
"2011","E00015648","E00015648","Total",137,44,18,26,0,48,12,36,44,44,0,0,0,1
"2011","E00015650","E00015650","Total",143,70,28,42,0,32,18,14,37,36,0,0,1,4
"2011","E00015654","E00015654","Total",96,17,8,9,0,66,12,54,13,11,0,1,1,0
"2011","E00015625","E00015625","Total",134,17,4,13,1,89,23,66,25,24,0,0,1,2
"2011","E00015631","E00015631","Total",69,9,2,7,0,34,3,31,23,19,0,1,3,3
"2011","E00015634","E00015634","Total",150,17,3,14,2,91,23,68,38,35,1,2,0,2
"2011","E00015635","E00015635","Total",168,57,23,34,0,13,5,8,97,91,0,4,2,1
"2011","E00015638","E00015638","Total",145,70,25,45,0,23,1,22,52,50,0,1,1,0
"2011","E00015633","E00015633","Total",136,49,18,31,3,8,7,1,76,74,1,1,0,0
"2011","E00015644","E00015644","Total",136,59,24,35,0,8,1,7,67,67,0,0,0,2
"2011","E00015645","E00015645","Total",142,50,15,35,1,6,0,6,85,82,0,3,0,0
"2011","E00015652","E00015652","Total",181,41,17,24,0,30,16,14,108,102,1,3,2,2
"2011","E00015653","E00015653","Total",132,40,5,35,0,2,1,1,90,85,0,5,0,0
"2011","E00015657","E00015657","Total",151,37,14,23,2,48,31,17,63,60,1,2,0,1
"2011","E00016077","E00016077","Total",122,39,14,25,0,29,21,8,54,54,0,0,0,0
"2011","E00016083","E00016083","Total",157,27,8,19,0,113,78,35,16,16,0,0,0,1
"2011","E00016086","E00016086","Total",131,57,10,47,1,41,19,22,30,26,0,3,1,2
"2011","E00016091","E00016091","Total",124,54,19,35,0,42,40,2,26,26,0,0,0,2
"2011","E00016094","E00016094","Total",128,26,10,16,0,89,87,2,13,11,0,2,0,0
"2011","E00016071","E00016071","Total",112,27,7,20,0,65,62,3,17,16,0,1,0,3
"2011","E00016072","E00016072","Total",138,29,2,27,3,71,68,3,33,30,0,3,0,2
"2011","E00016075","E00016075","Total",139,37,14,23,3,71,68,3,25,24,0,1,0,3
"2011","E00016076","E00016076","Total",125,9,1,8,0,106,35,71,10,9,0,0,1,0
"2011","E00016078","E00016078","Total",117,23,5,18,2,70,64,6,21,18,0,1,2,1
"2011","E00015646","E00015646","Total",122,29,8,21,3,79,77,2,10,9,0,1,0,1
"2011","E00015649","E00015649","Total",126,24,6,18,1,76,74,2,22,21,0,1,0,3
"2011","E00015651","E00015651","Total",129,26,13,13,0,75,71,4,26,25,0,1,0,2
"2011","E00015656","E00015656","Total",121,12,0,12,1,72,4,68,35,34,0,0,1,1
"2011","E00015658","E00015658","Total",116,15,2,13,1,67,27,40,31,29,0,2,0,2
"2011","E00015659","E00015659","Total",110,24,8,16,0,68,67,1,17,17,0,0,0,1
"2011","E00015757","E00015757","Total",119,15,2,13,0,91,7,84,12,11,0,1,0,1
"2011","E00015758","E00015758","Total",146,14,5,9,0,109,14,95,22,21,0,1,0,1
"2011","E00015761","E00015761","Total",124,16,3,13,0,99,5,94,9,9,0,0,0,0
"2011","E00015767","E00015767","Total",114,10,2,8,0,82,7,75,19,19,0,0,0,3
"2011","E00015798","E00015798","Total",188,28,11,17,1,135,20,115,23,20,0,3,0,1
"2011","E00015755","E00015755","Total",123,37,14,23,2,59,27,32,24,22,0,0,2,1
"2011","E00015766","E00015766","Total",125,65,38,27,1,27,23,4,30,28,0,2,0,2
"2011","E00015769","E00015769","Total",118,55,16,39,0,15,4,11,47,44,0,2,1,1
"2011","E00015772","E00015772","Total",116,57,25,32,0,6,2,4,48,43,0,5,0,5
"2011","E00015776","E00015776","Total",131,70,25,45,0,25,2,23,33,30,0,2,1,3
"2011","E00015799","E00015799","Total",70,21,5,16,0,31,16,15,18,18,0,0,0,0
"2011","E00015763","E00015763","Total",139,27,13,14,0,90,82,8,21,18,0,3,0,1
"2011","E00015764","E00015764","Total",114,31,15,16,0,54,51,3,24,20,1,2,1,5
"2011","E00015765","E00015765","Total",118,22,6,16,0,3,2,1,90,88,1,1,0,3
"2011","E00015768","E00015768","Total",129,31,13,18,0,40,38,2,57,57,0,0,0,1
"2011","E00015771","E00015771","Total",119,21,7,14,0,80,26,54,18,18,0,0,0,0
"2011","E00015754","E00015754","Total",157,19,6,13,0,97,93,4,39,37,0,2,0,2
"2011","E00015759","E00015759","Total",125,19,5,14,0,89,85,4,17,16,0,0,1,0
"2011","E00015760","E00015760","Total",144,17,6,11,14,95,90,5,18,15,0,3,0,0
"2011","E00015770","E00015770","Total",133,20,8,12,0,105,66,39,8,8,0,0,0,0
"2011","E00015794","E00015794","Total",133,31,12,19,0,82,49,33,18,17,0,0,1,2
"2011","E00016073","E00016073","Total",116,14,1,13,0,55,51,4,44,44,0,0,0,3
"2011","E00016074","E00016074","Total",126,22,3,19,2,85,81,4,17,16,0,1,0,0
"2011","E00016079","E00016079","Total",150,58,9,49,0,26,6,20,64,56,0,7,1,2
"2011","E00016080","E00016080","Total",122,28,8,20,1,79,66,13,14,12,0,2,0,0
"2011","E00016089","E00016089","Total",130,19,5,14,0,86,80,6,20,16,0,4,0,5
"2011","E00016082","E00016082","Total",103,2,1,1,1,96,8,88,4,3,0,1,0,0
"2011","E00016085","E00016085","Total",104,5,0,5,0,93,19,74,4,4,0,0,0,2
"2011","E00016095","E00016095","Total",128,19,0,19,0,94,90,4,12,11,0,1,0,3
"2011","E00016098","E00016098","Total",125,20,1,19,0,80,78,2,24,24,0,0,0,1
"2011","E00016102","E00016102","Total",126,13,4,9,0,93,84,9,20,16,0,2,2,0
"2011","E00016084","E00016084","Total",151,21,6,15,0,92,91,1,38,36,0,0,2,0
"2011","E00016088","E00016088","Total",123,16,2,14,2,71,7,64,34,31,0,2,1,0
"2011","E00016090","E00016090","Total",141,38,10,28,0,25,1,24,76,73,0,3,0,2
"2011","E00016092","E00016092","Total",123,30,12,18,0,69,7,62,22,19,0,2,1,2
"2011","E00016093","E00016093","Total",128,66,16,50,0,10,3,7,52,48,1,3,0,0
"2011","E00016101","E00016101","Total",102,18,1,17,0,66,18,48,18,16,0,1,1,0
"2011","E00016081","E00016081","Total",191,33,12,21,11,116,13,103,30,28,0,0,2,1
"2011","E00016097","E00016097","Total",170,50,17,33,0,15,3,12,105,100,0,5,0,0
"2011","E00016100","E00016100","Total",137,71,33,38,0,29,1,28,35,34,0,1,0,2
"2011","E00016106","E00016106","Total",126,47,21,26,1,48,23,25,30,29,0,1,0,0
"2011","E00016108","E00016108","Total",107,37,9,28,3,53,9,44,13,13,0,0,0,1
"2011","E00016109","E00016109","Total",145,26,7,19,0,29,6,23,88,83,0,5,0,2
"2011","E00016066","E00016066","Total",101,9,2,7,0,80,78,2,12,11,0,1,0,0
"2011","E00016067","E00016067","Total",124,22,3,19,0,93,80,13,9,8,0,0,1,0
"2011","E00016087","E00016087","Total",107,17,1,16,0,83,69,14,7,6,0,1,0,0
"2011","E00016096","E00016096","Total",180,58,14,44,0,79,45,34,42,39,0,2,1,1
"2011","E00016099","E00016099","Total",114,24,9,15,0,81,76,5,9,9,0,0,0,0
"2011","E00015584","E00015584","Total",138,33,13,20,0,73,52,21,30,30,0,0,0,2
"2011","E00015585","E00015585","Total",121,34,15,19,0,53,49,4,34,32,1,1,0,0
"2011","E00015586","E00015586","Total",130,19,5,14,0,87,84,3,23,23,0,0,0,1
"2011","E00015587","E00015587","Total",179,39,9,30,1,73,64,9,64,63,0,1,0,2
"2011","E00015589","E00015589","Total",121,16,1,15,0,94,92,2,10,10,0,0,0,1
"2011","E00015594","E00015594","Total",134,34,5,29,0,73,70,3,23,20,0,2,1,4
"2011","E00015595","E00015595","Total",204,69,25,44,2,9,0,9,124,120,0,3,1,0
"2011","E00015600","E00015600","Total",111,23,10,13,2,68,66,2,18,17,0,0,1,0
"2011","E00015601","E00015601","Total",104,23,7,16,1,66,65,1,13,12,0,1,0,1
"2011","E00015603","E00015603","Total",115,29,7,22,1,61,57,4,24,21,0,3,0,0
"2011","E00015588","E00015588","Total",137,21,6,15,0,89,86,3,26,24,0,1,1,1
"2011","E00015590","E00015590","Total",160,33,10,23,6,47,40,7,72,69,0,2,1,2
"2011","E00015591","E00015591","Total",159,18,3,15,2,124,93,31,14,13,1,0,0,1
"2011","E00015592","E00015592","Total",152,44,19,25,6,70,60,10,30,30,0,0,0,2
"2011","E00015596","E00015596","Total",109,14,5,9,0,89,85,4,4,3,0,1,0,2
"2011","E00015756","E00015756","Total",135,48,17,31,0,29,10,19,57,54,0,3,0,1
"2011","E00015773","E00015773","Total",122,23,3,20,0,38,12,26,61,59,0,0,2,0
"2011","E00015774","E00015774","Total",148,33,5,28,0,78,13,65,37,32,0,2,3,0
"2011","E00015777","E00015777","Total",104,19,7,12,0,68,14,54,13,12,0,1,0,4
"2011","E00015779","E00015779","Total",136,16,2,14,0,95,18,77,24,22,0,2,0,1
"2011","E00015778","E00015778","Total",114,15,2,13,1,77,11,66,19,19,0,0,0,2
"2011","E00015781","E00015781","Total",166,19,4,15,26,95,19,76,26,23,0,1,2,0
"2011","E00015783","E00015783","Total",115,18,3,15,0,71,15,56,24,23,0,0,1,2
"2011","E00015784","E00015784","Total",138,33,7,26,0,51,6,45,50,48,0,1,1,4
"2011","E00015785","E00015785","Total",131,20,1,19,1,91,9,82,19,17,0,2,0,0
"2011","E00015354","E00015354","Total",145,43,14,29,0,76,72,4,26,23,0,3,0,0
"2011","E00015355","E00015355","Total",128,15,4,11,0,92,83,9,20,17,0,2,1,1
"2011","E00015356","E00015356","Total",168,4,1,3,0,148,11,137,16,13,0,1,2,0
"2011","E00015360","E00015360","Total",129,17,2,15,0,94,86,8,17,15,0,2,0,1
"2011","E00015362","E00015362","Total",173,23,5,18,2,133,123,10,14,13,0,1,0,1
"2011","E00015359","E00015359","Total",211,21,5,16,15,147,93,54,28,25,0,1,2,0
"2011","E00015361","E00015361","Total",140,4,2,2,6,117,111,6,10,8,0,0,2,3
"2011","E00015366","E00015366","Total",122,7,1,6,1,100,99,1,14,13,1,0,0,0
"2011","E00015368","E00015368","Total",138,16,4,12,10,85,74,11,23,22,0,0,1,4
"2011","E00015371","E00015371","Total",130,12,3,9,0,110,98,12,7,7,0,0,0,1
"2011","E00015494","E00015494","Total",130,12,3,9,0,94,79,15,22,20,0,2,0,2
"2011","E00015496","E00015496","Total",125,29,6,23,0,71,53,18,25,19,1,5,0,0
"2011","E00015497","E00015497","Total",141,28,4,24,0,95,71,24,14,11,0,3,0,4
"2011","E00015499","E00015499","Total",144,21,4,17,0,106,101,5,17,17,0,0,0,0
"2011","E00015502","E00015502","Total",145,12,3,9,1,108,105,3,22,21,0,1,0,2
"2011","E00016068","E00016068","Total",186,46,11,35,0,102,85,17,35,30,0,5,0,3
"2011","E00016069","E00016069","Total",179,55,15,40,0,73,68,5,45,41,1,2,1,6
"2011","E00016103","E00016103","Total",106,28,5,23,0,52,47,5,23,21,0,2,0,3
"2011","E00016104","E00016104","Total",117,30,9,21,1,46,43,3,39,39,0,0,0,1
"2011","E00016105","E00016105","Total",132,38,6,32,0,57,44,13,35,35,0,0,0,2
"2011","E00016070","E00016070","Total",131,20,3,17,0,101,88,13,9,8,0,1,0,1
"2011","E00016107","E00016107","Total",158,25,3,22,3,111,98,13,19,17,0,2,0,0
"2011","E00016110","E00016110","Total",142,31,6,25,1,87,84,3,21,19,0,2,0,2
"2011","E00016111","E00016111","Total",123,25,5,20,1,75,59,16,20,17,0,3,0,2
"2011","E00015574","E00015574","Total",157,49,13,36,0,47,36,11,61,55,1,4,1,0
"2011","E00015578","E00015578","Total",156,34,7,27,6,93,88,5,23,22,0,0,1,0
"2011","E00015579","E00015579","Total",152,61,18,43,2,29,14,15,59,55,0,1,3,1
"2011","E00015581","E00015581","Total",129,23,7,16,2,60,55,5,43,37,1,4,1,1
"2011","E00015583","E00015583","Total",143,23,6,17,0,89,86,3,29,29,0,0,0,2
"2011","E00015593","E00015593","Total",144,22,9,13,2,88,13,75,29,28,0,1,0,3
"2011","E00015597","E00015597","Total",150,14,2,12,0,114,17,97,19,19,0,0,0,3
"2011","E00015598","E00015598","Total",212,28,7,21,0,125,17,108,58,49,0,7,2,1
"2011","E00171521","E00171521","Total",115,2,2,0,0,112,12,100,0,0,0,0,0,1
"2011","E00171522","E00171522","Total",131,16,8,8,0,104,15,89,11,10,0,1,0,0
"2011","E00171523","E00171523","Total",120,6,5,1,0,104,10,94,7,6,0,0,1,3
"2011","E00171552","E00171552","Total",77,5,1,4,69,0,0,0,3,3,0,0,0,0
"2011","E00015605","E00015605","Total",124,16,7,9,0,91,13,78,15,13,0,2,0,2
"2011","E00015606","E00015606","Total",154,33,17,16,3,89,13,76,27,27,0,0,0,2
"2011","E00015609","E00015609","Total",116,43,20,23,1,31,3,28,39,38,0,1,0,2
"2011","E00015612","E00015612","Total",136,44,21,23,1,41,22,19,48,47,0,1,0,2
"2011","E00015614","E00015614","Total",145,59,25,34,0,28,6,22,58,56,0,1,1,0
"2011","E00015575","E00015575","Total",173,53,9,44,0,31,8,23,89,85,0,4,0,0
"2011","E00015577","E00015577","Total",151,51,17,34,0,41,26,15,53,52,0,1,0,6
"2011","E00015580","E00015580","Total",127,48,23,25,1,26,8,18,47,45,1,1,0,5
"2011","E00015611","E00015611","Total",216,60,15,45,12,12,3,9,131,125,0,6,0,1
"2011","E00015613","E00015613","Total",143,44,13,31,1,12,4,8,86,80,2,4,0,0
"2011","E00015617","E00015617","Total",116,27,9,18,1,46,10,36,42,38,0,4,0,0
"2011","E00015775","E00015775","Total",151,85,35,50,0,20,0,20,40,38,0,2,0,6
"2011","E00015780","E00015780","Total",167,19,4,15,16,92,19,73,35,33,0,0,2,5
"2011","E00015782","E00015782","Total",127,33,10,23,1,51,15,36,41,36,1,3,1,1
"2011","E00015786","E00015786","Total",140,80,33,47,0,15,1,14,43,43,0,0,0,2
"2011","E00015787","E00015787","Total",170,22,7,15,3,82,30,52,61,61,0,0,0,2
"2011","E00015353","E00015353","Total",238,16,3,13,3,202,79,123,17,16,0,1,0,0
"2011","E00015357","E00015357","Total",124,15,3,12,1,100,55,45,8,8,0,0,0,0
"2011","E00015358","E00015358","Total",145,11,3,8,2,112,106,6,17,17,0,0,0,3
"2011","E00171531","E00171531","Total",108,15,1,14,2,82,72,10,8,8,0,0,0,1
"2011","E00171532","E00171532","Total",113,9,4,5,6,70,42,28,23,23,0,0,0,5
"2011","E00015363","E00015363","Total",161,19,1,18,0,96,73,23,44,44,0,0,0,2
"2011","E00015372","E00015372","Total",137,19,5,14,0,102,70,32,15,14,0,0,1,1
"2011","E00015374","E00015374","Total",127,18,8,10,0,72,30,42,33,24,0,8,1,4
"2011","E00015375","E00015375","Total",123,18,9,9,0,90,87,3,12,11,0,1,0,3
"2011","E00015382","E00015382","Total",203,48,12,36,0,27,8,19,126,120,0,5,1,2
"2011","E00015341","E00015341","Total",126,29,5,24,9,24,12,12,63,62,0,1,0,1
"2011","E00015364","E00015364","Total",153,23,6,17,8,78,60,18,41,39,0,1,1,3
"2011","E00015367","E00015367","Total",127,35,9,26,0,70,63,7,20,18,1,1,0,2
"2011","E00015369","E00015369","Total",154,13,3,10,0,123,118,5,13,12,0,0,1,5
"2011","E00015373","E00015373","Total",108,24,8,16,1,58,46,12,25,23,0,2,0,0
"2011","E00015398","E00015398","Total",176,68,13,55,0,62,16,46,45,43,0,2,0,1
"2011","E00015399","E00015399","Total",81,3,1,2,0,70,26,44,6,5,0,0,1,2
"2011","E00015401","E00015401","Total",137,20,5,15,0,81,31,50,32,28,1,3,0,4
"2011","E00015403","E00015403","Total",112,16,1,15,1,80,34,46,15,14,0,0,1,0
"2011","E00015404","E00015404","Total",119,13,0,13,1,87,39,48,17,14,0,3,0,1
"2011","E00015400","E00015400","Total",124,20,6,14,0,88,28,60,14,11,0,0,3,2
"2011","E00015402","E00015402","Total",138,18,1,17,2,97,83,14,20,18,0,2,0,1
"2011","E00015405","E00015405","Total",136,24,8,16,0,89,55,34,22,21,0,1,0,1
"2011","E00015406","E00015406","Total",119,12,2,10,2,80,36,44,23,14,0,2,7,2
"2011","E00015407","E00015407","Total",115,23,4,19,0,77,37,40,15,12,0,2,1,0
"2011","E00015408","E00015408","Total",115,26,10,16,0,63,6,57,25,21,0,4,0,1
"2011","E00015409","E00015409","Total",129,10,3,7,1,105,14,91,12,11,0,0,1,1
"2011","E00015413","E00015413","Total",146,32,11,21,1,37,10,27,76,68,0,8,0,0
"2011","E00015414","E00015414","Total",178,50,11,39,0,31,11,20,94,75,3,16,0,3
"2011","E00015332","E00015332","Total",153,18,6,12,1,119,119,0,13,13,0,0,0,2
"2011","E00015333","E00015333","Total",114,30,6,24,9,56,47,9,18,16,0,1,1,1
"2011","E00015334","E00015334","Total",156,67,24,43,0,25,10,15,62,62,0,0,0,2
"2011","E00015335","E00015335","Total",191,69,19,50,0,24,12,12,98,96,0,2,0,0
"2011","E00015337","E00015337","Total",109,53,21,32,3,15,7,8,32,25,0,5,2,6
"2011","E00015301","E00015301","Total",149,26,8,18,0,83,2,81,40,37,0,0,3,0
"2011","E00015309","E00015309","Total",132,46,21,25,1,39,35,4,43,39,1,3,0,3
"2011","E00015311","E00015311","Total",130,38,8,30,1,2,0,2,86,81,1,3,1,3
"2011","E00015316","E00015316","Total",156,37,14,23,1,34,3,31,82,80,0,2,0,2
"2011","E00015321","E00015321","Total",143,47,17,30,1,22,14,8,72,70,0,2,0,1
"2011","E00015293","E00015293","Total",136,58,15,43,1,15,11,4,62,60,0,2,0,0
"2011","E00015297","E00015297","Total",127,37,15,22,0,70,62,8,20,19,0,1,0,0
"2011","E00015300","E00015300","Total",110,57,27,30,0,10,5,5,32,30,0,1,1,11
"2011","E00015303","E00015303","Total",114,43,15,28,0,14,11,3,56,54,0,2,0,1
"2011","E00015305","E00015305","Total",133,45,14,31,0,54,35,19,32,32,0,0,0,2
"2011","E00015306","E00015306","Total",117,28,11,17,0,71,54,17,18,18,0,0,0,0
"2011","E00015582","E00015582","Total",154,22,7,15,0,43,34,9,87,85,1,1,0,2
"2011","E00015615","E00015615","Total",160,44,19,25,0,56,5,51,59,56,0,3,0,1
"2011","E00015616","E00015616","Total",173,39,3,36,17,50,35,15,66,63,0,3,0,1
"2011","E00015618","E00015618","Total",146,51,5,46,0,57,47,10,37,35,0,2,0,1
"2011","E00015619","E00015619","Total",144,36,8,28,3,45,4,41,59,57,0,2,0,1
"2011","E00171519","E00171519","Total",142,42,15,27,0,31,18,13,67,66,0,1,0,2
"2011","E00171551","E00171551","Total",124,46,8,38,24,5,3,2,48,45,0,3,0,1
"2011","E00015576","E00015576","Total",201,49,10,39,0,87,59,28,62,59,0,2,1,3
"2011","E00015602","E00015602","Total",148,60,24,36,0,25,8,17,63,61,0,2,0,0
"2011","E00015604","E00015604","Total",145,69,25,44,1,23,15,8,51,48,1,2,0,1
"2011","E00015607","E00015607","Total",118,48,14,34,0,37,30,7,33,32,0,1,0,0
"2011","E00015608","E00015608","Total",148,71,25,46,0,21,16,5,56,52,0,3,1,0
"2011","E00015298","E00015298","Total",149,31,12,19,2,61,58,3,54,52,1,1,0,1
"2011","E00015302","E00015302","Total",95,16,5,11,0,73,69,4,6,6,0,0,0,0
"2011","E00015336","E00015336","Total",133,16,3,13,2,83,82,1,32,31,0,1,0,0
"2011","E00015339","E00015339","Total",115,39,10,29,2,49,33,16,25,25,0,0,0,0
"2011","E00015340","E00015340","Total",114,19,6,13,0,71,67,4,23,21,0,2,0,1
"2011","E00015295","E00015295","Total",116,71,35,36,0,14,10,4,29,28,0,1,0,2
"2011","E00015296","E00015296","Total",118,56,22,34,0,14,3,11,47,46,1,0,0,1
"2011","E00015299","E00015299","Total",114,59,23,36,0,20,16,4,34,31,0,2,1,1
"2011","E00015304","E00015304","Total",119,52,21,31,1,27,18,9,34,33,0,1,0,5
"2011","E00015313","E00015313","Total",93,56,16,40,3,2,2,0,32,31,1,0,0,0
"2011","E00015338","E00015338","Total",129,68,18,50,1,5,4,1,55,51,0,3,1,0
"2011","E00015307","E00015307","Total",121,67,28,39,0,5,2,3,49,48,0,1,0,0
"2011","E00015315","E00015315","Total",120,56,19,37,1,7,5,2,55,53,0,2,0,1
"2011","E00015317","E00015317","Total",112,66,28,38,0,9,5,4,37,35,0,2,0,0
"2011","E00015319","E00015319","Total",113,50,15,35,0,20,15,5,40,38,0,1,1,3
"2011","E00015324","E00015324","Total",182,56,21,35,0,19,2,17,105,102,2,1,0,2
"2011","E00171520","E00171520","Total",142,60,33,27,5,6,3,3,69,58,6,3,2,2
"2011","E00171550","E00171550","Total",155,21,8,13,28,32,4,28,66,64,0,0,2,8
"2011","E00015294","E00015294","Total",124,62,32,30,0,17,13,4,44,40,0,4,0,1
"2011","E00015308","E00015308","Total",121,43,20,23,0,40,28,12,37,34,0,3,0,1
"2011","E00015312","E00015312","Total",111,56,25,31,1,8,5,3,43,41,0,1,1,3
"2011","E00015318","E00015318","Total",118,56,30,26,0,36,35,1,26,24,0,1,1,0
"2011","E00015325","E00015325","Total",120,54,26,28,0,35,33,2,30,25,0,5,0,1
"2011","E00015314","E00015314","Total",112,27,13,14,0,38,36,2,45,43,0,2,0,2
"2011","E00015322","E00015322","Total",100,27,10,17,1,49,30,19,22,20,0,1,1,1
"2011","E00015323","E00015323","Total",106,27,12,15,2,50,43,7,26,26,0,0,0,1
"2011","E00015326","E00015326","Total",112,23,10,13,0,55,38,17,32,27,0,5,0,2
"2011","E00015329","E00015329","Total",72,23,6,17,0,1,1,0,47,44,1,2,0,1
"2011","E00015487","E00015487","Total",153,31,15,16,0,14,1,13,103,101,0,2,0,5
"2011","E00015514","E00015514","Total",123,62,29,33,0,41,34,7,19,16,0,2,1,1
"2011","E00015517","E00015517","Total",156,102,46,56,0,35,7,28,18,16,0,2,0,1
"2011","E00015519","E00015519","Total",143,92,46,46,0,39,1,38,10,9,0,0,1,2
"2011","E00015522","E00015522","Total",194,95,37,58,0,25,10,15,73,72,0,1,0,1
"2011","E00015485","E00015485","Total",158,48,13,35,0,55,7,48,54,51,0,3,0,1
"2011","E00015486","E00015486","Total",106,17,4,13,0,85,5,80,4,3,0,0,1,0
"2011","E00015515","E00015515","Total",129,47,17,30,0,61,4,57,19,17,0,2,0,2
"2011","E00015516","E00015516","Total",137,32,7,25,0,88,23,65,16,14,0,2,0,1
"2011","E00015518","E00015518","Total",168,62,19,43,2,76,6,70,28,27,0,0,1,0
"2011","E00015495","E00015495","Total",147,24,6,18,0,37,1,36,78,72,5,0,1,8
"2011","E00015498","E00015498","Total",125,6,2,4,2,98,10,88,18,15,1,1,1,1
"2011","E00015500","E00015500","Total",151,33,7,26,2,32,2,30,83,75,3,5,0,1
"2011","E00015501","E00015501","Total",116,28,7,21,0,5,0,5,83,80,0,1,2,0
"2011","E00015505","E00015505","Total",158,65,22,43,1,26,8,18,65,62,0,3,0,1
"2011","E00015506","E00015506","Total",139,43,14,29,0,37,6,31,59,56,0,3,0,0
"2011","E00015484","E00015484","Total",159,39,15,24,1,51,7,44,68,64,0,2,2,0
"2011","E00015503","E00015503","Total",141,44,9,35,2,30,11,19,63,60,0,3,0,2
"2011","E00015504","E00015504","Total",139,41,12,29,0,51,10,41,45,41,0,4,0,2
"2011","E00015508","E00015508","Total",194,60,16,44,1,45,20,25,86,80,2,2,2,2
"2011","E00015510","E00015510","Total",153,90,26,64,2,14,4,10,46,43,0,2,1,1
"2011","E00015507","E00015507","Total",114,97,43,54,1,1,0,1,14,14,0,0,0,1
"2011","E00015509","E00015509","Total",143,97,44,53,0,10,4,6,31,28,0,3,0,5
"2011","E00015511","E00015511","Total",115,85,46,39,0,2,1,1,25,25,0,0,0,3
"2011","E00015512","E00015512","Total",116,54,13,41,0,46,43,3,13,11,0,1,1,3
"2011","E00015513","E00015513","Total",146,86,41,45,0,33,6,27,27,26,0,1,0,0
"2011","E00015209","E00015209","Total",172,61,20,41,1,53,24,29,55,53,0,0,2,2
"2011","E00015210","E00015210","Total",127,50,12,38,0,47,18,29,30,30,0,0,0,0
"2011","E00015212","E00015212","Total",119,40,8,32,2,31,6,25,44,42,0,1,1,2
"2011","E00015217","E00015217","Total",151,61,15,46,0,24,8,16,60,56,1,3,0,6
"2011","E00015219","E00015219","Total",209,98,25,73,10,9,4,5,90,86,0,4,0,2
"2011","E00015221","E00015221","Total",136,49,18,31,0,43,15,28,44,41,0,3,0,0
"2011","E00015390","E00015390","Total",146,46,12,34,0,43,14,29,57,53,0,4,0,0
"2011","E00015410","E00015410","Total",152,56,18,38,3,19,4,15,73,70,0,1,2,1
"2011","E00015411","E00015411","Total",143,52,26,26,0,17,2,15,72,65,0,4,3,2
"2011","E00015412","E00015412","Total",175,91,39,52,3,33,5,28,48,45,0,3,0,0
"2011","E00015419","E00015419","Total",141,60,16,44,2,15,2,13,64,61,0,2,1,0
"2011","E00015415","E00015415","Total",166,40,11,29,12,36,24,12,78,78,0,0,0,0
"2011","E00015416","E00015416","Total",166,43,12,31,0,41,37,4,82,81,0,1,0,0
"2011","E00015418","E00015418","Total",156,51,19,32,0,7,2,5,94,91,0,2,1,4
"2011","E00015420","E00015420","Total",162,56,23,33,0,15,3,12,90,87,0,3,0,1
"2011","E00015428","E00015428","Total",169,64,11,53,0,18,6,12,86,81,0,5,0,1
"2011","E00015423","E00015423","Total",192,50,12,38,0,55,21,34,86,82,0,3,1,1
"2011","E00015425","E00015425","Total",196,53,11,42,2,54,13,41,87,83,0,4,0,0
"2011","E00015426","E00015426","Total",149,46,15,31,0,47,7,40,55,53,0,2,0,1
"2011","E00015427","E00015427","Total",145,22,9,13,2,71,55,16,50,50,0,0,0,0
"2011","E00015429","E00015429","Total",156,45,19,26,0,38,4,34,73,70,0,3,0,0
"2011","E00015394","E00015394","Total",127,51,22,29,0,14,0,14,58,55,0,3,0,4
"2011","E00015397","E00015397","Total",241,69,19,50,0,45,13,32,127,123,2,1,1,0
"2011","E00015430","E00015430","Total",147,49,18,31,0,46,3,43,50,44,0,5,1,2
"2011","E00015431","E00015431","Total",130,39,10,29,6,37,1,36,46,42,2,2,0,2
"2011","E00015434","E00015434","Total",175,59,14,45,1,49,7,42,66,61,0,3,2,0
"2011","E00015207","E00015207","Total",139,28,10,18,1,77,73,4,32,30,0,1,1,1
"2011","E00015208","E00015208","Total",178,84,35,49,4,28,13,15,59,57,0,2,0,3
"2011","E00015211","E00015211","Total",151,71,28,43,0,15,8,7,65,63,0,1,1,0
"2011","E00015213","E00015213","Total",155,52,15,37,3,48,18,30,50,49,0,0,1,2
"2011","E00015214","E00015214","Total",148,46,11,35,0,78,71,7,24,22,0,2,0,0
"2011","E00015343","E00015343","Total",136,18,9,9,11,74,61,13,31,28,0,3,0,2
"2011","E00015345","E00015345","Total",146,63,25,38,3,33,9,24,47,44,0,2,1,0
"2011","E00015384","E00015384","Total",180,36,12,24,1,51,32,19,76,72,0,4,0,16
"2011","E00015386","E00015386","Total",149,49,13,36,1,45,24,21,52,49,0,3,0,2
"2011","E00015387","E00015387","Total",162,43,10,33,1,56,45,11,59,57,0,1,1,3
"2011","E00015342","E00015342","Total",196,26,6,20,5,147,24,123,16,15,0,0,1,2
"2011","E00015378","E00015378","Total",141,23,8,15,1,110,14,96,7,6,0,1,0,0
"2011","E00015381","E00015381","Total",149,15,7,8,0,110,78,32,22,19,0,0,3,2
"2011","E00015383","E00015383","Total",159,19,1,18,0,83,7,76,52,46,0,2,4,5
"2011","E00015388","E00015388","Total",113,15,3,12,3,85,62,23,10,9,0,1,0,0
"2011","E00015391","E00015391","Total",173,56,7,49,9,42,5,37,66,65,0,1,0,0
"2011","E00015417","E00015417","Total",134,22,5,17,7,59,15,44,46,43,0,2,1,0
"2011","E00015421","E00015421","Total",119,30,14,16,2,52,18,34,33,33,0,0,0,2
"2011","E00015422","E00015422","Total",116,35,14,21,0,50,39,11,22,18,0,4,0,9
"2011","E00015424","E00015424","Total",120,60,14,46,0,34,3,31,25,24,0,1,0,1
"2011","E00015432","E00015432","Total",128,21,5,16,0,68,48,20,36,33,0,2,1,3
"2011","E00016043","E00016043","Total",63,13,8,5,0,37,30,7,12,10,0,2,0,1
"2011","E00016044","E00016044","Total",141,10,6,4,18,96,16,80,10,9,0,0,1,7
"2011","E00016045","E00016045","Total",166,22,3,19,0,76,70,6,68,65,0,0,3,0
"2011","E00016046","E00016046","Total",150,15,9,6,1,118,82,36,15,12,0,2,1,1
"2011","E00016047","E00016047","Total",125,37,13,24,5,56,49,7,27,26,0,0,1,0
"2011","E00016048","E00016048","Total",135,13,7,6,31,30,17,13,61,57,0,4,0,0
"2011","E00015250","E00015250","Total",158,54,27,27,3,44,15,29,54,50,0,3,1,3
"2011","E00015266","E00015266","Total",107,7,3,4,0,83,83,0,16,15,0,1,0,1
"2011","E00015283","E00015283","Total",175,77,25,52,0,22,21,1,74,71,0,2,1,2
"2011","E00015285","E00015285","Total",140,47,15,32,1,36,28,8,53,53,0,0,0,3
"2011","E00015288","E00015288","Total",146,48,18,30,1,41,12,29,54,52,0,2,0,2
"2011","E00015291","E00015291","Total",134,57,28,29,0,11,7,4,66,65,0,1,0,0
"2011","E00015280","E00015280","Total",124,33,7,26,0,15,9,6,74,70,1,2,1,2
"2011","E00015281","E00015281","Total",131,43,21,22,1,53,23,30,29,26,1,1,1,5
"2011","E00015282","E00015282","Total",132,17,4,13,1,88,85,3,24,24,0,0,0,2
"2011","E00015284","E00015284","Total",130,61,36,25,0,37,37,0,31,28,0,3,0,1
"2011","E00015286","E00015286","Total",126,15,3,12,2,89,85,4,19,18,0,1,0,1
"2011","E00015287","E00015287","Total",116,33,10,23,0,55,50,5,27,26,0,1,0,1
"2011","E00015320","E00015320","Total",118,16,7,9,0,91,33,58,10,10,0,0,0,1
"2011","E00015327","E00015327","Total",128,32,2,30,0,30,2,28,63,60,0,3,0,3
"2011","E00015328","E00015328","Total",125,23,6,17,1,65,62,3,36,35,0,1,0,0
"2011","E00015330","E00015330","Total",170,31,10,21,23,65,60,5,49,43,0,6,0,2
"2011","E00015331","E00015331","Total",137,22,4,18,3,87,84,3,25,25,0,0,0,0
"2011","E00015392","E00015392","Total",137,25,8,17,1,72,55,17,39,39,0,0,0,0
"2011","E00015393","E00015393","Total",182,36,14,22,0,122,110,12,24,24,0,0,0,0
"2011","E00015395","E00015395","Total",115,17,4,13,1,85,84,1,12,12,0,0,0,0
"2011","E00015396","E00015396","Total",107,18,1,17,2,72,69,3,15,14,0,0,1,0
"2011","E00015433","E00015433","Total",183,49,17,32,2,58,26,32,72,66,1,4,1,2
"2011","E00015346","E00015346","Total",140,47,19,28,0,60,23,37,32,30,0,1,1,1
"2011","E00015347","E00015347","Total",151,38,12,26,2,55,14,41,51,45,0,4,2,5
"2011","E00015348","E00015348","Total",127,56,21,35,6,27,5,22,35,35,0,0,0,3
"2011","E00015349","E00015349","Total",122,57,23,34,3,26,15,11,34,30,0,4,0,2
"2011","E00015351","E00015351","Total",145,43,12,31,5,56,19,37,41,38,0,2,1,0
"2011","E00015344","E00015344","Total",126,0,0,0,0,114,20,94,11,6,0,1,4,1
"2011","E00015350","E00015350","Total",128,21,3,18,0,87,9,78,17,16,1,0,0,3
"2011","E00015352","E00015352","Total",115,1,1,0,1,95,8,87,14,11,0,2,1,4
"2011","E00015385","E00015385","Total",116,13,5,8,1,92,6,86,9,9,0,0,0,1
"2011","E00015389","E00015389","Total",121,1,1,0,3,104,6,98,7,6,0,0,1,6
"2011","E00015370","E00015370","Total",140,11,5,6,2,9,3,6,117,114,0,2,1,1
"2011","E00015376","E00015376","Total",118,21,5,16,2,80,30,50,15,13,0,0,2,0
"2011","E00015377","E00015377","Total",195,20,8,12,5,71,14,57,97,95,0,2,0,2
"2011","E00015379","E00015379","Total",111,18,7,11,5,62,3,59,26,22,0,2,2,0
"2011","E00015380","E00015380","Total",111,17,2,15,1,74,44,30,18,17,0,0,1,1
"2011","E00015489","E00015489","Total",162,97,47,50,2,22,6,16,41,40,0,1,0,0
"2011","E00015520","E00015520","Total",163,46,19,27,0,35,19,16,80,76,0,4,0,2
"2011","E00015523","E00015523","Total",195,94,22,72,1,42,13,29,57,55,0,2,0,1
"2011","E00015524","E00015524","Total",175,69,25,44,0,57,34,23,47,47,0,0,0,2
"2011","E00171524","E00171524","Total",148,68,15,53,3,36,11,25,40,37,0,2,1,1
"2011","E00171525","E00171525","Total",161,7,1,6,31,35,4,31,88,88,0,0,0,0
"2011","E00015488","E00015488","Total",204,123,37,86,3,35,14,21,42,40,0,2,0,1
"2011","E00015490","E00015490","Total",213,80,22,58,2,28,13,15,99,99,0,0,0,4
"2011","E00015491","E00015491","Total",200,87,21,66,0,40,16,24,71,68,0,3,0,2
"2011","E00015492","E00015492","Total",142,17,9,8,0,111,104,7,12,8,0,3,1,2
"2011","E00015493","E00015493","Total",188,95,39,56,3,65,44,21,24,21,0,2,1,1
"2011","E00015525","E00015525","Total",149,55,25,30,0,55,39,16,36,35,0,1,0,3
"2011","E00015251","E00015251","Total",134,73,35,38,0,2,2,0,59,58,0,1,0,0
"2011","E00015252","E00015252","Total",100,25,9,16,0,45,2,43,28,25,0,3,0,2
"2011","E00015259","E00015259","Total",115,63,26,37,0,13,7,6,38,36,1,1,0,1
"2011","E00015262","E00015262","Total",124,69,23,46,0,1,0,1,53,52,0,1,0,1
"2011","E00015263","E00015263","Total",56,22,7,15,0,14,11,3,20,19,0,1,0,0
"2011","E00015267","E00015267","Total",127,71,30,41,0,4,1,3,52,52,0,0,0,0
"2011","E00015253","E00015253","Total",111,82,24,58,0,9,0,9,20,20,0,0,0,0
"2011","E00015261","E00015261","Total",122,94,45,49,2,6,2,4,20,20,0,0,0,0
"2011","E00015289","E00015289","Total",128,82,37,45,0,2,1,1,42,40,0,2,0,2
"2011","E00015292","E00015292","Total",119,94,37,57,0,4,3,1,20,19,0,1,0,1
"2011","E00015260","E00015260","Total",121,83,34,49,0,5,2,3,33,31,0,2,0,0
"2011","E00015264","E00015264","Total",79,11,4,7,0,55,53,2,12,11,0,1,0,1
"2011","E00015270","E00015270","Total",119,47,16,31,0,29,26,3,42,39,0,2,1,1
"2011","E00015272","E00015272","Total",122,85,49,36,0,7,5,2,30,29,0,0,1,0
"2011","E00015273","E00015273","Total",122,34,17,17,0,47,40,7,41,39,1,1,0,0
"2011","E00015257","E00015257","Total",225,85,25,60,9,15,5,10,116,116,0,0,0,0
"2011","E00015265","E00015265","Total",120,64,21,43,2,21,19,2,33,32,0,1,0,0
"2011","E00015268","E00015268","Total",135,48,22,26,0,3,0,3,84,83,0,0,1,0
"2011","E00015269","E00015269","Total",167,94,34,60,1,8,6,2,63,59,0,3,1,1
"2011","E00015274","E00015274","Total",136,65,26,39,0,17,15,2,53,49,0,2,2,1
"2011","E00015254","E00015254","Total",118,68,27,41,0,22,11,11,28,25,0,3,0,0
"2011","E00015255","E00015255","Total",112,83,34,49,0,7,5,2,21,18,0,3,0,1
"2011","E00015256","E00015256","Total",119,60,27,33,0,2,1,1,56,54,0,2,0,1
"2011","E00015258","E00015258","Total",125,82,41,41,2,18,4,14,23,22,0,1,0,0
"2011","E00015290","E00015290","Total",120,28,5,23,2,70,66,4,17,16,0,1,0,3
"2011","E00015215","E00015215","Total",136,56,16,40,1,33,16,17,46,44,0,0,2,0
"2011","E00015216","E00015216","Total",128,46,21,25,1,12,4,8,69,66,0,2,1,0
"2011","E00015218","E00015218","Total",115,64,29,35,0,16,10,6,33,32,0,1,0,2
"2011","E00015220","E00015220","Total",143,48,15,33,1,25,15,10,68,64,0,2,2,1
"2011","E00015222","E00015222","Total",150,49,9,40,5,24,8,16,71,69,1,1,0,1
"2011","E00015223","E00015223","Total",136,26,10,16,2,18,9,9,90,88,1,1,0,0
"2011","E00015228","E00015228","Total",191,51,14,37,1,17,5,12,121,118,2,0,1,1
"2011","E00016025","E00016025","Total",126,57,17,40,0,9,1,8,60,55,1,4,0,0
"2011","E00016027","E00016027","Total",156,54,13,41,1,69,19,50,32,31,0,1,0,0
"2011","E00016059","E00016059","Total",140,52,14,38,0,38,18,20,49,46,0,1,2,1
"2011","E00016060","E00016060","Total",142,46,17,29,0,61,41,20,34,33,0,1,0,1
"2011","E00016062","E00016062","Total",110,36,13,23,1,31,18,13,40,37,0,2,1,2
"2011","E00016063","E00016063","Total",153,75,23,52,1,30,8,22,47,46,0,1,0,0
"2011","E00016023","E00016023","Total",140,81,26,55,0,12,2,10,46,46,0,0,0,1
"2011","E00016026","E00016026","Total",142,66,16,50,1,7,1,6,66,63,0,2,1,2
"2011","E00016029","E00016029","Total",125,90,46,44,3,0,0,0,29,27,0,0,2,3
"2011","E00016030","E00016030","Total",140,48,22,26,4,42,5,37,42,41,0,0,1,4
"2011","E00016032","E00016032","Total",147,114,52,62,0,5,0,5,28,28,0,0,0,0
"2011","E00016021","E00016021","Total",127,31,13,18,0,32,5,27,59,58,0,1,0,5
"2011","E00016049","E00016049","Total",136,52,11,41,4,38,18,20,41,36,0,4,1,1
"2011","E00016050","E00016050","Total",154,26,12,14,0,67,40,27,58,52,0,6,0,3
"2011","E00016052","E00016052","Total",142,40,12,28,0,60,39,21,41,37,0,4,0,1
"2011","E00016053","E00016053","Total",144,62,23,39,1,40,20,20,37,31,0,6,0,4
"2011","E00016022","E00016022","Total",132,60,29,31,1,32,5,27,38,37,0,0,1,1
"2011","E00016051","E00016051","Total",150,57,17,40,3,26,2,24,63,59,0,3,1,1
"2011","E00016054","E00016054","Total",153,55,14,41,1,41,5,36,55,55,0,0,0,1
"2011","E00016055","E00016055","Total",130,73,27,46,1,15,6,9,41,38,0,3,0,0
"2011","E00016056","E00016056","Total",147,54,17,37,0,40,5,35,52,48,0,4,0,1
"2011","E00015203","E00015203","Total",144,23,6,17,1,89,77,12,30,27,0,1,2,1
"2011","E00015224","E00015224","Total",141,34,17,17,0,86,67,19,21,19,0,2,0,0
"2011","E00015225","E00015225","Total",92,20,5,15,0,55,51,4,17,16,0,1,0,0
"2011","E00015227","E00015227","Total",163,32,12,20,5,93,85,8,30,29,0,1,0,3
"2011","E00015233","E00015233","Total",123,44,13,31,0,43,7,36,33,32,0,0,1,3
"2011","E00015226","E00015226","Total",134,22,7,15,1,91,45,46,20,18,0,2,0,0
"2011","E00015229","E00015229","Total",101,41,14,27,0,30,29,1,30,29,0,1,0,0
"2011","E00015230","E00015230","Total",125,45,8,37,1,51,40,11,28,27,0,1,0,0
"2011","E00015231","E00015231","Total",140,54,18,36,2,31,22,9,53,50,0,3,0,0
"2011","E00015234","E00015234","Total",130,72,30,42,0,21,6,15,36,34,0,2,0,1
"2011","E00015235","E00015235","Total",140,73,22,51,2,21,5,16,44,40,0,3,1,0
"2011","E00015237","E00015237","Total",128,55,18,37,1,10,3,7,61,59,1,1,0,1
"2011","E00015239","E00015239","Total",147,62,18,44,1,50,44,6,30,28,0,2,0,4
"2011","E00015240","E00015240","Total",147,49,7,42,0,48,5,43,49,47,0,2,0,1
"2011","E00015241","E00015241","Total",239,28,9,19,34,73,71,2,101,94,0,3,4,3
"2011","E00015244","E00015244","Total",192,81,23,58,2,16,0,16,86,80,0,4,2,7
"2011","E00015248","E00015248","Total",210,59,11,48,33,47,15,32,69,63,1,5,0,2
"2011","E00015232","E00015232","Total",147,43,8,35,0,44,42,2,59,54,3,2,0,1
"2011","E00015236","E00015236","Total",126,27,5,22,1,73,72,1,23,20,2,0,1,2
"2011","E00015238","E00015238","Total",132,29,7,22,1,86,83,3,15,14,0,0,1,1
"2011","E00015242","E00015242","Total",151,18,2,16,1,84,62,22,48,46,0,0,2,0
"2011","E00015245","E00015245","Total",104,17,5,12,0,71,67,4,15,15,0,0,0,1
"2011","E00015247","E00015247","Total",106,20,5,15,0,68,62,6,18,17,0,1,0,0
"2011","E00015204","E00015204","Total",147,63,22,41,9,41,9,32,32,32,0,0,0,2
"2011","E00015205","E00015205","Total",166,82,24,58,1,11,5,6,72,68,0,4,0,0
"2011","E00015206","E00015206","Total",133,21,5,16,16,85,15,70,11,8,0,1,2,0
"2011","E00015243","E00015243","Total",120,10,3,7,0,99,94,5,11,11,0,0,0,0
"2011","E00015246","E00015246","Total",124,58,18,40,2,41,7,34,22,21,0,1,0,1
"2011","E00015249","E00015249","Total",152,67,21,46,1,30,28,2,52,51,0,1,0,2
"2011","E00015825","E00015825","Total",109,39,10,29,0,18,1,17,52,51,0,1,0,0
"2011","E00015826","E00015826","Total",127,16,2,14,0,83,23,60,27,26,0,1,0,1
"2011","E00015828","E00015828","Total",151,37,8,29,0,27,4,23,84,80,0,4,0,3
"2011","E00015831","E00015831","Total",121,64,31,33,0,25,7,18,31,29,0,1,1,1
"2011","E00015832","E00015832","Total",111,44,12,32,1,20,3,17,44,44,0,0,0,2
"2011","E00015835","E00015835","Total",116,56,19,37,5,8,3,5,46,46,0,0,0,1
"2011","E00015827","E00015827","Total",93,25,9,16,7,30,18,12,30,26,0,3,1,1
"2011","E00015829","E00015829","Total",115,22,4,18,0,69,62,7,24,24,0,0,0,0
"2011","E00015830","E00015830","Total",102,20,5,15,3,56,36,20,20,20,0,0,0,3
"2011","E00015833","E00015833","Total",119,35,15,20,0,8,7,1,74,69,0,3,2,2
"2011","E00015834","E00015834","Total",133,39,8,31,2,50,22,28,40,39,0,1,0,2
"2011","E00015842","E00015842","Total",114,30,9,21,0,52,50,2,30,29,0,1,0,2
"2011","E00015939","E00015939","Total",117,56,26,30,0,20,1,19,40,36,0,3,1,1
"2011","E00015940","E00015940","Total",135,40,17,23,0,63,17,46,30,29,0,0,1,2
"2011","E00015941","E00015941","Total",123,6,2,4,0,96,20,76,21,19,0,0,2,0
"2011","E00015943","E00015943","Total",120,18,7,11,0,77,18,59,25,17,0,0,8,0
"2011","E00015948","E00015948","Total",104,11,7,4,0,80,17,63,11,7,1,0,3,2
"2011","E00015942","E00015942","Total",126,7,2,5,0,98,30,68,20,17,1,0,2,1
"2011","E00015945","E00015945","Total",106,23,10,13,0,65,63,2,18,17,0,0,1,0
"2011","E00015947","E00015947","Total",104,9,3,6,0,86,25,61,7,7,0,0,0,2
"2011","E00015949","E00015949","Total",106,15,2,13,1,71,64,7,17,15,0,0,2,2
"2011","E00015950","E00015950","Total",116,8,2,6,2,97,25,72,7,6,0,1,0,2
"2011","E00015951","E00015951","Total",148,22,8,14,0,104,29,75,21,17,0,1,3,1
"2011","E00015952","E00015952","Total",150,35,11,24,2,97,28,69,14,14,0,0,0,2
"2011","E00015956","E00015956","Total",136,13,5,8,1,94,22,72,27,24,0,0,3,1
"2011","E00015957","E00015957","Total",127,8,1,7,2,105,25,80,10,9,0,0,1,2
"2011","E00015963","E00015963","Total",137,22,10,12,0,89,25,64,26,24,0,1,1,0
"2011","E00015964","E00015964","Total",132,37,12,25,2,43,7,36,48,46,1,0,1,2
"2011","E00015271","E00015271","Total",123,54,12,42,0,17,12,5,52,51,0,1,0,0
"2011","E00015275","E00015275","Total",125,36,10,26,0,31,31,0,56,53,0,3,0,2
"2011","E00015276","E00015276","Total",115,47,12,35,0,12,11,1,56,55,0,1,0,0
"2011","E00015277","E00015277","Total",113,20,7,13,0,82,81,1,10,10,0,0,0,1
"2011","E00015278","E00015278","Total",115,22,6,16,1,71,68,3,21,20,0,0,1,0
"2011","E00015279","E00015279","Total",129,25,5,20,1,69,65,4,34,31,0,2,1,0
"2011","E00015959","E00015959","Total",111,53,19,34,0,21,15,6,36,34,0,2,0,1
"2011","E00015961","E00015961","Total",88,24,10,14,0,44,41,3,17,14,0,2,1,3
"2011","E00015965","E00015965","Total",123,91,24,67,0,3,1,2,28,28,0,0,0,1
"2011","E00015968","E00015968","Total",122,22,10,12,0,74,17,57,22,21,0,1,0,4
"2011","E00015970","E00015970","Total",116,76,28,48,1,14,5,9,25,23,0,1,1,0
"2011","E00015977","E00015977","Total",105,22,5,17,1,58,7,51,22,21,0,0,1,2
"2011","E00015958","E00015958","Total",120,49,14,35,3,46,5,41,21,19,0,2,0,1
"2011","E00015969","E00015969","Total",111,65,16,49,0,8,2,6,36,34,1,1,0,2
"2011","E00015972","E00015972","Total",125,65,31,34,0,31,1,30,28,26,0,2,0,1
"2011","E00015976","E00015976","Total",108,89,33,56,1,3,1,2,14,13,0,1,0,1
"2011","E00015978","E00015978","Total",113,91,38,53,0,7,0,7,15,14,0,1,0,0
"2011","E00015937","E00015937","Total",116,80,22,58,4,3,1,2,27,24,0,2,1,2
"2011","E00015938","E00015938","Total",104,69,16,53,0,0,0,0,35,34,0,1,0,0
"2011","E00015973","E00015973","Total",110,42,13,29,0,45,23,22,22,21,0,1,0,1
"2011","E00015974","E00015974","Total",106,57,16,41,0,5,1,4,43,42,0,1,0,1
"2011","E00015975","E00015975","Total",94,43,11,32,1,27,0,27,23,23,0,0,0,0
"2011","E00015979","E00015979","Total",100,68,15,53,0,5,1,4,27,25,0,2,0,0
"2011","E00015980","E00015980","Total",107,53,14,39,1,24,0,24,26,23,0,1,2,3
"2011","E00015944","E00015944","Total",102,59,20,39,0,5,3,2,37,35,0,2,0,1
"2011","E00015946","E00015946","Total",91,35,10,25,0,8,5,3,48,46,0,0,2,0
"2011","E00015953","E00015953","Total",98,39,23,16,2,36,32,4,19,18,0,1,0,2
"2011","E00015954","E00015954","Total",94,55,23,32,0,8,1,7,31,30,0,1,0,0
"2011","E00015960","E00015960","Total",113,10,1,9,0,94,22,72,9,8,0,1,0,0
"2011","E00015955","E00015955","Total",132,88,41,47,0,19,5,14,25,24,0,1,0,0
"2011","E00015962","E00015962","Total",113,74,27,47,0,4,3,1,35,34,0,1,0,0
"2011","E00015966","E00015966","Total",113,71,35,36,0,17,3,14,25,22,0,3,0,0
"2011","E00015967","E00015967","Total",114,31,12,19,0,65,55,10,18,17,0,1,0,0
"2011","E00015971","E00015971","Total",116,81,42,39,0,16,4,12,15,14,0,1,0,4
"2011","E00015800","E00015800","Total",156,58,21,37,0,65,56,9,31,29,0,2,0,2
"2011","E00015802","E00015802","Total",137,42,15,27,0,71,57,14,23,22,1,0,0,1
"2011","E00015841","E00015841","Total",123,43,15,28,8,46,44,2,23,21,0,2,0,3
"2011","E00015844","E00015844","Total",120,25,5,20,0,81,77,4,12,12,0,0,0,2
"2011","E00016028","E00016028","Total",121,30,15,15,0,78,71,7,12,11,0,1,0,1
"2011","E00016031","E00016031","Total",140,16,2,14,0,102,99,3,19,16,2,1,0,3
"2011","E00016033","E00016033","Total",145,31,8,23,0,93,46,47,19,17,0,1,1,2
"2011","E00016036","E00016036","Total",135,34,10,24,0,84,72,12,15,15,0,0,0,2
"2011","E00171530","E00171530","Total",142,57,7,50,1,28,22,6,53,52,0,1,0,3
"2011","E00171541","E00171541","Total",132,56,10,46,17,22,6,16,36,35,0,1,0,1
"2011","E00016038","E00016038","Total",147,25,6,19,2,94,8,86,26,25,0,0,1,0
"2011","E00016039","E00016039","Total",151,26,7,19,2,99,18,81,20,18,0,2,0,4
"2011","E00016040","E00016040","Total",184,37,8,29,1,121,18,103,25,23,0,1,1,0
"2011","E00016041","E00016041","Total",196,21,4,17,0,151,19,132,23,18,0,1,4,1
"2011","E00016042","E00016042","Total",151,21,8,13,0,38,6,32,92,92,0,0,0,0
"2011","E00016020","E00016020","Total",167,13,1,12,1,145,12,133,7,7,0,0,0,1
"2011","E00016034","E00016034","Total",134,68,26,42,16,24,1,23,25,25,0,0,0,1
"2011","E00016035","E00016035","Total",156,35,6,29,2,83,19,64,36,34,0,1,1,0
"2011","E00016037","E00016037","Total",151,31,9,22,1,107,18,89,12,11,0,1,0,0
"2011","E00016057","E00016057","Total",135,28,6,22,0,89,85,4,18,18,0,0,0,0
"2011","E00016058","E00016058","Total",132,13,3,10,0,105,101,4,13,13,0,0,0,1
"2011","E00016061","E00016061","Total",132,29,9,20,1,82,60,22,19,19,0,0,0,1
"2011","E00016064","E00016064","Total",122,10,0,10,0,99,97,2,13,13,0,0,0,0
"2011","E00016065","E00016065","Total",133,17,6,11,0,106,81,25,10,8,0,2,0,0
"2011","E00015981","E00015981","Total",112,34,14,20,0,55,2,53,23,23,0,0,0,0
"2011","E00016011","E00016011","Total",190,72,22,50,0,33,10,23,84,80,0,4,0,1
"2011","E00016015","E00016015","Total",150,35,12,23,0,24,2,22,90,89,0,1,0,1
"2011","E00016016","E00016016","Total",177,56,5,51,0,54,6,48,67,66,0,1,0,0
"2011","E00016017","E00016017","Total",168,28,14,14,1,76,56,20,63,62,0,1,0,0
"2011","E00016018","E00016018","Total",138,37,11,26,13,13,3,10,73,72,0,1,0,2
"2011","E00015982","E00015982","Total",156,93,54,39,0,22,5,17,39,36,0,3,0,2
"2011","E00015989","E00015989","Total",159,35,6,29,6,89,85,4,27,26,0,1,0,2
"2011","E00015991","E00015991","Total",142,70,24,46,1,42,32,10,27,25,0,2,0,2
"2011","E00015993","E00015993","Total",132,63,22,41,0,40,10,30,23,23,0,0,0,6
"2011","E00016019","E00016019","Total",123,79,37,42,0,11,5,6,33,32,0,1,0,0
"2011","E00016000","E00016000","Total",127,11,2,9,0,99,6,93,16,15,0,1,0,1
"2011","E00016001","E00016001","Total",105,7,1,6,1,86,2,84,11,11,0,0,0,0
"2011","E00016002","E00016002","Total",164,41,13,28,0,72,40,32,50,48,0,1,1,1
"2011","E00016004","E00016004","Total",130,9,4,5,0,108,7,101,10,10,0,0,0,3
"2011","E00016009","E00016009","Total",121,0,0,0,0,110,12,98,10,9,0,1,0,1
"2011","E00015984","E00015984","Total",207,99,30,69,4,46,8,38,57,53,0,4,0,1
"2011","E00015999","E00015999","Total",119,42,11,31,0,32,8,24,45,42,0,3,0,0
"2011","E00016006","E00016006","Total",210,108,35,73,11,32,5,27,59,54,0,4,1,0
"2011","E00016008","E00016008","Total",190,51,12,39,1,92,26,66,46,42,0,3,1,0
"2011","E00016012","E00016012","Total",158,63,18,45,0,63,44,19,32,29,0,2,1,0
"2011","E00016013","E00016013","Total",187,83,22,61,0,51,14,37,52,46,0,4,2,1
"2011","E00015998","E00015998","Total",177,87,25,62,8,32,19,13,49,48,0,1,0,1
"2011","E00016003","E00016003","Total",110,72,25,47,0,1,0,1,36,34,0,2,0,1
"2011","E00016005","E00016005","Total",123,73,23,50,0,37,31,6,13,12,0,1,0,0
"2011","E00016007","E00016007","Total",136,117,56,61,1,2,0,2,15,14,0,1,0,1
"2011","E00016010","E00016010","Total",131,91,59,32,0,10,2,8,28,26,0,2,0,2
"2011","E00016014","E00016014","Total",120,95,64,31,0,10,0,10,13,10,0,3,0,2
"2011","E00015804","E00015804","Total",145,76,28,48,8,3,1,2,55,51,2,1,1,3
"2011","E00015810","E00015810","Total",154,63,25,38,5,36,26,10,48,48,0,0,0,2
"2011","E00015812","E00015812","Total",124,90,41,49,0,10,9,1,23,20,0,3,0,1
"2011","E00015836","E00015836","Total",103,39,11,28,0,9,7,2,55,54,0,1,0,0
"2011","E00015838","E00015838","Total",103,34,10,24,0,0,0,0,67,67,0,0,0,2
"2011","E00015845","E00015845","Total",110,65,24,41,0,0,0,0,45,44,0,1,0,0
"2011","E00015801","E00015801","Total",136,50,19,31,0,5,2,3,78,74,0,4,0,3
"2011","E00015805","E00015805","Total",112,40,7,33,0,29,4,25,42,40,0,0,2,1
"2011","E00015814","E00015814","Total",113,69,25,44,0,12,9,3,31,30,0,0,1,1
"2011","E00015843","E00015843","Total",128,76,30,46,0,11,6,5,41,37,1,3,0,0
"2011","E00015847","E00015847","Total",128,64,25,39,0,35,3,32,28,25,0,2,1,1
"2011","E00015803","E00015803","Total",133,55,13,42,0,35,33,2,41,38,0,3,0,2
"2011","E00015817","E00015817","Total",135,46,15,31,0,58,55,3,30,29,0,1,0,1
"2011","E00015821","E00015821","Total",160,52,12,40,1,73,70,3,34,31,0,3,0,0
"2011","E00015823","E00015823","Total",150,57,15,42,0,60,59,1,33,32,0,1,0,0
"2011","E00015824","E00015824","Total",146,48,7,41,0,63,63,0,35,33,0,2,0,0
"2011","E00015809","E00015809","Total",127,67,18,49,2,11,4,7,46,43,0,3,0,1
"2011","E00015813","E00015813","Total",119,47,17,30,0,13,5,8,58,53,0,3,2,1
"2011","E00015837","E00015837","Total",124,61,27,34,0,24,2,22,38,36,0,2,0,1
"2011","E00015839","E00015839","Total",111,70,31,39,0,3,2,1,38,38,0,0,0,0
"2011","E00015840","E00015840","Total",87,42,8,34,1,10,3,7,34,29,0,5,0,0
"2011","E00015846","E00015846","Total",121,80,20,60,2,0,0,0,39,39,0,0,0,0
"2011","E00015890","E00015890","Total",117,18,3,15,3,84,77,7,10,10,0,0,0,2
"2011","E00015909","E00015909","Total",148,45,11,34,2,47,33,14,52,51,0,1,0,2
"2011","E00015912","E00015912","Total",151,19,3,16,0,92,56,36,37,35,0,2,0,3
"2011","E00015915","E00015915","Total",122,42,15,27,3,19,11,8,58,55,0,2,1,0
"2011","E00015919","E00015919","Total",159,21,3,18,9,107,59,48,19,19,0,0,0,3
"2011","E00015920","E00015920","Total",123,20,7,13,2,76,75,1,24,22,0,2,0,1
"2011","E00015551","E00015551","Total",152,54,13,41,2,44,2,42,50,46,0,3,1,2
"2011","E00015552","E00015552","Total",172,13,3,10,0,137,105,32,21,17,0,3,1,1
"2011","E00015553","E00015553","Total",132,78,26,52,3,24,18,6,24,23,0,1,0,3
"2011","E00015554","E00015554","Total",159,68,14,54,0,27,6,21,62,61,0,1,0,2
"2011","E00015555","E00015555","Total",142,45,16,29,0,47,2,45,47,43,0,4,0,3
"2011","E00015556","E00015556","Total",133,55,10,45,0,24,10,14,54,54,0,0,0,0
"2011","E00015557","E00015557","Total",127,91,30,61,0,4,0,4,30,30,0,0,0,2
"2011","E00015558","E00015558","Total",162,69,16,53,0,35,13,22,57,56,0,1,0,1
"2011","E00015559","E00015559","Total",132,70,20,50,1,8,5,3,53,51,0,2,0,0
"2011","E00015560","E00015560","Total",109,77,29,48,0,10,5,5,19,16,2,1,0,3
"2011","E00015807","E00015807","Total",176,49,16,33,0,23,7,16,101,100,0,1,0,3
"2011","E00015808","E00015808","Total",162,51,17,34,0,67,26,41,40,40,0,0,0,4
"2011","E00015811","E00015811","Total",156,56,10,46,0,36,9,27,62,62,0,0,0,2
"2011","E00015818","E00015818","Total",129,64,15,49,0,14,3,11,51,46,0,5,0,0
"2011","E00015819","E00015819","Total",142,72,27,45,0,32,10,22,36,35,0,1,0,2
"2011","E00015806","E00015806","Total",110,86,46,40,2,1,1,0,19,17,2,0,0,2
"2011","E00015815","E00015815","Total",119,72,27,45,1,20,19,1,24,22,0,1,1,2
"2011","E00015816","E00015816","Total",149,70,19,51,3,42,37,5,31,28,2,1,0,3
"2011","E00015820","E00015820","Total",128,45,9,36,0,48,47,1,35,30,0,5,0,0
"2011","E00015822","E00015822","Total",113,54,13,41,1,26,25,1,32,30,0,1,1,0
"2011","E00015911","E00015911","Total",154,57,17,40,1,14,5,9,80,78,0,0,2,2
"2011","E00015914","E00015914","Total",123,53,15,38,2,11,2,9,57,56,0,1,0,0
"2011","E00015917","E00015917","Total",131,57,22,35,1,21,4,17,51,51,0,0,0,1
"2011","E00015918","E00015918","Total",135,73,37,36,7,4,0,4,48,46,0,2,0,3
"2011","E00015922","E00015922","Total",120,91,46,45,1,4,4,0,22,18,0,2,2,2
"2011","E00015928","E00015928","Total",98,57,20,37,1,2,1,1,38,36,0,2,0,0
"2011","E00015443","E00015443","Total",125,72,21,51,0,15,4,11,38,37,0,0,1,0
"2011","E00015475","E00015475","Total",127,50,8,42,3,3,2,1,69,68,0,1,0,2
"2011","E00015476","E00015476","Total",132,86,24,62,1,5,4,1,39,34,0,5,0,1
"2011","E00015477","E00015477","Total",127,64,13,51,0,19,8,11,44,42,0,2,0,0
"2011","E00015478","E00015478","Total",149,88,21,67,0,19,8,11,42,38,0,2,2,0
"2011","E00015436","E00015436","Total",122,48,11,37,0,45,32,13,24,22,1,1,0,5
"2011","E00015438","E00015438","Total",136,75,21,54,0,5,5,0,55,54,0,1,0,1
"2011","E00015440","E00015440","Total",128,42,7,35,1,40,33,7,44,42,0,2,0,1
"2011","E00015447","E00015447","Total",100,25,7,18,1,48,43,5,23,20,0,1,2,3
"2011","E00015451","E00015451","Total",123,34,6,28,0,58,41,17,31,30,0,1,0,0
"2011","E00015479","E00015479","Total",132,20,10,10,0,93,72,21,17,17,0,0,0,2
"2011","E00015527","E00015527","Total",122,59,20,39,1,19,6,13,43,36,0,5,2,0
"2011","E00015528","E00015528","Total",131,65,24,41,0,29,3,26,36,33,0,2,1,1
"2011","E00015562","E00015562","Total",108,35,6,29,0,53,44,9,20,19,0,1,0,0
"2011","E00015563","E00015563","Total",145,20,6,14,0,26,4,22,96,93,2,0,1,3
"2011","E00015565","E00015565","Total",104,30,13,17,0,46,28,18,28,28,0,0,0,0
"2011","E00015567","E00015567","Total",158,33,7,26,6,21,5,16,95,94,0,0,1,3
"2011","E00015983","E00015983","Total",120,66,23,43,7,6,4,2,41,39,0,2,0,0
"2011","E00015985","E00015985","Total",168,60,13,47,4,34,8,26,70,69,0,1,0,0
"2011","E00015987","E00015987","Total",149,94,32,62,1,0,0,0,53,46,0,7,0,1
"2011","E00015990","E00015990","Total",215,35,9,26,1,75,5,70,104,98,1,4,1,0
"2011","E00015992","E00015992","Total",179,67,14,53,2,34,17,17,72,71,0,1,0,4
"2011","E00015997","E00015997","Total",189,31,11,20,1,20,8,12,137,133,0,4,0,0
"2011","E00015986","E00015986","Total",135,104,46,58,1,11,6,5,19,18,0,1,0,0
"2011","E00015988","E00015988","Total",124,105,42,63,0,3,1,2,13,13,0,0,0,3
"2011","E00015994","E00015994","Total",125,82,35,47,1,15,4,11,24,21,0,2,1,3
"2011","E00015995","E00015995","Total",146,73,34,39,0,19,10,9,53,49,0,4,0,1
"2011","E00015996","E00015996","Total",151,83,26,57,0,27,7,20,41,39,0,2,0,0
"2011","E00015712","E00015712","Total",112,58,27,31,0,15,10,5,39,36,0,1,2,0
"2011","E00015713","E00015713","Total",130,68,24,44,1,21,4,17,40,39,0,1,0,0
"2011","E00015732","E00015732","Total",122,48,23,25,0,51,3,48,21,20,0,0,1,2
"2011","E00015734","E00015734","Total",144,128,65,63,0,6,6,0,7,5,0,1,1,3
"2011","E00015738","E00015738","Total",126,59,24,35,0,21,8,13,45,43,0,0,2,1
"2011","E00015733","E00015733","Total",122,41,14,27,0,53,34,19,26,24,0,2,0,2
"2011","E00015735","E00015735","Total",159,63,26,37,1,12,7,5,82,79,0,2,1,1
"2011","E00015736","E00015736","Total",123,37,15,22,1,56,33,23,27,26,1,0,0,2
"2011","E00015737","E00015737","Total",185,66,34,32,1,12,1,11,103,97,2,3,1,3
"2011","E00015739","E00015739","Total",119,46,12,34,0,10,4,6,61,57,0,3,1,2
"2011","E00015740","E00015740","Total",133,59,19,40,0,11,10,1,63,63,0,0,0,0
"2011","E00015741","E00015741","Total",96,63,24,39,0,4,4,0,28,28,0,0,0,1
"2011","E00015742","E00015742","Total",146,82,35,47,0,7,3,4,54,51,0,3,0,3
"2011","E00015743","E00015743","Total",128,48,19,29,0,33,33,0,46,46,0,0,0,1
"2011","E00015744","E00015744","Total",117,42,22,20,0,43,5,38,29,29,0,0,0,3
"2011","E00015745","E00015745","Total",201,75,24,51,1,4,2,2,121,116,0,4,1,0
"2011","E00015908","E00015908","Total",179,43,15,28,2,14,3,11,119,115,1,2,1,1
"2011","E00015910","E00015910","Total",134,53,12,41,0,20,3,17,59,56,0,3,0,2
"2011","E00015913","E00015913","Total",174,95,19,76,1,2,0,2,74,68,0,4,2,2
"2011","E00015916","E00015916","Total",134,73,20,53,0,0,0,0,59,53,0,5,1,2
"2011","E00015924","E00015924","Total",146,14,8,6,0,7,2,5,125,123,0,2,0,0
"2011","E00015929","E00015929","Total",162,52,16,36,0,17,4,13,92,90,0,2,0,1
"2011","E00015921","E00015921","Total",122,90,42,48,3,3,0,3,24,23,0,1,0,2
"2011","E00015923","E00015923","Total",106,79,37,42,1,3,0,3,23,21,0,2,0,0
"2011","E00015927","E00015927","Total",120,67,20,47,1,9,4,5,40,38,0,2,0,3
"2011","E00015931","E00015931","Total",143,73,28,45,0,30,9,21,40,40,0,0,0,0
"2011","E00015932","E00015932","Total",143,36,8,28,0,4,2,2,102,101,1,0,0,1
"2011","E00015934","E00015934","Total",116,52,16,36,0,24,18,6,38,37,0,1,0,2
"2011","E00015526","E00015526","Total",122,90,33,57,0,6,5,1,23,22,0,0,1,3
"2011","E00015561","E00015561","Total",118,70,26,44,0,20,17,3,27,26,0,1,0,1
"2011","E00015566","E00015566","Total",127,70,36,34,1,43,42,1,12,12,0,0,0,1
"2011","E00015568","E00015568","Total",129,66,18,48,0,18,6,12,43,41,0,2,0,2
"2011","E00015572","E00015572","Total",98,58,19,39,0,16,1,15,22,22,0,0,0,2
"2011","E00015529","E00015529","Total",123,74,23,51,1,15,5,10,33,32,0,1,0,0
"2011","E00015564","E00015564","Total",122,66,21,45,0,20,5,15,35,31,0,4,0,1
"2011","E00015569","E00015569","Total",149,64,19,45,0,18,7,11,67,65,0,2,0,0
"2011","E00015570","E00015570","Total",145,78,18,60,1,26,7,19,40,37,0,2,1,0
"2011","E00015573","E00015573","Total",134,75,21,54,7,13,2,11,38,37,0,0,1,1
"2011","E00015530","E00015530","Total",138,122,54,68,2,3,2,1,11,11,0,0,0,0
"2011","E00015536","E00015536","Total",123,77,21,56,0,14,6,8,30,30,0,0,0,2
"2011","E00015537","E00015537","Total",133,94,40,54,1,23,9,14,14,14,0,0,0,1
"2011","E00015540","E00015540","Total",102,69,31,38,1,4,3,1,28,28,0,0,0,0
"2011","E00015542","E00015542","Total",113,52,19,33,1,44,39,5,15,14,0,0,1,1
"2011","E00015571","E00015571","Total",88,27,14,13,0,51,43,8,10,10,0,0,0,0
"2011","E00015894","E00015894","Total",79,52,21,31,0,4,1,3,23,23,0,0,0,0
"2011","E00015895","E00015895","Total",153,93,29,64,2,3,2,1,55,55,0,0,0,0
"2011","E00015898","E00015898","Total",182,101,33,68,0,19,8,11,60,60,0,0,0,2
"2011","E00015902","E00015902","Total",126,70,34,36,2,5,1,4,46,43,0,2,1,3
"2011","E00015935","E00015935","Total",154,108,49,59,7,9,8,1,28,27,0,1,0,2
"2011","E00015891","E00015891","Total",127,38,16,22,1,65,59,6,21,21,0,0,0,2
"2011","E00015892","E00015892","Total",114,7,4,3,3,79,47,32,25,22,0,0,3,0
"2011","E00015897","E00015897","Total",136,22,8,14,1,108,88,20,5,4,0,0,1,0
"2011","E00015925","E00015925","Total",119,43,12,31,27,6,3,3,42,42,0,0,0,1
"2011","E00015926","E00015926","Total",178,95,26,69,6,31,20,11,46,45,0,1,0,0
"2011","E00015930","E00015930","Total",112,62,30,32,0,1,0,1,38,36,0,2,0,11
"2011","E00015437","E00015437","Total",196,40,7,33,17,114,72,42,25,24,0,1,0,0
"2011","E00015444","E00015444","Total",91,41,13,28,0,37,24,13,12,10,1,1,0,1
"2011","E00015481","E00015481","Total",123,48,18,30,2,56,54,2,17,16,1,0,0,0
"2011","E00015482","E00015482","Total",158,20,5,15,18,113,56,57,6,4,0,0,2,1
"2011","E00015483","E00015483","Total",98,16,6,10,1,70,67,3,11,9,0,2,0,0
"2011","E00015439","E00015439","Total",118,49,9,40,0,45,42,3,23,20,0,1,2,1
"2011","E00015446","E00015446","Total",122,40,14,26,0,50,16,34,30,28,0,1,1,2
"2011","E00015448","E00015448","Total",108,57,13,44,0,29,26,3,22,22,0,0,0,0
"2011","E00015450","E00015450","Total",99,22,7,15,0,51,46,5,26,25,0,0,1,0
"2011","E00015452","E00015452","Total",119,47,10,37,0,46,42,4,24,23,0,1,0,2
"2011","E00015454","E00015454","Total",91,62,28,34,2,16,15,1,10,9,0,0,1,1
"2011","E00015531","E00015531","Total",106,49,22,27,0,32,26,6,25,24,0,1,0,0
"2011","E00015532","E00015532","Total",109,28,10,18,0,63,47,16,17,15,0,1,1,1
"2011","E00015533","E00015533","Total",101,52,16,36,2,34,25,9,12,10,0,2,0,1
"2011","E00015534","E00015534","Total",96,23,6,17,2,50,49,1,21,17,0,3,1,0
"2011","E00015538","E00015538","Total",111,31,8,23,0,59,47,12,18,15,0,1,2,3
"2011","E00015541","E00015541","Total",128,56,14,42,0,47,40,7,25,23,0,2,0,0
"2011","E00015535","E00015535","Total",103,11,1,10,1,84,43,41,7,7,0,0,0,0
"2011","E00015539","E00015539","Total",111,45,14,31,0,48,40,8,14,13,0,0,1,4
"2011","E00015543","E00015543","Total",117,32,10,22,0,74,69,5,10,8,0,0,2,1
"2011","E00015544","E00015544","Total",108,37,14,23,0,63,56,7,8,6,0,0,2,0
"2011","E00015549","E00015549","Total",208,79,16,63,16,65,11,54,47,45,1,0,1,1
"2011","E00015545","E00015545","Total",123,29,6,23,0,68,57,11,26,24,0,2,0,0
"2011","E00015546","E00015546","Total",112,17,3,14,1,77,53,24,15,14,0,1,0,2
"2011","E00015547","E00015547","Total",121,50,20,30,1,36,33,3,32,31,0,1,0,2
"2011","E00015548","E00015548","Total",135,27,6,21,0,79,75,4,28,28,0,0,0,1
"2011","E00015550","E00015550","Total",120,17,4,13,0,86,81,5,16,16,0,0,0,1
"2011","E00015714","E00015714","Total",173,51,12,39,0,43,17,26,79,79,0,0,0,0
"2011","E00015715","E00015715","Total",109,51,13,38,1,1,0,1,56,55,0,1,0,0
"2011","E00015719","E00015719","Total",146,59,18,41,3,20,11,9,63,60,1,2,0,1
"2011","E00015720","E00015720","Total",138,67,14,53,2,12,5,7,54,53,0,1,0,3
"2011","E00015721","E00015721","Total",122,43,17,26,7,24,3,21,48,45,0,2,1,0
"2011","E00015722","E00015722","Total",129,49,19,30,1,23,12,11,55,50,4,0,1,1
"2011","E00015710","E00015710","Total",122,43,10,33,1,6,0,6,69,66,0,3,0,3
"2011","E00015711","E00015711","Total",126,45,6,39,0,10,9,1,70,66,0,3,1,1
"2011","E00015723","E00015723","Total",131,30,11,19,1,37,8,29,61,61,0,0,0,2
"2011","E00015724","E00015724","Total",155,100,37,63,3,6,3,3,44,43,0,1,0,2
"2011","E00015725","E00015725","Total",100,56,19,37,3,4,3,1,33,32,0,1,0,4
"2011","E00015726","E00015726","Total",131,59,20,39,0,7,1,6,65,63,0,2,0,0
"2011","E00015709","E00015709","Total",149,34,8,26,8,17,9,8,90,88,0,1,1,0
"2011","E00015717","E00015717","Total",117,51,17,34,1,11,2,9,52,51,0,1,0,2
"2011","E00015746","E00015746","Total",153,68,26,42,1,8,7,1,76,73,0,3,0,0
"2011","E00015748","E00015748","Total",129,68,22,46,2,6,5,1,53,52,0,1,0,0
"2011","E00015749","E00015749","Total",118,42,6,36,0,21,12,9,55,53,0,2,0,0
"2011","E00015751","E00015751","Total",147,59,18,41,0,2,2,0,85,81,0,4,0,1
"2011","E00015716","E00015716","Total",132,42,9,33,0,22,19,3,68,67,0,1,0,0
"2011","E00015718","E00015718","Total",188,17,4,13,0,10,2,8,158,155,0,3,0,3
"2011","E00015747","E00015747","Total",202,37,10,27,0,56,40,16,105,104,0,1,0,4
"2011","E00015750","E00015750","Total",147,42,5,37,0,4,2,2,101,100,0,1,0,0
"2011","E00015752","E00015752","Total",158,52,11,41,1,12,6,6,93,93,0,0,0,0
"2011","E00015753","E00015753","Total",134,48,12,36,0,12,8,4,74,74,0,0,0,0
"2011","E00015893","E00015893","Total",120,80,23,57,0,10,5,5,29,29,0,0,0,1
"2011","E00015896","E00015896","Total",137,39,4,35,1,31,14,17,63,63,0,0,0,3
"2011","E00015899","E00015899","Total",123,69,19,50,1,17,5,12,34,33,0,1,0,2
"2011","E00015900","E00015900","Total",152,74,30,44,0,25,15,10,52,50,0,2,0,1
"2011","E00015933","E00015933","Total",105,68,13,55,0,5,3,2,32,31,0,1,0,0
"2011","E00015936","E00015936","Total",125,60,13,47,0,24,17,7,38,36,0,2,0,3
"2011","E00015901","E00015901","Total",121,39,9,30,3,38,24,14,41,40,0,1,0,0
"2011","E00015903","E00015903","Total",126,53,19,34,5,10,2,8,58,54,0,4,0,0
"2011","E00015904","E00015904","Total",136,38,11,27,1,39,27,12,58,58,0,0,0,0
"2011","E00015905","E00015905","Total",117,10,4,6,0,92,63,29,15,13,0,1,1,0
"2011","E00015906","E00015906","Total",131,29,8,21,0,60,56,4,38,37,0,1,0,4
"2011","E00015907","E00015907","Total",138,70,28,42,1,7,1,6,58,57,0,0,1,2
"2011","E00015465","E00015465","Total",135,31,5,26,0,50,20,30,53,50,0,3,0,1
"2011","E00015466","E00015466","Total",119,61,18,43,0,21,17,4,34,33,0,1,0,3
"2011","E00015468","E00015468","Total",147,43,9,34,0,64,23,41,32,31,0,1,0,8
"2011","E00015469","E00015469","Total",164,60,13,47,0,32,8,24,68,65,1,2,0,4
"2011","E00015470","E00015470","Total",114,44,11,33,0,38,14,24,32,32,0,0,0,0
"2011","E00015472","E00015472","Total",116,37,8,29,6,13,5,8,60,58,1,1,0,0
"2011","E00015463","E00015463","Total",115,41,12,29,0,53,28,25,21,17,0,2,2,0
"2011","E00015464","E00015464","Total",119,49,8,41,0,30,7,23,40,37,0,2,1,0
"2011","E00015467","E00015467","Total",95,29,9,20,0,60,59,1,6,4,0,2,0,0
"2011","E00015471","E00015471","Total",108,47,12,35,3,45,39,6,12,12,0,0,0,1
"2011","E00015473","E00015473","Total",122,16,3,13,3,82,78,4,19,19,0,0,0,2
"2011","E00015474","E00015474","Total",105,22,4,18,0,70,65,5,13,12,0,1,0,0
"2011","E00015435","E00015435","Total",110,52,15,37,0,8,6,2,47,44,1,2,0,3
"2011","E00015445","E00015445","Total",123,52,11,41,0,45,34,11,25,25,0,0,0,1
"2011","E00015449","E00015449","Total",149,50,15,35,0,17,6,11,80,77,0,2,1,2
"2011","E00015453","E00015453","Total",94,73,27,46,0,1,1,0,19,16,1,2,0,1
"2011","E00015480","E00015480","Total",123,69,25,44,2,34,32,2,18,18,0,0,0,0
"2011","E00015441","E00015441","Total",98,65,28,37,2,17,15,2,14,13,0,1,0,0
"2011","E00015442","E00015442","Total",101,40,11,29,1,50,43,7,9,8,1,0,0,1
"2011","E00015458","E00015458","Total",106,36,6,30,0,26,16,10,44,42,0,1,1,0
"2011","E00015460","E00015460","Total",97,46,11,35,0,32,27,5,19,19,0,0,0,0
"2011","E00015462","E00015462","Total",118,53,21,32,1,46,35,11,18,16,0,1,1,0
"2011","E00015455","E00015455","Total",126,29,9,20,3,68,56,12,24,24,0,0,0,2
"2011","E00015456","E00015456","Total",105,17,1,16,1,83,79,4,4,3,0,1,0,0
"2011","E00015457","E00015457","Total",134,14,3,11,0,104,99,5,11,10,0,1,0,5
"2011","E00015459","E00015459","Total",159,48,10,38,0,53,13,40,57,55,0,1,1,1
"2011","E00015461","E00015461","Total",131,43,5,38,0,64,61,3,24,17,0,4,3,0
"2011","E00015727","E00015727","Total",126,27,6,21,2,37,23,14,59,58,0,0,1,1
"2011","E00015728","E00015728","Total",112,50,18,32,1,14,11,3,46,45,0,0,1,1
"2011","E00015729","E00015729","Total",143,63,24,39,1,28,8,20,51,47,0,3,1,0
"2011","E00015730","E00015730","Total",128,65,23,42,0,21,11,10,41,40,0,1,0,1
"2011","E00015731","E00015731","Total",160,56,9,47,0,33,19,14,70,69,0,1,0,1
"2011","E00015860","E00015860","Total",132,63,19,44,0,19,12,7,50,49,0,1,0,0
"2011","E00015865","E00015865","Total",137,120,67,53,0,1,1,0,15,14,0,0,1,1
"2011","E00015877","E00015877","Total",195,28,14,14,33,90,10,80,42,41,0,1,0,2
"2011","E00015878","E00015878","Total",121,47,19,28,6,39,33,6,27,27,0,0,0,2
"2011","E00015886","E00015886","Total",138,79,27,52,1,16,13,3,42,40,0,1,1,0
"2011","E00015849","E00015849","Total",129,112,61,51,0,2,2,0,15,15,0,0,0,0
"2011","E00015850","E00015850","Total",122,87,33,54,0,10,3,7,25,22,0,3,0,0
"2011","E00015864","E00015864","Total",139,110,51,59,1,8,6,2,19,18,0,1,0,1
"2011","E00015866","E00015866","Total",130,96,43,53,0,6,2,4,27,27,0,0,0,1
"2011","E00015852","E00015852","Total",164,86,32,54,0,14,4,10,63,62,0,1,0,1
"2011","E00015862","E00015862","Total",201,47,13,34,8,13,9,4,130,128,0,1,1,3
"2011","E00015868","E00015868","Total",148,43,11,32,2,24,4,20,77,76,0,1,0,2
"2011","E00015871","E00015871","Total",125,35,8,27,2,35,14,21,51,51,0,0,0,2
"2011","E00015872","E00015872","Total",145,50,13,37,0,14,6,8,78,77,0,0,1,3
"2011","E00015851","E00015851","Total",130,65,22,43,0,12,8,4,50,50,0,0,0,3
"2011","E00015869","E00015869","Total",137,24,9,15,0,77,72,5,36,35,0,0,1,0
"2011","E00015875","E00015875","Total",193,76,33,43,0,22,7,15,93,92,1,0,0,2
"2011","E00015881","E00015881","Total",158,101,33,68,0,28,10,18,27,27,0,0,0,2
"2011","E00015882","E00015882","Total",179,100,30,70,0,11,6,5,65,64,0,1,0,3
"2011","E00015870","E00015870","Total",116,64,19,45,13,2,1,1,37,36,0,1,0,0
"2011","E00015876","E00015876","Total",109,53,18,35,2,8,6,2,44,40,0,3,1,2
"2011","E00015880","E00015880","Total",110,76,39,37,2,7,2,5,25,23,0,2,0,0
"2011","E00015884","E00015884","Total",93,63,40,23,3,3,2,1,23,22,0,1,0,1
"2011","E00015885","E00015885","Total",114,67,29,38,0,10,3,7,36,31,0,5,0,1
"2011","E00015848","E00015848","Total",125,90,44,46,0,12,5,7,22,20,0,2,0,1
"2011","E00015858","E00015858","Total",125,91,49,42,0,5,2,3,29,27,0,1,1,0
"2011","E00015861","E00015861","Total",120,85,30,55,1,11,7,4,23,23,0,0,0,0
"2011","E00015883","E00015883","Total",122,62,31,31,9,8,5,3,41,38,0,2,1,2
"2011","E00015856","E00015856","Total",111,73,35,38,3,10,3,7,24,22,0,1,1,1
"2011","E00015857","E00015857","Total",117,75,43,32,0,6,5,1,32,29,0,1,2,4
"2011","E00015859","E00015859","Total",111,77,40,37,1,8,5,3,22,20,0,1,1,3
"2011","E00015889","E00015889","Total",114,77,41,36,0,12,10,2,25,24,0,0,1,0
"2011","E00015854","E00015854","Total",96,3,0,3,0,84,7,77,9,7,0,0,2,0
"2011","E00015855","E00015855","Total",96,60,27,33,1,15,10,5,20,20,0,0,0,0
"2011","E00015879","E00015879","Total",102,30,10,20,0,51,9,42,19,19,0,0,0,2
"2011","E00015887","E00015887","Total",115,80,31,49,1,18,7,11,15,15,0,0,0,1
"2011","E00015888","E00015888","Total",107,75,34,41,0,7,2,5,25,23,0,1,1,0
"2011","E00015853","E00015853","Total",119,78,31,47,1,9,6,3,30,30,0,0,0,1
"2011","E00015863","E00015863","Total",95,5,0,5,0,80,5,75,10,8,0,1,1,0
"2011","E00015867","E00015867","Total",96,57,22,35,0,2,1,1,37,37,0,0,0,0
"2011","E00015873","E00015873","Total",95,61,20,41,1,9,2,7,23,23,0,0,0,1
"2011","E00015874","E00015874","Total",119,69,35,34,2,9,7,2,37,36,0,1,0,2
"2011","E00015166","E00015166","Total",142,7,2,5,0,43,2,41,89,30,51,0,8,3
"2011","E00015176","E00015176","Total",211,51,33,18,2,3,3,0,139,126,6,5,2,16
"2011","E00015181","E00015181","Total",139,56,31,25,0,6,3,3,67,62,1,4,0,10
"2011","E00015184","E00015184","Total",75,14,7,7,8,30,18,12,16,12,1,0,3,7
"2011","E00171534","E00171534","Total",212,61,29,32,1,1,0,1,146,127,2,13,4,3
"2011","E00171535","E00171535","Total",75,19,13,6,0,1,0,1,52,50,0,2,0,3
"2011","E00015168","E00015168","Total",166,41,13,28,0,81,37,44,41,35,0,5,1,3
"2011","E00015182","E00015182","Total",92,33,21,12,1,27,0,27,28,23,0,5,0,3
"2011","E00015183","E00015183","Total",56,9,4,5,0,40,1,39,5,3,1,0,1,2
"2011","E00015185","E00015185","Total",155,69,42,27,0,56,39,17,29,26,0,1,2,1
"2011","E00015186","E00015186","Total",65,14,2,12,0,36,35,1,13,13,0,0,0,2
"2011","E00015187","E00015187","Total",95,22,8,14,0,44,42,2,28,24,1,1,2,1
"2011","E00015188","E00015188","Total",49,11,5,6,0,29,27,2,9,6,1,1,1,0
"2011","E00015195","E00015195","Total",128,3,1,2,2,114,3,111,8,8,0,0,0,1
"2011","E00015196","E00015196","Total",84,30,11,19,4,29,26,3,21,19,1,1,0,0
"2011","E00171533","E00171533","Total",314,96,57,39,1,16,0,16,197,184,2,6,5,4
"2011","E00015171","E00015171","Total",129,10,3,7,1,99,15,84,19,15,2,0,2,0
"2011","E00015172","E00015172","Total",76,12,4,8,0,39,1,38,25,24,0,0,1,0
"2011","E00015197","E00015197","Total",139,2,0,2,1,128,6,122,6,6,0,0,0,2
"2011","E00015198","E00015198","Total",123,8,2,6,0,97,10,87,16,15,0,1,0,2
"2011","E00015199","E00015199","Total",192,9,3,6,0,103,21,82,77,73,0,2,2,3
"2011","E00015201","E00015201","Total",136,97,59,38,1,8,1,7,25,23,0,2,0,5
"2011","E00015202","E00015202","Total",67,2,1,1,1,42,3,39,20,19,0,0,1,2
"2011","E00015167","E00015167","Total",248,73,22,51,37,36,33,3,100,93,3,4,0,2
"2011","E00015173","E00015173","Total",123,9,3,6,0,49,0,49,65,60,0,4,1,0
"2011","E00015175","E00015175","Total",104,19,4,15,0,37,35,2,47,45,1,1,0,1
"2011","E00015178","E00015178","Total",75,9,1,8,0,46,40,6,20,19,0,1,0,0
"2011","E00015179","E00015179","Total",112,21,4,17,0,57,54,3,33,30,1,2,0,1
"2011","E00015180","E00015180","Total",158,19,5,14,0,89,86,3,48,45,1,1,1,2
"2011","E00165807","E00165807","Total",100,7,4,3,0,62,27,35,29,29,0,0,0,2
"2011","E00016403","E00016403","Total",142,8,5,3,0,124,116,8,10,10,0,0,0,0
"2011","E00016437","E00016437","Total",159,20,4,16,0,127,121,6,11,11,0,0,0,1
"2011","E00016439","E00016439","Total",178,8,1,7,0,127,100,27,42,41,0,0,1,1
"2011","E00016442","E00016442","Total",139,14,7,7,1,110,103,7,14,12,0,0,2,0
"2011","E00016399","E00016399","Total",141,9,1,8,0,123,12,111,4,3,0,0,1,5
"2011","E00016401","E00016401","Total",154,21,4,17,30,90,15,75,11,10,0,0,1,2
"2011","E00016406","E00016406","Total",119,5,2,3,2,99,9,90,12,11,0,0,1,1
"2011","E00016435","E00016435","Total",170,13,4,9,26,113,45,68,17,17,0,0,0,1
"2011","E00016395","E00016395","Total",115,20,11,9,1,59,15,44,34,32,0,1,1,1
"2011","E00016404","E00016404","Total",120,37,11,26,1,33,14,19,47,44,1,2,0,2
"2011","E00016405","E00016405","Total",138,45,12,33,0,28,9,19,63,61,0,2,0,2
"2011","E00016408","E00016408","Total",68,28,6,22,0,2,1,1,37,37,0,0,0,1
"2011","E00016410","E00016410","Total",112,52,20,32,0,16,15,1,42,41,0,1,0,2
"2011","E00016438","E00016438","Total",132,45,11,34,1,7,7,0,78,77,0,1,0,1
"2011","E00016398","E00016398","Total",111,18,8,10,6,67,22,45,19,17,0,2,0,1
"2011","E00016431","E00016431","Total",110,19,6,13,6,58,52,6,23,22,0,1,0,4
"2011","E00016432","E00016432","Total",160,30,5,25,21,70,36,34,38,36,0,2,0,1
"2011","E00016434","E00016434","Total",167,17,7,10,14,122,32,90,11,10,0,1,0,3
"2011","E00173943","E00173943","Total",164,20,5,15,39,83,8,75,18,17,0,0,1,4
"2011","E00173946","E00173946","Total",185,46,6,40,1,21,5,16,117,115,0,0,2,0
"2011","E00016397","E00016397","Total",210,66,14,52,2,50,15,35,92,88,0,2,2,0
"2011","E00016433","E00016433","Total",140,28,11,17,1,84,78,6,26,26,0,0,0,1
"2011","E00016436","E00016436","Total",101,24,2,22,0,58,56,2,16,16,0,0,0,3
"2011","E00016440","E00016440","Total",108,14,6,8,0,82,76,6,10,10,0,0,0,2
"2011","E00016441","E00016441","Total",204,23,5,18,16,128,100,28,35,31,0,3,1,2
"2011","E00016412","E00016412","Total",151,34,7,27,1,64,63,1,51,49,0,2,0,1
"2011","E00016414","E00016414","Total",144,35,6,29,0,82,78,4,25,25,0,0,0,2
"2011","E00016418","E00016418","Total",153,34,3,31,0,75,9,66,41,37,0,2,2,3
"2011","E00016422","E00016422","Total",111,11,2,9,0,92,60,32,8,8,0,0,0,0
"2011","E00016402","E00016402","Total",128,22,6,16,1,88,84,4,16,13,3,0,0,1
"2011","E00016407","E00016407","Total",146,41,10,31,1,35,5,30,69,68,0,1,0,0
"2011","E00016409","E00016409","Total",146,8,2,6,23,95,37,58,16,14,0,2,0,4
"2011","E00016411","E00016411","Total",172,38,9,29,14,64,12,52,56,55,0,1,0,0
"2011","E00016413","E00016413","Total",126,24,8,16,1,79,72,7,18,18,0,0,0,4
"2011","E00016415","E00016415","Total",140,16,7,9,5,94,81,13,23,22,0,1,0,2
"2011","E00016416","E00016416","Total",104,10,3,7,1,78,64,14,15,14,0,0,1,0
"2011","E00016419","E00016419","Total",118,12,1,11,0,87,85,2,17,16,0,1,0,2
"2011","E00016420","E00016420","Total",121,12,3,9,0,92,85,7,13,12,0,1,0,4
"2011","E00173947","E00173947","Total",123,4,2,2,0,92,83,9,24,22,0,0,2,3
"2011","E00173948","E00173948","Total",171,8,1,7,16,104,22,82,41,41,0,0,0,2
"2011","E00016417","E00016417","Total",138,27,10,17,1,104,68,36,5,5,0,0,0,1
"2011","E00016421","E00016421","Total",125,7,1,6,0,112,95,17,6,6,0,0,0,0
"2011","E00016423","E00016423","Total",122,24,9,15,1,82,76,6,14,14,0,0,0,1
"2011","E00016424","E00016424","Total",123,11,5,6,0,109,108,1,3,3,0,0,0,0
"2011","E00016427","E00016427","Total",105,8,3,5,0,86,84,2,11,10,0,1,0,0
"2011","E00016396","E00016396","Total",134,16,2,14,0,99,68,31,18,16,0,1,1,1
"2011","E00016426","E00016426","Total",134,20,4,16,0,93,81,12,19,17,0,2,0,2
"2011","E00016428","E00016428","Total",157,29,11,18,0,31,19,12,95,93,0,1,1,2
"2011","E00016429","E00016429","Total",124,48,18,30,1,47,31,16,26,22,0,3,1,2
"2011","E00016430","E00016430","Total",120,19,8,11,8,78,76,2,13,13,0,0,0,2
"2011","E00016680","E00016680","Total",122,36,4,32,0,3,3,0,83,83,0,0,0,0
"2011","E00016716","E00016716","Total",159,34,5,29,0,22,6,16,101,98,2,1,0,2
"2011","E00016717","E00016717","Total",102,35,5,30,0,6,4,2,59,59,0,0,0,2
"2011","E00016719","E00016719","Total",117,31,8,23,0,74,71,3,11,10,0,1,0,1
"2011","E00016720","E00016720","Total",148,37,6,31,0,12,7,5,99,98,0,1,0,0
"2011","E00016725","E00016725","Total",119,43,6,37,0,7,3,4,69,68,0,1,0,0
"2011","E00016706","E00016706","Total",103,17,4,13,1,44,38,6,40,37,0,1,2,1
"2011","E00016708","E00016708","Total",130,41,11,30,0,66,49,17,21,19,0,2,0,2
"2011","E00016709","E00016709","Total",137,43,10,33,3,53,43,10,37,33,2,2,0,1
"2011","E00016714","E00016714","Total",114,28,6,22,0,40,27,13,46,43,0,3,0,0
"2011","E00016715","E00016715","Total",125,41,10,31,3,43,28,15,38,38,0,0,0,0
"2011","E00016675","E00016675","Total",116,33,6,27,0,13,5,8,69,69,0,0,0,1
"2011","E00016677","E00016677","Total",131,39,9,30,7,37,8,29,48,48,0,0,0,0
"2011","E00016683","E00016683","Total",138,65,8,57,0,5,4,1,68,66,0,2,0,0
"2011","E00016697","E00016697","Total",121,26,8,18,2,71,38,33,21,21,0,0,0,1
"2011","E00173940","E00173940","Total",113,40,7,33,0,44,31,13,29,28,0,1,0,0
"2011","E00173949","E00173949","Total",148,54,8,46,20,4,2,2,70,65,0,5,0,0
"2011","E00016684","E00016684","Total",107,46,8,38,7,14,4,10,40,36,0,4,0,0
"2011","E00016687","E00016687","Total",108,56,11,45,0,6,2,4,46,44,0,2,0,0
"2011","E00016694","E00016694","Total",135,34,12,22,17,59,14,45,22,21,0,0,1,3
"2011","E00016718","E00016718","Total",128,21,6,15,0,96,89,7,10,10,0,0,0,1
"2011","E00016721","E00016721","Total",109,15,1,14,1,79,75,4,13,11,0,1,1,1
"2011","E00016723","E00016723","Total",123,31,13,18,0,79,75,4,13,12,0,1,0,0
"2011","E00016679","E00016679","Total",91,33,16,17,0,50,22,28,8,6,0,2,0,0
"2011","E00016689","E00016689","Total",115,49,14,35,1,41,37,4,24,20,0,3,1,0
"2011","E00016693","E00016693","Total",125,23,10,13,0,71,58,13,28,26,0,2,0,3
"2011","E00016701","E00016701","Total",88,32,11,21,4,33,22,11,17,16,0,1,0,2
"2011","E00173939","E00173939","Total",94,4,4,0,6,72,68,4,10,9,1,0,0,2
"2011","E00016210","E00016210","Total",142,12,3,9,0,82,11,71,45,44,0,1,0,3
"2011","E00016239","E00016239","Total",148,8,3,5,1,42,5,37,96,94,1,0,1,1
"2011","E00016240","E00016240","Total",85,3,0,3,0,75,12,63,7,7,0,0,0,0
"2011","E00016241","E00016241","Total",143,26,11,15,1,99,94,5,17,17,0,0,0,0
"2011","E00016245","E00016245","Total",97,19,7,12,1,67,58,9,10,10,0,0,0,0
"2011","E00016211","E00016211","Total",113,29,9,20,0,66,53,13,17,15,0,1,1,1
"2011","E00016213","E00016213","Total",170,40,6,34,0,93,81,12,36,32,0,4,0,1
"2011","E00016244","E00016244","Total",128,48,14,34,13,30,19,11,33,33,0,0,0,4
"2011","E00016250","E00016250","Total",141,21,6,15,0,94,60,34,24,24,0,0,0,2
"2011","E00174011","E00174011","Total",53,6,1,5,17,14,10,4,16,16,0,0,0,0
"2011","E00174032","E00174032","Total",132,29,10,19,1,38,9,29,62,59,0,3,0,2
"2011","E00174033","E00174033","Total",41,14,5,9,1,13,11,2,13,13,0,0,0,0
"2011","E00016216","E00016216","Total",171,63,21,42,0,28,0,28,78,75,0,3,0,2
"2011","E00016236","E00016236","Total",204,56,14,42,2,23,4,19,117,112,3,2,0,6
"2011","E00016246","E00016246","Total",137,47,13,34,2,59,47,12,27,25,0,2,0,2
"2011","E00016248","E00016248","Total",174,43,13,30,0,38,8,30,93,92,0,0,1,0
"2011","E00016252","E00016252","Total",164,59,18,41,0,62,17,45,42,40,0,1,1,1
"2011","E00016214","E00016214","Total",162,83,39,44,5,27,15,12,46,45,0,1,0,1
"2011","E00016215","E00016215","Total",135,57,20,37,2,38,28,10,37,31,0,5,1,1
"2011","E00016217","E00016217","Total",186,60,18,42,1,60,9,51,62,56,0,6,0,3
"2011","E00016237","E00016237","Total",112,77,40,37,1,4,2,2,29,26,0,3,0,1
"2011","E00016247","E00016247","Total",140,55,16,39,1,42,21,21,42,41,0,1,0,0
"2011","E00016253","E00016253","Total",132,62,21,41,1,29,11,18,40,36,0,4,0,0
"2011","E00016209","E00016209","Total",158,43,18,25,2,65,19,46,46,42,0,2,2,2
"2011","E00016235","E00016235","Total",145,27,11,16,0,37,13,24,81,80,0,1,0,0
"2011","E00016238","E00016238","Total",181,53,24,29,1,39,16,23,87,82,0,3,2,1
"2011","E00173941","E00173941","Total",105,18,10,8,0,24,8,16,58,55,0,0,3,5
"2011","E00173942","E00173942","Total",77,11,8,3,0,17,10,7,49,47,0,1,1,0
"2011","E00016881","E00016881","Total",104,24,9,15,0,59,50,9,19,18,0,1,0,2
"2011","E00016915","E00016915","Total",143,11,1,10,0,67,41,26,60,57,0,1,2,5
"2011","E00016916","E00016916","Total",142,20,4,16,0,103,77,26,18,15,0,0,3,1
"2011","E00016920","E00016920","Total",126,18,5,13,0,85,74,11,22,22,0,0,0,1
"2011","E00173950","E00173950","Total",117,14,3,11,17,49,7,42,36,31,0,2,3,1
"2011","E00173951","E00173951","Total",139,3,0,3,10,122,12,110,3,3,0,0,0,1
"2011","E00016921","E00016921","Total",131,27,6,21,3,79,75,4,21,20,0,1,0,1
"2011","E00016922","E00016922","Total",144,38,14,24,0,67,46,21,38,38,0,0,0,1
"2011","E00016923","E00016923","Total",156,55,20,35,1,40,33,7,55,54,0,1,0,5
"2011","E00016925","E00016925","Total",199,65,25,40,3,28,9,19,99,97,0,2,0,4
"2011","E00016926","E00016926","Total",133,29,9,20,0,78,55,23,23,23,0,0,0,3
"2011","E00016917","E00016917","Total",179,50,14,36,1,18,9,9,109,107,0,1,1,1
"2011","E00016918","E00016918","Total",156,36,9,27,0,13,7,6,104,102,0,2,0,3
"2011","E00016919","E00016919","Total",141,58,25,33,0,36,21,15,47,47,0,0,0,0
"2011","E00016924","E00016924","Total",186,66,23,43,1,37,10,27,79,77,0,1,1,3
"2011","E00016927","E00016927","Total",135,65,15,50,0,24,14,10,45,44,0,1,0,1
"2011","E00016879","E00016879","Total",165,94,44,50,1,33,15,18,35,32,0,3,0,2
"2011","E00016884","E00016884","Total",130,69,32,37,0,23,5,18,38,36,0,2,0,0
"2011","E00016886","E00016886","Total",151,58,20,38,2,36,19,17,54,53,0,0,1,1
"2011","E00016893","E00016893","Total",135,54,27,27,0,43,7,36,38,35,0,3,0,0
"2011","E00016885","E00016885","Total",137,66,31,35,0,29,15,14,39,35,2,2,0,3
"2011","E00016887","E00016887","Total",102,62,28,34,0,18,7,11,21,21,0,0,0,1
"2011","E00016889","E00016889","Total",116,53,19,34,0,35,26,9,25,24,0,1,0,3
"2011","E00016890","E00016890","Total",137,36,7,29,1,68,68,0,31,30,0,1,0,1
"2011","E00016895","E00016895","Total",134,57,21,36,0,25,1,24,51,48,0,1,2,1
"2011","E00016159","E00016159","Total",120,63,27,36,0,24,19,5,32,32,0,0,0,1
"2011","E00016173","E00016173","Total",133,63,21,42,2,41,39,2,25,24,0,1,0,2
"2011","E00016176","E00016176","Total",135,94,26,68,0,6,5,1,33,32,0,1,0,2
"2011","E00016184","E00016184","Total",131,65,28,37,0,5,3,2,59,52,2,5,0,2
"2011","E00016186","E00016186","Total",143,64,28,36,0,22,19,3,54,52,0,2,0,3
"2011","E00016188","E00016188","Total",139,64,27,37,0,32,8,24,43,41,0,2,0,0
"2011","E00016164","E00016164","Total",110,33,14,19,0,66,60,6,11,9,1,0,1,0
"2011","E00016170","E00016170","Total",150,47,14,33,0,67,52,15,36,34,1,1,0,0
"2011","E00016175","E00016175","Total",149,44,12,32,1,74,25,49,30,29,0,1,0,0
"2011","E00016181","E00016181","Total",140,20,6,14,3,96,10,86,20,20,0,0,0,1
"2011","E00016182","E00016182","Total",131,91,36,55,1,13,6,7,23,22,0,1,0,3
"2011","E00016162","E00016162","Total",129,64,22,42,0,28,27,1,37,36,0,1,0,0
"2011","E00016198","E00016198","Total",105,37,9,28,0,37,32,5,28,26,0,2,0,3
"2011","E00016202","E00016202","Total",100,9,2,7,1,81,80,1,7,5,0,0,2,2
"2011","E00016205","E00016205","Total",129,92,32,60,0,2,1,1,34,33,0,1,0,1
"2011","E00016208","E00016208","Total",140,42,24,18,1,63,55,8,34,31,0,3,0,0
"2011","E00016199","E00016199","Total",119,35,12,23,0,63,61,2,19,15,0,4,0,2
"2011","E00016200","E00016200","Total",84,6,1,5,0,72,66,6,5,5,0,0,0,1
"2011","E00016201","E00016201","Total",56,5,2,3,0,45,44,1,6,6,0,0,0,0
"2011","E00016203","E00016203","Total",129,12,3,9,0,111,109,2,4,4,0,0,0,2
"2011","E00016207","E00016207","Total",114,17,9,8,0,92,82,10,5,2,0,3,0,0
"2011","E00016163","E00016163","Total",129,59,15,44,0,35,34,1,35,34,0,1,0,0
"2011","E00016165","E00016165","Total",119,65,34,31,1,20,9,11,33,32,0,1,0,0
"2011","E00016168","E00016168","Total",86,39,18,21,0,8,0,8,39,39,0,0,0,0
"2011","E00016169","E00016169","Total",116,80,48,32,0,17,16,1,16,15,0,1,0,3
"2011","E00016172","E00016172","Total",127,49,15,34,0,39,31,8,39,38,0,0,1,0
"2011","E00016177","E00016177","Total",121,55,21,34,0,35,25,10,30,28,0,2,0,1
"2011","E00016219","E00016219","Total",146,41,11,30,0,44,28,16,57,52,1,3,1,4
"2011","E00016220","E00016220","Total",136,48,10,38,0,30,14,16,58,53,0,5,0,0
"2011","E00016221","E00016221","Total",146,47,15,32,0,36,33,3,63,60,0,3,0,0
"2011","E00016223","E00016223","Total",107,49,21,28,3,33,13,20,22,20,0,1,1,0
"2011","E00016225","E00016225","Total",117,47,11,36,3,28,8,20,37,35,1,0,1,2
"2011","E00016255","E00016255","Total",101,47,9,38,4,19,7,12,30,28,0,2,0,1
"2011","E00016218","E00016218","Total",113,41,11,30,0,11,5,6,60,56,0,4,0,1
"2011","E00016222","E00016222","Total",160,47,14,33,0,53,29,24,59,56,1,2,0,1
"2011","E00016224","E00016224","Total",156,69,17,52,2,18,7,11,62,59,0,2,1,5
"2011","E00016226","E00016226","Total",120,47,13,34,2,43,29,14,27,22,0,4,1,1
"2011","E00016227","E00016227","Total",139,58,16,42,0,20,10,10,59,59,0,0,0,2
"2011","E00016228","E00016228","Total",125,59,21,38,2,26,12,14,36,35,0,1,0,2
"2011","E00016229","E00016229","Total",182,67,21,46,0,38,12,26,77,70,0,7,0,0
"2011","E00016230","E00016230","Total",134,59,26,33,13,22,4,18,36,34,1,1,0,4
"2011","E00016231","E00016231","Total",145,38,8,30,0,72,45,27,30,30,0,0,0,5
"2011","E00016232","E00016232","Total",130,33,8,25,0,52,46,6,44,39,3,2,0,1
"2011","E00016233","E00016233","Total",154,20,2,18,12,99,89,10,21,17,0,4,0,2
"2011","E00016212","E00016212","Total",120,45,16,29,0,56,46,10,19,11,0,8,0,0
"2011","E00016249","E00016249","Total",118,25,9,16,0,78,72,6,12,9,0,3,0,3
"2011","E00016254","E00016254","Total",107,48,15,33,1,41,10,31,16,10,0,6,0,1
"2011","E00173952","E00173952","Total",108,24,11,13,0,56,34,22,28,28,0,0,0,0
"2011","E00174016","E00174016","Total",98,42,19,23,2,28,22,6,25,19,0,6,0,1
"2011","E00174022","E00174022","Total",91,46,13,33,0,18,15,3,24,24,0,0,0,3
"2011","E00174008","E00174008","Total",130,37,9,28,15,1,1,0,77,73,1,3,0,0
"2011","E00174010","E00174010","Total",120,32,7,25,0,2,1,1,86,83,0,2,1,0
"2011","E00174013","E00174013","Total",126,36,12,24,0,2,2,0,88,86,0,1,1,0
"2011","E00174015","E00174015","Total",107,42,11,31,0,4,3,1,61,59,0,2,0,0
"2011","E00174025","E00174025","Total",127,36,4,32,7,2,2,0,81,80,0,1,0,1
"2011","E00174027","E00174027","Total",96,43,12,31,0,0,0,0,52,50,0,2,0,1
"2011","E00016178","E00016178","Total",121,35,13,22,0,74,51,23,12,11,0,1,0,0
"2011","E00016179","E00016179","Total",128,54,23,31,0,48,45,3,26,22,0,4,0,0
"2011","E00016180","E00016180","Total",132,68,35,33,0,35,33,2,29,27,1,0,1,0
"2011","E00016187","E00016187","Total",130,89,34,55,1,13,13,0,27,24,0,3,0,0
"2011","E00016189","E00016189","Total",128,98,36,62,0,10,10,0,20,20,0,0,0,0
"2011","E00016166","E00016166","Total",101,41,19,22,0,8,7,1,52,52,0,0,0,0
"2011","E00016167","E00016167","Total",120,85,60,25,0,4,3,1,28,26,0,1,1,3
"2011","E00016171","E00016171","Total",153,31,16,15,0,2,1,1,113,109,4,0,0,7
"2011","E00016174","E00016174","Total",121,78,39,39,0,20,1,19,23,23,0,0,0,0
"2011","E00016204","E00016204","Total",140,63,25,38,0,35,35,0,42,41,0,1,0,0
"2011","E00016206","E00016206","Total",121,62,25,37,1,26,21,5,31,31,0,0,0,1
"2011","E00016160","E00016160","Total",131,107,72,35,1,5,4,1,17,17,0,0,0,1
"2011","E00016183","E00016183","Total",119,69,32,37,0,2,2,0,47,46,0,1,0,1
"2011","E00016185","E00016185","Total",114,87,50,37,0,4,3,1,23,21,0,2,0,0
"2011","E00016191","E00016191","Total",122,76,47,29,0,7,1,6,39,38,0,1,0,0
"2011","E00016195","E00016195","Total",128,81,35,46,0,16,16,0,31,30,0,1,0,0
"2011","E00016197","E00016197","Total",150,48,19,29,0,6,1,5,96,95,0,0,1,0
"2011","E00016161","E00016161","Total",166,62,19,43,0,35,25,10,67,64,0,3,0,2
"2011","E00016190","E00016190","Total",156,31,14,17,0,91,86,5,34,34,0,0,0,0
"2011","E00016192","E00016192","Total",173,49,15,34,0,69,36,33,52,51,0,1,0,3
"2011","E00016193","E00016193","Total",154,52,15,37,0,3,0,3,98,94,0,3,1,1
"2011","E00016194","E00016194","Total",152,25,6,19,1,75,8,67,51,51,0,0,0,0
"2011","E00016196","E00016196","Total",179,69,13,56,2,68,63,5,38,36,0,2,0,2
"2011","E00016905","E00016905","Total",114,32,8,24,1,50,45,5,29,25,0,2,2,2
"2011","E00016907","E00016907","Total",115,43,14,29,0,51,42,9,19,17,0,0,2,2
"2011","E00016908","E00016908","Total",123,14,3,11,9,81,64,17,18,15,0,2,1,1
"2011","E00016910","E00016910","Total",128,16,3,13,0,98,95,3,14,11,0,1,2,0
"2011","E00016912","E00016912","Total",97,8,1,7,2,79,72,7,8,7,0,1,0,0
"2011","E00016909","E00016909","Total",146,21,4,17,1,108,87,21,15,14,0,0,1,1
"2011","E00016911","E00016911","Total",171,30,9,21,28,103,58,45,8,7,0,1,0,2
"2011","E00016913","E00016913","Total",158,16,2,14,9,119,92,27,14,14,0,0,0,0
"2011","E00016914","E00016914","Total",125,19,4,15,0,94,91,3,12,12,0,0,0,0
"2011","E00016896","E00016896","Total",140,53,15,38,4,22,10,12,60,60,0,0,0,1
"2011","E00016898","E00016898","Total",113,42,17,25,0,20,13,7,51,48,0,3,0,0
"2011","E00016900","E00016900","Total",144,72,22,50,0,22,15,7,50,49,0,1,0,0
"2011","E00016901","E00016901","Total",85,28,7,21,0,9,8,1,42,42,0,0,0,6
"2011","E00016904","E00016904","Total",107,36,8,28,3,26,11,15,40,39,0,1,0,2
"2011","E00016906","E00016906","Total",113,63,14,49,0,15,10,5,35,33,0,2,0,0
"2011","E00016883","E00016883","Total",142,52,18,34,0,46,26,20,44,40,0,4,0,0
"2011","E00016888","E00016888","Total",129,57,19,38,0,47,21,26,24,20,0,4,0,1
"2011","E00016891","E00016891","Total",171,43,7,36,0,70,41,29,56,45,0,11,0,2
"2011","E00016892","E00016892","Total",126,55,15,40,1,23,13,10,47,41,0,6,0,0
"2011","E00016894","E00016894","Total",151,62,20,42,2,45,19,26,39,23,0,16,0,3
"2011","E00016880","E00016880","Total",115,40,6,34,0,54,38,16,20,20,0,0,0,1
"2011","E00016897","E00016897","Total",180,58,20,38,1,41,14,27,80,77,0,2,1,0
"2011","E00016899","E00016899","Total",159,67,18,49,3,17,14,3,72,70,0,1,1,0
"2011","E00016902","E00016902","Total",137,55,17,38,3,35,26,9,43,42,0,0,1,1
"2011","E00016903","E00016903","Total",128,59,14,45,1,18,5,13,49,45,0,4,0,1
"2011","E00016564","E00016564","Total",133,74,24,50,1,29,11,18,29,25,0,3,1,0
"2011","E00016567","E00016567","Total",82,12,2,10,1,59,46,13,10,8,0,0,2,0
"2011","E00016569","E00016569","Total",128,76,27,49,0,25,15,10,27,26,0,1,0,0
"2011","E00016571","E00016571","Total",115,94,36,58,0,5,3,2,16,13,1,2,0,0
"2011","E00173700","E00173700","Total",103,46,26,20,0,43,4,39,14,9,0,5,0,0
"2011","E00173702","E00173702","Total",105,54,23,31,0,42,4,38,9,7,0,2,0,0
"2011","E00016558","E00016558","Total",126,48,9,39,1,36,12,24,41,37,1,2,1,0
"2011","E00016561","E00016561","Total",121,42,7,35,0,35,7,28,43,41,0,2,0,1
"2011","E00016566","E00016566","Total",113,50,20,30,0,25,7,18,37,36,0,1,0,1
"2011","E00016568","E00016568","Total",144,61,20,41,3,36,14,22,40,34,0,6,0,4
"2011","E00016572","E00016572","Total",147,54,24,30,0,46,24,22,47,45,0,2,0,0
"2011","E00016575","E00016575","Total",127,69,17,52,1,37,14,23,20,17,0,2,1,0
"2011","E00016557","E00016557","Total",95,33,11,22,0,21,10,11,40,34,0,6,0,1
"2011","E00016559","E00016559","Total",137,62,27,35,0,30,5,25,44,41,0,3,0,1
"2011","E00016560","E00016560","Total",146,60,18,42,0,20,5,15,65,60,1,3,1,1
"2011","E00016562","E00016562","Total",147,72,25,47,2,28,3,25,45,44,0,1,0,0
"2011","E00016563","E00016563","Total",126,66,26,40,0,28,0,28,31,28,0,3,0,1
"2011","E00016565","E00016565","Total",154,60,18,42,0,54,34,20,40,38,0,2,0,0
"2011","E00016544","E00016544","Total",149,85,35,50,0,28,22,6,34,34,0,0,0,2
"2011","E00016574","E00016574","Total",128,80,28,52,0,20,13,7,26,19,0,6,1,2
"2011","E00016576","E00016576","Total",125,68,22,46,0,24,8,16,31,30,0,1,0,2
"2011","E00016577","E00016577","Total",144,92,36,56,1,27,19,8,21,18,0,3,0,3
"2011","E00016578","E00016578","Total",108,72,28,44,0,13,7,6,21,15,0,6,0,2
"2011","E00016635","E00016635","Total",175,59,28,31,1,22,7,15,92,91,0,1,0,1
"2011","E00016640","E00016640","Total",142,26,12,14,0,98,16,82,17,16,0,1,0,1
"2011","E00016641","E00016641","Total",147,31,3,28,4,89,79,10,13,12,0,1,0,10
"2011","E00016642","E00016642","Total",183,44,21,23,12,89,60,29,35,34,0,0,1,3
"2011","E00016643","E00016643","Total",147,46,15,31,1,76,72,4,23,22,0,1,0,1
"2011","E00016630","E00016630","Total",152,61,16,45,9,31,8,23,50,45,2,2,1,1
"2011","E00016647","E00016647","Total",151,25,6,19,2,73,62,11,51,49,0,1,1,0
"2011","E00016648","E00016648","Total",136,37,13,24,0,34,11,23,65,64,0,1,0,0
"2011","E00016649","E00016649","Total",138,13,2,11,0,71,19,52,54,50,1,1,2,0
"2011","E00016651","E00016651","Total",148,51,15,36,12,32,11,21,53,51,0,1,1,0
"2011","E00016629","E00016629","Total",159,36,11,25,4,83,77,6,34,33,0,0,1,2
"2011","E00016650","E00016650","Total",122,43,10,33,1,61,35,26,16,15,0,1,0,1
"2011","E00016652","E00016652","Total",129,16,5,11,0,86,40,46,26,24,0,1,1,1
"2011","E00016654","E00016654","Total",133,7,2,5,0,108,19,89,18,17,0,0,1,0
"2011","E00016657","E00016657","Total",139,21,4,17,2,98,37,61,18,17,0,1,0,0
"2011","E00016633","E00016633","Total",109,32,9,23,0,45,10,35,31,30,0,0,1,1
"2011","E00016636","E00016636","Total",133,39,13,26,0,2,1,1,92,90,0,1,1,0
"2011","E00016638","E00016638","Total",84,20,9,11,1,3,2,1,59,58,0,0,1,1
"2011","E00016639","E00016639","Total",200,35,15,20,44,108,9,99,13,9,0,1,3,0
"2011","E00016674","E00016674","Total",122,76,29,47,1,18,7,11,27,26,0,1,0,0
"2011","E00174018","E00174018","Total",234,52,12,40,12,11,8,3,158,157,0,1,0,1
"2011","E00174019","E00174019","Total",84,18,10,8,18,26,6,20,20,19,0,1,0,2
"2011","E00174021","E00174021","Total",55,21,5,16,0,6,4,2,28,26,0,2,0,0
"2011","E00016628","E00016628","Total",149,58,30,28,23,29,6,23,36,35,0,1,0,3
"2011","E00016637","E00016637","Total",194,99,55,44,8,11,2,9,76,72,1,3,0,0
"2011","E00174024","E00174024","Total",114,35,11,24,1,9,4,5,67,67,0,0,0,2
"2011","E00174029","E00174029","Total",112,20,10,10,0,9,6,3,83,83,0,0,0,0
"2011","E00174030","E00174030","Total",110,38,5,33,5,25,14,11,42,41,0,0,1,0
"2011","E00016644","E00016644","Total",208,44,9,35,4,74,45,29,72,72,0,0,0,14
"2011","E00016645","E00016645","Total",170,60,21,39,5,59,29,30,40,38,0,2,0,6
"2011","E00016646","E00016646","Total",173,45,17,28,1,61,22,39,66,64,0,2,0,0
"2011","E00016584","E00016584","Total",233,86,33,53,3,54,14,40,89,83,1,2,3,1
"2011","E00016596","E00016596","Total",126,87,31,56,0,19,17,2,19,19,0,0,0,1
"2011","E00016598","E00016598","Total",228,117,41,76,4,46,28,18,59,54,0,4,1,2
"2011","E00016623","E00016623","Total",173,63,7,56,0,49,5,44,61,59,0,1,1,0
"2011","E00174036","E00174036","Total",97,55,21,34,4,16,9,7,21,20,0,1,0,1
"2011","E00174038","E00174038","Total",190,63,16,47,2,27,11,16,96,92,0,4,0,2
"2011","E00016585","E00016585","Total",134,69,32,37,0,9,1,8,56,54,0,2,0,0
"2011","E00016593","E00016593","Total",244,136,62,74,4,12,6,6,90,84,2,0,4,2
"2011","E00016600","E00016600","Total",144,120,47,73,0,17,14,3,7,6,0,1,0,0
"2011","E00016602","E00016602","Total",133,95,29,66,0,27,9,18,11,11,0,0,0,0
"2011","E00016624","E00016624","Total",129,48,15,33,4,15,7,8,60,57,0,3,0,2
"2011","E00016625","E00016625","Total",139,91,35,56,0,15,3,12,33,29,0,3,1,0
"2011","E00016587","E00016587","Total",184,89,32,57,3,58,47,11,33,33,0,0,0,1
"2011","E00016594","E00016594","Total",157,82,23,59,1,29,14,15,43,40,0,3,0,2
"2011","E00016605","E00016605","Total",181,97,31,66,1,28,13,15,54,51,0,3,0,1
"2011","E00016608","E00016608","Total",91,58,22,36,0,15,7,8,17,17,0,0,0,1
"2011","E00016626","E00016626","Total",135,98,42,56,0,13,12,1,24,23,0,1,0,0
"2011","E00016589","E00016589","Total",133,74,43,31,1,43,8,35,13,13,0,0,0,2
"2011","E00016595","E00016595","Total",127,11,1,10,1,107,24,83,8,8,0,0,0,0
"2011","E00016597","E00016597","Total",133,15,3,12,5,93,21,72,18,18,0,0,0,2
"2011","E00016599","E00016599","Total",139,57,16,41,8,29,25,4,44,42,0,2,0,1
"2011","E00016601","E00016601","Total",139,29,6,23,0,87,81,6,21,19,0,1,1,2
"2011","E00016607","E00016607","Total",115,32,16,16,0,62,9,53,20,20,0,0,0,1
"2011","E00016573","E00016573","Total",130,63,18,45,1,16,7,9,49,49,0,0,0,1
"2011","E00016579","E00016579","Total",134,39,15,24,0,29,9,20,64,62,0,2,0,2
"2011","E00016580","E00016580","Total",168,83,30,53,2,28,8,20,55,51,1,2,1,0
"2011","E00016581","E00016581","Total",186,63,21,42,0,55,22,33,67,64,1,2,0,1
"2011","E00016582","E00016582","Total",180,98,35,63,1,29,12,17,52,49,0,3,0,0
"2011","E00016546","E00016546","Total",141,47,13,34,1,17,4,13,73,68,0,4,1,3
"2011","E00016547","E00016547","Total",164,95,33,62,1,14,4,10,53,52,0,1,0,1
"2011","E00016548","E00016548","Total",137,101,45,56,1,13,8,5,20,19,0,0,1,2
"2011","E00016550","E00016550","Total",158,68,23,45,1,22,4,18,67,63,0,3,1,0
"2011","E00016583","E00016583","Total",121,61,14,47,0,42,18,24,18,16,0,2,0,0
"2011","E00016542","E00016542","Total",135,56,12,44,1,49,45,4,26,24,0,2,0,3
"2011","E00016552","E00016552","Total",142,30,12,18,4,90,3,87,12,12,0,0,0,6
"2011","E00016554","E00016554","Total",123,88,27,61,0,7,1,6,24,22,0,2,0,4
"2011","E00016555","E00016555","Total",114,38,14,24,0,60,38,22,12,12,0,0,0,4
"2011","E00016556","E00016556","Total",126,77,25,52,1,23,16,7,22,22,0,0,0,3
"2011","E00016543","E00016543","Total",168,62,13,49,1,55,38,17,48,43,0,4,1,2
"2011","E00016545","E00016545","Total",128,34,10,24,0,71,32,39,16,12,1,3,0,7
"2011","E00016549","E00016549","Total",134,113,50,63,0,4,2,2,12,11,0,1,0,5
"2011","E00016551","E00016551","Total",140,115,41,74,0,9,7,2,8,6,0,2,0,8
"2011","E00016553","E00016553","Total",130,78,32,46,0,18,6,12,22,20,0,2,0,12
"2011","E00016335","E00016335","Total",91,63,21,42,0,6,2,4,22,18,0,3,1,0
"2011","E00016336","E00016336","Total",136,86,38,48,14,11,3,8,23,22,0,1,0,2
"2011","E00016339","E00016339","Total",117,100,34,66,2,6,2,4,6,5,0,1,0,3
"2011","E00016340","E00016340","Total",131,103,30,73,0,8,3,5,19,18,0,0,1,1
"2011","E00016341","E00016341","Total",115,101,34,67,2,4,1,3,7,7,0,0,0,1
"2011","E00016309","E00016309","Total",146,68,29,39,0,21,4,17,56,55,0,1,0,1
"2011","E00016323","E00016323","Total",114,47,17,30,1,50,25,25,14,14,0,0,0,2
"2011","E00016324","E00016324","Total",161,75,27,48,1,37,19,18,46,44,0,2,0,2
"2011","E00016325","E00016325","Total",142,43,14,29,1,6,2,4,92,88,0,4,0,0
"2011","E00016327","E00016327","Total",124,72,27,45,0,16,5,11,36,35,0,1,0,0
"2011","E00016326","E00016326","Total",124,81,27,54,0,18,2,16,25,24,0,0,1,0
"2011","E00016329","E00016329","Total",144,61,21,40,12,37,1,36,32,31,0,1,0,2
"2011","E00016332","E00016332","Total",148,112,60,52,2,9,2,7,25,24,0,1,0,0
"2011","E00016333","E00016333","Total",111,66,27,39,0,13,1,12,32,28,1,3,0,0
"2011","E00016337","E00016337","Total",122,101,44,57,3,7,1,6,11,9,0,2,0,0
"2011","E00016311","E00016311","Total",126,88,28,60,0,14,6,8,24,22,0,2,0,0
"2011","E00016328","E00016328","Total",126,86,22,64,1,14,10,4,25,25,0,0,0,0
"2011","E00016330","E00016330","Total",117,53,18,35,0,29,20,9,33,33,0,0,0,2
"2011","E00016331","E00016331","Total",137,81,42,39,0,9,1,8,47,44,0,2,1,0
"2011","E00016334","E00016334","Total",163,117,34,83,0,12,4,8,31,28,0,3,0,3
"2011","E00016613","E00016613","Total",150,133,71,62,1,3,1,2,12,11,0,1,0,1
"2011","E00016614","E00016614","Total",128,55,18,37,1,55,10,45,13,12,0,1,0,4
"2011","E00016615","E00016615","Total",122,87,37,50,0,0,0,0,35,35,0,0,0,0
"2011","E00016618","E00016618","Total",116,28,8,20,1,62,18,44,23,22,0,1,0,2
"2011","E00016621","E00016621","Total",135,19,1,18,0,87,21,66,28,27,0,1,0,1
"2011","E00016609","E00016609","Total",104,89,44,45,1,1,0,1,12,11,0,0,1,1
"2011","E00016617","E00016617","Total",137,98,46,52,0,15,5,10,24,22,0,2,0,0
"2011","E00016619","E00016619","Total",136,85,38,47,0,38,23,15,12,11,0,1,0,1
"2011","E00016620","E00016620","Total",117,105,39,66,1,4,3,1,7,6,0,0,1,0
"2011","E00016622","E00016622","Total",107,42,12,30,0,40,5,35,23,20,0,3,0,2
"2011","E00016588","E00016588","Total",164,105,46,59,0,12,11,1,43,39,0,4,0,4
"2011","E00016592","E00016592","Total",185,118,64,54,1,7,1,6,58,54,0,4,0,1
"2011","E00016604","E00016604","Total",106,93,56,37,0,1,0,1,12,12,0,0,0,0
"2011","E00016611","E00016611","Total",105,39,15,24,11,11,2,9,44,39,2,3,0,0
"2011","E00016612","E00016612","Total",90,60,34,26,0,14,6,8,15,11,0,4,0,1
"2011","E00016616","E00016616","Total",117,44,17,27,0,12,5,7,61,58,0,2,1,0
"2011","E00016590","E00016590","Total",171,108,44,64,0,22,14,8,41,39,0,2,0,0
"2011","E00016591","E00016591","Total",130,80,43,37,0,28,14,14,20,19,0,1,0,2
"2011","E00016603","E00016603","Total",198,120,49,71,0,36,27,9,41,39,0,2,0,1
"2011","E00016606","E00016606","Total",165,123,45,78,0,13,7,6,29,28,0,1,0,0
"2011","E00016610","E00016610","Total",133,90,30,60,2,11,3,8,30,30,0,0,0,0
"2011","E00016653","E00016653","Total",127,83,21,62,0,14,5,9,28,25,0,2,1,2
"2011","E00016655","E00016655","Total",143,52,8,44,1,11,1,10,78,70,0,7,1,1
"2011","E00016656","E00016656","Total",154,70,27,43,2,17,8,9,63,61,0,2,0,2
"2011","E00016662","E00016662","Total",117,78,24,54,0,11,4,7,27,25,0,2,0,1
"2011","E00016664","E00016664","Total",161,99,27,72,1,12,4,8,49,47,0,2,0,0
"2011","E00016631","E00016631","Total",140,75,23,52,1,25,3,22,38,37,0,1,0,1
"2011","E00016658","E00016658","Total",107,32,16,16,1,5,0,5,68,66,0,2,0,1
"2011","E00016659","E00016659","Total",121,45,8,37,1,39,5,34,35,34,0,0,1,1
"2011","E00016660","E00016660","Total",159,69,17,52,0,42,6,36,48,46,0,1,1,0
"2011","E00016663","E00016663","Total",149,60,14,46,0,33,6,27,54,50,0,4,0,2
"2011","E00016632","E00016632","Total",133,60,17,43,0,21,3,18,51,50,0,1,0,1
"2011","E00016666","E00016666","Total",127,62,22,40,6,22,9,13,36,35,0,1,0,1
"2011","E00016667","E00016667","Total",159,75,20,55,0,29,14,15,54,51,0,3,0,1
"2011","E00016669","E00016669","Total",113,37,5,32,1,39,32,7,36,36,0,0,0,0
"2011","E00016673","E00016673","Total",121,72,17,55,1,18,6,12,29,28,0,1,0,1
"2011","E00016668","E00016668","Total",117,50,17,33,2,46,7,39,19,19,0,0,0,0
"2011","E00016670","E00016670","Total",111,78,34,44,1,9,7,2,21,20,0,1,0,2
"2011","E00016671","E00016671","Total",75,33,15,18,0,28,7,21,14,14,0,0,0,0
"2011","E00016672","E00016672","Total",141,69,21,48,0,28,4,24,43,41,0,0,2,1
"2011","E00173708","E00173708","Total",83,26,4,22,1,4,3,1,52,51,0,1,0,0
"2011","E00173710","E00173710","Total",118,63,20,43,3,16,5,11,35,34,0,1,0,1
"2011","E00016661","E00016661","Total",121,76,26,50,0,19,5,14,23,22,0,0,1,3
"2011","E00173936","E00173936","Total",113,9,0,9,10,70,1,69,24,23,0,1,0,0
"2011","E00173937","E00173937","Total",110,23,5,18,13,4,2,2,69,69,0,0,0,1
"2011","E00173938","E00173938","Total",149,54,8,46,1,5,1,4,87,84,0,2,1,2
"2011","E00174035","E00174035","Total",101,52,5,47,1,2,0,2,46,44,0,2,0,0
"2011","E00016796","E00016796","Total",157,42,10,32,0,75,7,68,39,36,0,1,2,1
"2011","E00016799","E00016799","Total",138,73,20,53,0,20,0,20,45,44,0,1,0,0
"2011","E00016804","E00016804","Total",216,115,78,37,1,19,3,16,77,76,0,1,0,4
"2011","E00016805","E00016805","Total",138,64,27,37,0,38,7,31,36,34,0,0,2,0
"2011","E00016806","E00016806","Total",103,42,14,28,0,34,4,30,25,24,0,1,0,2
"2011","E00016781","E00016781","Total",110,57,24,33,0,32,7,25,20,20,0,0,0,1
"2011","E00016793","E00016793","Total",113,14,6,8,0,89,6,83,9,9,0,0,0,1
"2011","E00016794","E00016794","Total",113,36,9,27,0,38,21,17,36,35,1,0,0,3
"2011","E00016801","E00016801","Total",107,57,22,35,0,18,2,16,32,31,0,0,1,0
"2011","E00016803","E00016803","Total",101,47,17,30,0,27,8,19,25,22,0,3,0,2
"2011","E00016808","E00016808","Total",106,40,13,27,0,30,10,20,32,31,0,1,0,4
"2011","E00016813","E00016813","Total",144,79,16,63,0,27,9,18,38,38,0,0,0,0
"2011","E00016814","E00016814","Total",129,67,30,37,0,26,8,18,34,32,0,2,0,2
"2011","E00016815","E00016815","Total",109,54,17,37,0,22,4,18,32,29,0,3,0,1
"2011","E00016818","E00016818","Total",130,58,17,41,2,35,1,34,34,33,0,1,0,1
"2011","E00016819","E00016819","Total",112,47,17,30,0,34,4,30,30,29,0,1,0,1
"2011","E00016778","E00016778","Total",140,60,15,45,1,34,4,30,42,41,0,1,0,3
"2011","E00016788","E00016788","Total",117,58,25,33,0,33,11,22,26,26,0,0,0,0
"2011","E00016791","E00016791","Total",125,52,15,37,3,31,6,25,37,36,0,0,1,2
"2011","E00016800","E00016800","Total",112,43,9,34,0,28,12,16,41,40,0,1,0,0
"2011","E00016820","E00016820","Total",106,23,6,17,0,44,30,14,38,38,0,0,0,1
"2011","E00016823","E00016823","Total",122,50,13,37,0,37,6,31,34,34,0,0,0,1
"2011","E00016300","E00016300","Total",148,60,14,46,0,6,1,5,79,72,2,5,0,3
"2011","E00016310","E00016310","Total",91,75,34,41,0,4,1,3,11,11,0,0,0,1
"2011","E00016312","E00016312","Total",140,63,17,46,3,22,2,20,51,48,0,3,0,1
"2011","E00016343","E00016343","Total",137,117,56,61,1,2,0,2,16,13,0,3,0,1
"2011","E00016344","E00016344","Total",193,92,23,69,1,14,5,9,84,83,0,1,0,2
"2011","E00016301","E00016301","Total",162,98,31,67,1,14,3,11,47,47,0,0,0,2
"2011","E00016302","E00016302","Total",120,69,20,49,0,29,11,18,21,21,0,0,0,1
"2011","E00016316","E00016316","Total",119,86,39,47,1,14,2,12,16,15,0,1,0,2
"2011","E00016338","E00016338","Total",169,95,26,69,19,22,11,11,33,33,0,0,0,0
"2011","E00016342","E00016342","Total",108,77,32,45,2,5,3,2,23,23,0,0,0,1
"2011","E00016303","E00016303","Total",162,95,30,65,1,28,5,23,38,37,0,0,1,0
"2011","E00016304","E00016304","Total",156,86,28,58,0,22,1,21,46,44,0,1,1,2
"2011","E00016313","E00016313","Total",106,60,14,46,3,3,1,2,40,40,0,0,0,0
"2011","E00016318","E00016318","Total",127,86,20,66,1,10,2,8,29,26,0,2,1,1
"2011","E00016345","E00016345","Total",122,66,23,43,1,9,1,8,46,41,0,5,0,0
"2011","E00016307","E00016307","Total",166,48,12,36,3,74,19,55,37,33,0,2,2,4
"2011","E00016314","E00016314","Total",129,52,17,35,0,52,11,41,23,23,0,0,0,2
"2011","E00016319","E00016319","Total",120,30,10,20,1,63,27,36,23,18,1,3,1,3
"2011","E00016321","E00016321","Total",159,53,18,35,0,23,5,18,83,81,0,2,0,0
"2011","E00016322","E00016322","Total",168,63,19,44,13,44,19,25,44,40,1,2,1,4
"2011","E00016305","E00016305","Total",116,51,19,32,1,38,19,19,23,21,0,2,0,3
"2011","E00016306","E00016306","Total",170,45,8,37,1,96,71,25,28,28,0,0,0,0
"2011","E00016308","E00016308","Total",145,47,15,32,0,39,15,24,58,57,1,0,0,1
"2011","E00016315","E00016315","Total",194,79,28,51,0,67,32,35,48,46,0,0,2,0
"2011","E00016317","E00016317","Total",119,75,21,54,0,14,12,2,30,28,0,2,0,0
"2011","E00016320","E00016320","Total",122,74,22,52,0,14,4,10,32,30,0,1,1,2
"2011","E00016779","E00016779","Total",88,35,8,27,0,21,0,21,32,30,0,0,2,0
"2011","E00016789","E00016789","Total",144,111,49,62,0,2,2,0,30,25,0,4,1,1
"2011","E00016797","E00016797","Total",144,108,51,57,0,13,3,10,19,17,0,2,0,4
"2011","E00016798","E00016798","Total",152,45,13,32,0,19,13,6,86,82,0,4,0,2
"2011","E00016821","E00016821","Total",160,82,30,52,1,33,21,12,43,41,0,1,1,1
"2011","E00016780","E00016780","Total",156,48,11,37,0,31,7,24,74,72,0,1,1,3
"2011","E00016782","E00016782","Total",174,74,23,51,0,29,16,13,71,69,0,0,2,0
"2011","E00016790","E00016790","Total",91,17,5,12,1,20,7,13,52,49,1,1,1,1
"2011","E00016792","E00016792","Total",170,20,5,15,0,35,29,6,115,112,2,0,1,0
"2011","E00016795","E00016795","Total",114,48,17,31,2,31,11,20,30,29,0,1,0,3
"2011","E00016783","E00016783","Total",154,74,27,47,2,47,3,44,31,30,0,0,1,0
"2011","E00016802","E00016802","Total",161,64,17,47,3,46,2,44,48,46,0,2,0,0
"2011","E00016807","E00016807","Total",194,53,16,37,2,64,7,57,74,70,0,2,2,1
"2011","E00016809","E00016809","Total",157,77,20,57,0,34,2,32,46,42,0,1,3,0
"2011","E00016810","E00016810","Total",144,56,15,41,0,29,2,27,58,56,0,2,0,1
"2011","E00016784","E00016784","Total",123,61,24,37,1,30,6,24,31,31,0,0,0,0
"2011","E00016811","E00016811","Total",134,48,19,29,0,28,7,21,57,49,1,5,2,1
"2011","E00016812","E00016812","Total",117,74,30,44,0,16,5,11,26,22,0,4,0,1
"2011","E00016816","E00016816","Total",104,57,21,36,0,17,2,15,29,27,0,2,0,1
"2011","E00016817","E00016817","Total",115,69,27,42,0,17,3,14,28,28,0,0,0,1
"2011","E00016785","E00016785","Total",110,28,14,14,1,45,34,11,35,35,0,0,0,1
"2011","E00016786","E00016786","Total",98,51,20,31,3,23,5,18,21,20,0,1,0,0
"2011","E00016787","E00016787","Total",274,11,6,5,1,238,229,9,20,15,1,3,1,4
"2011","E00016822","E00016822","Total",129,50,14,36,0,33,6,27,44,43,0,1,0,2
"2011","E00016824","E00016824","Total",102,56,20,36,1,11,3,8,31,29,0,0,2,3
"2011","E00016445","E00016445","Total",128,73,27,46,0,28,2,26,25,24,0,0,1,2
"2011","E00016448","E00016448","Total",124,111,53,58,0,6,2,4,7,7,0,0,0,0
"2011","E00016452","E00016452","Total",118,91,55,36,0,3,0,3,23,22,0,1,0,1
"2011","E00016454","E00016454","Total",119,76,32,44,0,20,4,16,23,23,0,0,0,0
"2011","E00016455","E00016455","Total",113,67,25,42,0,23,13,10,19,18,0,1,0,4
"2011","E00016446","E00016446","Total",167,81,30,51,0,20,7,13,65,61,0,3,1,1
"2011","E00016453","E00016453","Total",120,56,21,35,0,32,1,31,32,32,0,0,0,0
"2011","E00016456","E00016456","Total",128,56,19,37,0,32,9,23,40,36,0,3,1,0
"2011","E00016457","E00016457","Total",135,54,19,35,5,10,0,10,66,63,0,3,0,0
"2011","E00016462","E00016462","Total",149,86,23,63,5,6,0,6,50,47,0,2,1,2
"2011","E00173944","E00173944","Total",131,37,7,30,0,7,3,4,86,79,4,1,2,1
"2011","E00173945","E00173945","Total",134,36,7,29,1,28,2,26,67,67,0,0,0,2
"2011","E00016444","E00016444","Total",111,61,21,40,5,18,5,13,27,27,0,0,0,0
"2011","E00016484","E00016484","Total",136,95,44,51,0,7,1,6,32,29,0,2,1,2
"2011","E00016485","E00016485","Total",117,33,13,20,0,65,63,2,19,19,0,0,0,0
"2011","E00016488","E00016488","Total",113,92,44,48,1,5,2,3,13,12,0,0,1,2
"2011","E00016489","E00016489","Total",204,85,32,53,0,32,30,2,84,84,0,0,0,3
"2011","E00016443","E00016443","Total",129,100,38,62,0,20,18,2,7,7,0,0,0,2
"2011","E00016483","E00016483","Total",110,49,18,31,0,29,7,22,30,28,0,2,0,2
"2011","E00016486","E00016486","Total",137,91,33,58,0,26,18,8,18,18,0,0,0,2
"2011","E00016487","E00016487","Total",123,67,26,41,0,46,41,5,10,9,0,1,0,0
"2011","E00016491","E00016491","Total",120,51,15,36,0,40,9,31,28,27,0,1,0,1
"2011","E00016449","E00016449","Total",127,55,19,36,0,29,5,24,42,40,1,1,0,1
"2011","E00016450","E00016450","Total",122,56,20,36,0,20,1,19,46,45,0,1,0,0
"2011","E00016451","E00016451","Total",129,67,24,43,0,34,18,16,27,25,0,2,0,1
"2011","E00016490","E00016490","Total",131,80,19,61,0,23,16,7,28,23,2,3,0,0
"2011","E00016492","E00016492","Total",115,43,20,23,0,46,36,10,25,23,0,1,1,1
"2011","E00016281","E00016281","Total",135,107,38,69,1,12,3,9,15,14,0,0,1,0
"2011","E00016290","E00016290","Total",122,86,29,57,1,9,0,9,26,24,0,2,0,0
"2011","E00016292","E00016292","Total",107,85,27,58,0,6,2,4,16,16,0,0,0,0
"2011","E00016293","E00016293","Total",123,89,35,54,1,10,1,9,23,21,0,1,1,0
"2011","E00016295","E00016295","Total",135,110,29,81,2,5,0,5,17,15,0,2,0,1
"2011","E00016258","E00016258","Total",132,107,40,67,3,7,1,6,15,12,0,3,0,0
"2011","E00016259","E00016259","Total",130,79,26,53,1,33,11,22,15,14,0,1,0,2
"2011","E00016298","E00016298","Total",139,107,38,69,2,8,1,7,21,20,0,1,0,1
"2011","E00016299","E00016299","Total",138,101,38,63,1,17,2,15,18,17,0,1,0,1
"2011","E00016274","E00016274","Total",116,78,29,49,0,16,1,15,22,21,0,1,0,0
"2011","E00016276","E00016276","Total",150,59,16,43,0,40,9,31,48,44,0,4,0,3
"2011","E00016277","E00016277","Total",124,57,26,31,3,29,5,24,34,30,0,4,0,1
"2011","E00016278","E00016278","Total",104,75,20,55,1,9,4,5,18,18,0,0,0,1
"2011","E00016285","E00016285","Total",110,67,18,49,0,15,5,10,27,26,0,1,0,1
"2011","E00016256","E00016256","Total",121,74,29,45,0,22,7,15,21,17,0,1,3,4
"2011","E00016284","E00016284","Total",114,80,24,56,0,16,5,11,16,14,0,2,0,2
"2011","E00016286","E00016286","Total",136,100,32,68,0,7,5,2,28,27,0,1,0,1
"2011","E00016296","E00016296","Total",120,71,18,53,0,19,4,15,28,27,0,0,1,2
"2011","E00016297","E00016297","Total",138,83,41,42,0,28,10,18,25,21,0,3,1,2
"2011","E00016275","E00016275","Total",159,64,21,43,1,40,17,23,52,48,0,4,0,2
"2011","E00016279","E00016279","Total",112,76,25,51,1,10,3,7,25,18,0,4,3,0
"2011","E00016280","E00016280","Total",102,83,26,57,0,2,2,0,11,10,0,1,0,6
"2011","E00016283","E00016283","Total",135,100,28,72,0,12,3,9,23,22,0,0,1,0
"2011","E00016287","E00016287","Total",118,93,24,69,1,6,1,5,18,17,0,1,0,0
"2011","E00016513","E00016513","Total",131,55,23,32,0,28,2,26,48,46,0,2,0,0
"2011","E00016514","E00016514","Total",125,46,15,31,0,61,4,57,16,16,0,0,0,2
"2011","E00016515","E00016515","Total",129,69,29,40,0,41,14,27,18,18,0,0,0,1
"2011","E00016516","E00016516","Total",111,47,17,30,1,44,10,34,17,17,0,0,0,2
"2011","E00016519","E00016519","Total",112,73,24,49,0,13,2,11,25,23,1,1,0,1
"2011","E00016521","E00016521","Total",131,38,11,27,0,54,5,49,39,39,0,0,0,0
"2011","E00016493","E00016493","Total",161,60,10,50,0,63,11,52,34,33,0,1,0,4
"2011","E00016499","E00016499","Total",119,68,34,34,0,22,6,16,26,24,0,2,0,3
"2011","E00016502","E00016502","Total",107,63,21,42,0,30,4,26,14,12,0,2,0,0
"2011","E00016503","E00016503","Total",109,46,5,41,1,19,2,17,43,41,0,1,1,0
"2011","E00016507","E00016507","Total",103,63,14,49,2,14,4,10,24,20,0,4,0,0
"2011","E00016540","E00016540","Total",119,93,50,43,2,3,0,3,19,19,0,0,0,2
"2011","E00016498","E00016498","Total",227,154,59,95,3,38,7,31,30,28,0,2,0,2
"2011","E00016500","E00016500","Total",127,41,17,24,0,69,14,55,16,16,0,0,0,1
"2011","E00016505","E00016505","Total",156,36,14,22,2,79,11,68,37,36,0,1,0,2
"2011","E00016541","E00016541","Total",137,114,46,68,0,7,2,5,14,12,0,1,1,2
"2011","E00016494","E00016494","Total",156,95,35,60,6,5,1,4,47,46,0,1,0,3
"2011","E00016495","E00016495","Total",109,70,11,59,0,5,4,1,30,28,0,2,0,4
"2011","E00016501","E00016501","Total",149,123,55,68,0,7,0,7,18,16,0,2,0,1
"2011","E00016508","E00016508","Total",139,114,47,67,2,9,3,6,12,11,0,1,0,2
"2011","E00016511","E00016511","Total",125,107,38,69,1,3,0,3,13,13,0,0,0,1
"2011","E00016504","E00016504","Total",115,105,53,52,0,3,0,3,6,5,0,1,0,1
"2011","E00016506","E00016506","Total",133,117,52,65,1,1,0,1,14,14,0,0,0,0
"2011","E00016509","E00016509","Total",158,122,60,62,0,17,2,15,19,19,0,0,0,0
"2011","E00016510","E00016510","Total",107,96,50,46,0,0,0,0,10,8,0,2,0,1
"2011","E00016512","E00016512","Total",124,106,45,61,0,4,0,4,13,10,0,3,0,1
"2011","E00016750","E00016750","Total",116,68,16,52,0,7,1,6,38,35,0,2,1,3
"2011","E00016752","E00016752","Total",130,111,58,53,1,0,0,0,16,16,0,0,0,2
"2011","E00016753","E00016753","Total",108,47,14,33,2,34,23,11,25,25,0,0,0,0
"2011","E00016758","E00016758","Total",141,37,12,25,4,72,23,49,25,23,0,2,0,3
"2011","E00016763","E00016763","Total",132,91,24,67,0,17,1,16,24,20,0,3,1,0
"2011","E00016738","E00016738","Total",172,84,23,61,0,45,8,37,43,43,0,0,0,0
"2011","E00016739","E00016739","Total",119,77,27,50,1,29,5,24,11,10,0,0,1,1
"2011","E00016740","E00016740","Total",140,67,21,46,0,32,5,27,40,37,0,2,1,1
"2011","E00016749","E00016749","Total",127,71,16,55,0,27,5,22,29,28,1,0,0,0
"2011","E00016755","E00016755","Total",176,62,17,45,1,58,26,32,55,52,0,3,0,0
"2011","E00016745","E00016745","Total",160,96,20,76,0,35,4,31,27,25,0,1,1,2
"2011","E00016746","E00016746","Total",148,84,22,62,2,35,17,18,26,24,0,2,0,1
"2011","E00016751","E00016751","Total",127,53,18,35,3,29,12,17,40,38,0,1,1,2
"2011","E00016754","E00016754","Total",131,71,22,49,1,14,5,9,44,41,0,3,0,1
"2011","E00016757","E00016757","Total",117,84,25,59,0,6,0,6,24,22,0,1,1,3
"2011","E00016732","E00016732","Total",165,46,8,38,0,19,1,18,100,99,0,1,0,0
"2011","E00016735","E00016735","Total",152,67,22,45,0,40,14,26,44,39,0,5,0,1
"2011","E00016741","E00016741","Total",132,57,15,42,0,42,23,19,30,29,0,1,0,3
"2011","E00016742","E00016742","Total",150,57,12,45,0,48,21,27,44,41,1,1,1,1
"2011","E00016733","E00016733","Total",130,90,31,59,0,22,6,16,16,14,0,1,1,2
"2011","E00016734","E00016734","Total",118,75,24,51,0,14,4,10,29,27,0,2,0,0
"2011","E00016743","E00016743","Total",117,81,28,53,5,6,2,4,25,23,0,2,0,0
"2011","E00016744","E00016744","Total",130,89,37,52,0,21,1,20,20,20,0,0,0,0
"2011","E00016747","E00016747","Total",114,44,17,27,0,29,4,25,39,34,0,5,0,2
"2011","E00016261","E00016261","Total",119,73,25,48,0,21,9,12,23,23,0,0,0,2
"2011","E00016282","E00016282","Total",145,72,15,57,0,23,10,13,49,48,0,1,0,1
"2011","E00016288","E00016288","Total",179,98,24,74,1,15,1,14,62,61,0,1,0,3
"2011","E00016289","E00016289","Total",125,71,17,54,0,22,3,19,32,32,0,0,0,0
"2011","E00016294","E00016294","Total",121,78,22,56,1,23,7,16,19,18,0,1,0,0
"2011","E00016260","E00016260","Total",139,103,33,70,1,18,1,17,16,14,0,2,0,1
"2011","E00016262","E00016262","Total",110,72,29,43,0,7,1,6,31,31,0,0,0,0
"2011","E00016266","E00016266","Total",132,98,35,63,1,15,3,12,16,16,0,0,0,2
"2011","E00016267","E00016267","Total",102,77,31,46,1,11,4,7,12,12,0,0,0,1
"2011","E00016271","E00016271","Total",148,112,49,63,3,6,3,3,23,22,0,1,0,4
"2011","E00016257","E00016257","Total",147,101,30,71,0,21,12,9,23,19,0,4,0,2
"2011","E00016263","E00016263","Total",99,63,27,36,0,23,9,14,12,12,0,0,0,1
"2011","E00016265","E00016265","Total",186,98,32,66,2,33,7,26,51,50,0,0,1,2
"2011","E00016268","E00016268","Total",170,89,39,50,0,45,8,37,36,35,0,0,1,0
"2011","E00016291","E00016291","Total",167,56,15,41,7,30,12,18,69,66,0,0,3,5
"2011","E00016264","E00016264","Total",115,105,53,52,0,2,2,0,7,6,0,1,0,1
"2011","E00016269","E00016269","Total",125,100,36,64,0,7,4,3,16,15,0,0,1,2
"2011","E00016270","E00016270","Total",100,87,40,47,0,2,0,2,9,8,0,1,0,2
"2011","E00016272","E00016272","Total",131,86,43,43,0,3,2,1,42,41,0,1,0,0
"2011","E00016273","E00016273","Total",132,87,29,58,1,13,4,9,29,28,0,1,0,2
"2011","E00016930","E00016930","Total",216,147,65,82,1,39,19,20,26,25,0,0,1,3
"2011","E00016946","E00016946","Total",149,83,23,60,3,44,16,28,18,15,0,3,0,1
"2011","E00016952","E00016952","Total",119,34,11,23,0,73,17,56,11,10,0,0,1,1
"2011","E00016964","E00016964","Total",114,50,11,39,1,47,13,34,16,14,0,2,0,0
"2011","E00016929","E00016929","Total",111,37,14,23,1,56,16,40,16,15,0,0,1,1
"2011","E00016931","E00016931","Total",103,36,11,25,0,57,20,37,10,10,0,0,0,0
"2011","E00016932","E00016932","Total",110,37,9,28,0,60,12,48,13,13,0,0,0,0
"2011","E00016954","E00016954","Total",93,29,10,19,0,51,20,31,13,13,0,0,0,0
"2011","E00016961","E00016961","Total",124,53,21,32,0,49,9,40,20,17,0,2,1,2
"2011","E00016933","E00016933","Total",168,102,30,72,0,45,11,34,20,17,0,3,0,1
"2011","E00016953","E00016953","Total",130,22,4,18,0,87,17,70,17,16,0,0,1,4
"2011","E00016957","E00016957","Total",110,57,17,40,1,38,9,29,14,12,0,2,0,0
"2011","E00016960","E00016960","Total",107,31,11,20,2,52,17,35,21,21,0,0,0,1
"2011","E00016966","E00016966","Total",77,42,11,31,1,19,9,10,13,11,0,2,0,2
"2011","E00016940","E00016940","Total",101,68,18,50,0,6,3,3,25,23,0,2,0,2
"2011","E00016941","E00016941","Total",134,116,44,72,0,7,0,7,11,9,0,1,1,0
"2011","E00016942","E00016942","Total",118,77,25,52,0,7,4,3,33,33,0,0,0,1
"2011","E00016943","E00016943","Total",123,68,9,59,0,4,1,3,48,45,0,3,0,3
"2011","E00016944","E00016944","Total",118,81,35,46,1,10,3,7,26,26,0,0,0,0
"2011","E00016945","E00016945","Total",107,61,3,58,0,10,4,6,36,33,0,1,2,0
"2011","E00016728","E00016728","Total",113,28,13,15,0,71,66,5,14,13,0,1,0,0
"2011","E00016764","E00016764","Total",110,44,15,29,0,36,32,4,27,27,0,0,0,3
"2011","E00016766","E00016766","Total",139,43,17,26,1,74,48,26,19,16,0,1,2,2
"2011","E00016768","E00016768","Total",143,23,8,15,1,111,109,2,7,7,0,0,0,1
"2011","E00016772","E00016772","Total",140,86,32,54,2,22,17,5,29,26,0,3,0,1
"2011","E00016737","E00016737","Total",113,54,18,36,5,36,21,15,17,16,0,1,0,1
"2011","E00016748","E00016748","Total",132,33,5,28,0,73,46,27,24,23,0,1,0,2
"2011","E00016756","E00016756","Total",115,12,0,12,0,80,41,39,22,20,0,1,1,1
"2011","E00016760","E00016760","Total",145,50,17,33,8,51,28,23,35,35,0,0,0,1
"2011","E00173704","E00173704","Total",112,32,13,19,7,21,19,2,48,47,0,1,0,4
"2011","E00173705","E00173705","Total",66,14,0,14,15,21,16,5,15,14,1,0,0,1
"2011","E00173707","E00173707","Total",73,6,3,3,29,0,0,0,36,35,0,1,0,2
"2011","E00016729","E00016729","Total",107,77,41,36,0,21,5,16,9,7,0,1,1,0
"2011","E00016730","E00016730","Total",131,92,46,46,0,13,2,11,26,24,0,2,0,0
"2011","E00016759","E00016759","Total",130,99,50,49,0,10,6,4,21,19,0,1,1,0
"2011","E00016761","E00016761","Total",121,103,40,63,0,3,1,2,13,11,0,2,0,2
"2011","E00016762","E00016762","Total",116,69,31,38,0,19,14,5,27,26,0,1,0,1
"2011","E00016765","E00016765","Total",109,56,20,36,1,7,1,6,43,42,0,1,0,2
"2011","E00016767","E00016767","Total",130,59,14,45,0,40,13,27,30,29,0,1,0,1
"2011","E00016770","E00016770","Total",95,37,10,27,2,2,1,1,54,51,0,2,1,0
"2011","E00016771","E00016771","Total",167,96,32,64,0,41,16,25,29,29,0,0,0,1
"2011","E00016774","E00016774","Total",132,90,40,50,3,16,3,13,22,21,0,1,0,1
"2011","E00016777","E00016777","Total",146,96,35,61,1,14,5,9,34,32,0,2,0,1
"2011","E00016731","E00016731","Total",135,61,16,45,1,32,26,6,39,39,0,0,0,2
"2011","E00016769","E00016769","Total",153,47,9,38,0,75,73,2,31,31,0,0,0,0
"2011","E00016773","E00016773","Total",122,23,8,15,0,83,78,5,14,13,0,1,0,2
"2011","E00016775","E00016775","Total",111,20,6,14,0,83,79,4,7,6,0,1,0,1
"2011","E00016776","E00016776","Total",149,66,19,47,0,44,18,26,37,34,0,3,0,2
"2011","E00016460","E00016460","Total",135,89,45,44,0,25,6,19,21,18,0,0,3,0
"2011","E00016463","E00016463","Total",230,45,13,32,13,95,16,79,74,70,1,2,1,3
"2011","E00016467","E00016467","Total",137,93,42,51,0,20,5,15,24,24,0,0,0,0
"2011","E00016469","E00016469","Total",141,63,26,37,0,38,24,14,39,38,0,1,0,1
"2011","E00016471","E00016471","Total",101,16,5,11,2,68,62,6,14,13,0,1,0,1
"2011","E00016472","E00016472","Total",187,42,24,18,1,104,25,79,40,38,2,0,0,0
"2011","E00016447","E00016447","Total",135,68,20,48,1,32,28,4,33,31,0,2,0,1
"2011","E00016458","E00016458","Total",146,69,14,55,0,49,22,27,26,25,0,0,1,2
"2011","E00016459","E00016459","Total",98,76,41,35,0,4,2,2,17,14,2,1,0,1
"2011","E00016464","E00016464","Total",119,17,1,16,0,89,86,3,12,7,0,4,1,1
"2011","E00016465","E00016465","Total",121,41,16,25,0,70,34,36,6,5,0,0,1,4
"2011","E00016466","E00016466","Total",116,84,44,40,0,12,3,9,19,19,0,0,0,1
"2011","E00016475","E00016475","Total",86,15,5,10,2,58,21,37,10,9,0,1,0,1
"2011","E00016476","E00016476","Total",108,36,5,31,1,47,16,31,23,20,0,1,2,1
"2011","E00016478","E00016478","Total",83,55,22,33,0,12,7,5,16,15,0,1,0,0
"2011","E00016479","E00016479","Total",96,17,4,13,0,72,18,54,6,3,0,1,2,1
"2011","E00016480","E00016480","Total",114,15,3,12,0,90,27,63,7,7,0,0,0,2
"2011","E00016482","E00016482","Total",107,28,11,17,0,53,20,33,26,25,0,1,0,0
"2011","E00016468","E00016468","Total",94,68,35,33,0,7,2,5,17,14,0,2,1,2
"2011","E00016470","E00016470","Total",104,60,21,39,0,27,14,13,14,10,0,1,3,3
"2011","E00016473","E00016473","Total",126,75,17,58,1,29,9,20,16,15,0,1,0,5
"2011","E00016474","E00016474","Total",128,54,17,37,2,17,11,6,50,48,0,1,1,5
"2011","E00016477","E00016477","Total",134,77,24,53,3,23,17,6,29,28,0,0,1,2
"2011","E00016481","E00016481","Total",170,32,9,23,3,19,4,15,113,106,0,2,5,3
"2011","E00016126","E00016126","Total",126,112,58,54,0,7,4,3,7,7,0,0,0,0
"2011","E00016127","E00016127","Total",142,108,45,63,10,9,4,5,12,12,0,0,0,3
"2011","E00016131","E00016131","Total",137,60,19,41,2,60,45,15,14,14,0,0,0,1
"2011","E00016134","E00016134","Total",138,36,14,22,3,85,76,9,14,14,0,0,0,0
"2011","E00016140","E00016140","Total",123,52,11,41,2,42,34,8,25,22,0,3,0,2
"2011","E00016118","E00016118","Total",144,100,45,55,2,22,16,6,20,20,0,0,0,0
"2011","E00016154","E00016154","Total",153,40,17,23,2,83,72,11,28,24,0,3,1,0
"2011","E00016155","E00016155","Total",153,54,15,39,0,27,20,7,72,71,1,0,0,0
"2011","E00016156","E00016156","Total",141,27,6,21,0,102,8,94,12,10,0,1,1,0
"2011","E00016157","E00016157","Total",125,54,19,35,1,58,25,33,11,10,0,1,0,1
"2011","E00016112","E00016112","Total",142,66,11,55,0,41,34,7,34,34,0,0,0,1
"2011","E00016119","E00016119","Total",122,97,47,50,1,4,2,2,20,18,0,2,0,0
"2011","E00016121","E00016121","Total",126,66,16,50,6,17,12,5,36,32,0,4,0,1
"2011","E00016123","E00016123","Total",122,100,36,64,1,6,1,5,12,12,0,0,0,3
"2011","E00016158","E00016158","Total",125,93,28,65,1,8,4,4,23,22,1,0,0,0
"2011","E00016113","E00016113","Total",162,58,18,40,0,82,30,52,19,18,0,1,0,3
"2011","E00016120","E00016120","Total",110,43,13,30,0,53,14,39,14,13,0,0,1,0
"2011","E00016122","E00016122","Total",120,61,15,46,0,50,18,32,9,8,0,1,0,0
"2011","E00016124","E00016124","Total",112,41,13,28,0,55,18,37,14,13,0,1,0,2
"2011","E00016125","E00016125","Total",120,43,14,29,0,53,13,40,23,19,0,4,0,1
"2011","E00016114","E00016114","Total",106,42,9,33,1,51,17,34,12,10,0,2,0,0
"2011","E00016128","E00016128","Total",133,54,13,41,1,60,19,41,17,15,0,2,0,1
"2011","E00016130","E00016130","Total",132,55,14,41,0,59,21,38,16,14,0,1,1,2
"2011","E00016133","E00016133","Total",119,36,8,28,2,70,12,58,11,9,0,1,1,0
"2011","E00016135","E00016135","Total",135,43,11,32,2,72,16,56,17,16,0,0,1,1
"2011","E00016948","E00016948","Total",146,19,3,16,0,99,36,63,25,21,0,4,0,3
"2011","E00016949","E00016949","Total",130,26,9,17,0,81,31,50,22,21,0,1,0,1
"2011","E00016951","E00016951","Total",126,17,2,15,0,88,36,52,20,20,0,0,0,1
"2011","E00016955","E00016955","Total",128,29,9,20,0,82,25,57,17,17,0,0,0,0
"2011","E00016956","E00016956","Total",108,30,10,20,0,68,34,34,9,9,0,0,0,1
"2011","E00016950","E00016950","Total",110,87,45,42,1,8,3,5,12,9,0,3,0,2
"2011","E00016967","E00016967","Total",115,82,33,49,1,14,4,10,18,16,0,1,1,0
"2011","E00016968","E00016968","Total",118,83,41,42,1,19,5,14,14,13,0,0,1,1
"2011","E00016969","E00016969","Total",115,45,23,22,0,56,11,45,13,11,0,1,1,1
"2011","E00016971","E00016971","Total",113,60,27,33,0,41,11,30,12,11,0,1,0,0
"2011","E00016928","E00016928","Total",132,73,17,56,0,37,11,26,20,19,0,1,0,2
"2011","E00016947","E00016947","Total",141,14,8,6,0,122,89,33,3,3,0,0,0,2
"2011","E00016958","E00016958","Total",122,57,14,43,0,50,22,28,14,12,0,1,1,1
"2011","E00016963","E00016963","Total",124,89,39,50,0,19,4,15,15,13,0,2,0,1
"2011","E00016937","E00016937","Total",151,130,80,50,0,4,1,3,10,10,0,0,0,7
"2011","E00016959","E00016959","Total",108,95,56,39,1,3,2,1,8,7,0,1,0,1
"2011","E00016962","E00016962","Total",190,37,14,23,2,126,21,105,23,21,0,0,2,2
"2011","E00016965","E00016965","Total",142,25,11,14,2,94,28,66,19,19,0,0,0,2
"2011","E00016970","E00016970","Total",144,45,17,28,0,81,20,61,18,17,0,1,0,0
"2011","E00016934","E00016934","Total",126,82,35,47,5,13,5,8,23,21,0,2,0,3
"2011","E00016935","E00016935","Total",157,111,45,66,1,16,4,12,27,25,0,2,0,2
"2011","E00016936","E00016936","Total",125,91,33,58,1,12,6,6,21,18,0,3,0,0
"2011","E00016938","E00016938","Total",102,79,39,40,0,6,0,6,17,16,1,0,0,0
"2011","E00016939","E00016939","Total",122,86,33,53,4,6,0,6,24,23,0,0,1,2
"2011","E00016496","E00016496","Total",121,60,22,38,9,33,3,30,19,18,0,0,1,0
"2011","E00016517","E00016517","Total",97,42,14,28,4,40,4,36,11,11,0,0,0,0
"2011","E00016518","E00016518","Total",133,63,26,37,1,41,8,33,28,26,0,2,0,0
"2011","E00016523","E00016523","Total",120,44,15,29,0,52,8,44,20,16,0,4,0,4
"2011","E00016524","E00016524","Total",131,62,26,36,4,26,7,19,38,35,0,3,0,1
"2011","E00016525","E00016525","Total",126,103,75,28,0,9,3,6,12,12,0,0,0,2
"2011","E00016497","E00016497","Total",120,39,8,31,0,24,2,22,57,54,0,3,0,0
"2011","E00016527","E00016527","Total",103,35,7,28,0,7,1,6,60,58,0,2,0,1
"2011","E00016528","E00016528","Total",113,49,8,41,12,8,2,6,44,44,0,0,0,0
"2011","E00016531","E00016531","Total",127,48,17,31,4,58,11,47,16,14,0,2,0,1
"2011","E00016532","E00016532","Total",105,28,4,24,0,39,11,28,37,36,0,1,0,1
"2011","E00016535","E00016535","Total",112,33,6,27,0,43,10,33,36,33,0,2,1,0
"2011","E00016520","E00016520","Total",124,48,21,27,1,66,7,59,8,7,0,1,0,1
"2011","E00016522","E00016522","Total",146,39,14,25,0,96,24,72,9,9,0,0,0,2
"2011","E00016526","E00016526","Total",141,32,16,16,0,87,22,65,21,21,0,0,0,1
"2011","E00016529","E00016529","Total",115,50,16,34,1,53,10,43,11,11,0,0,0,0
"2011","E00016530","E00016530","Total",118,38,20,18,0,69,11,58,11,10,0,1,0,0
"2011","E00016533","E00016533","Total",113,70,29,41,0,31,8,23,11,10,0,0,1,1
"2011","E00016534","E00016534","Total",110,89,48,41,3,9,3,6,9,9,0,0,0,0
"2011","E00016536","E00016536","Total",115,45,12,33,0,58,13,45,10,9,0,1,0,2
"2011","E00016537","E00016537","Total",106,55,18,37,3,30,13,17,17,15,0,1,1,1
"2011","E00016538","E00016538","Total",121,54,10,44,0,58,18,40,9,8,0,1,0,0
"2011","E00016539","E00016539","Total",146,60,20,40,3,74,15,59,8,8,0,0,0,1
"2011","E00016830","E00016830","Total",139,108,47,61,0,7,3,4,23,23,0,0,0,1
"2011","E00016839","E00016839","Total",117,71,9,62,0,18,2,16,28,25,0,2,1,0
"2011","E00016845","E00016845","Total",136,68,17,51,0,40,5,35,28,24,0,4,0,0
"2011","E00016872","E00016872","Total",140,73,27,46,0,38,10,28,25,22,0,2,1,4
"2011","E00016873","E00016873","Total",134,30,4,26,0,72,38,34,30,29,0,0,1,2
"2011","E00016838","E00016838","Total",129,18,8,10,0,100,99,1,7,6,0,0,1,4
"2011","E00016840","E00016840","Total",126,82,45,37,4,16,14,2,24,24,0,0,0,0
"2011","E00016847","E00016847","Total",105,13,6,7,0,84,62,22,8,8,0,0,0,0
"2011","E00016852","E00016852","Total",87,49,21,28,2,10,8,2,25,25,0,0,0,1
"2011","E00016858","E00016858","Total",99,3,1,2,0,92,9,83,4,4,0,0,0,0
"2011","E00016874","E00016874","Total",116,4,4,0,0,100,4,96,7,6,0,0,1,5
"2011","E00016826","E00016826","Total",116,35,14,21,0,65,52,13,14,12,0,1,1,2
"2011","E00016831","E00016831","Total",112,36,15,21,0,56,40,16,18,16,0,1,1,2
"2011","E00016832","E00016832","Total",125,75,46,29,0,34,13,21,14,13,0,1,0,2
"2011","E00016833","E00016833","Total",121,106,55,51,0,2,0,2,13,12,0,1,0,0
"2011","E00016875","E00016875","Total",98,44,15,29,1,37,29,8,14,12,0,2,0,2
"2011","E00016828","E00016828","Total",114,62,22,40,0,23,11,12,25,24,0,0,1,4
"2011","E00016850","E00016850","Total",92,35,10,25,0,40,18,22,16,14,0,2,0,1
"2011","E00016854","E00016854","Total",120,60,16,44,0,47,17,30,12,12,0,0,0,1
"2011","E00016855","E00016855","Total",111,63,6,57,0,8,0,8,39,38,0,1,0,1
"2011","E00016857","E00016857","Total",126,56,18,38,2,43,23,20,25,25,0,0,0,0
"2011","E00016878","E00016878","Total",116,23,4,19,0,79,70,9,12,12,0,0,0,2
"2011","E00016827","E00016827","Total",134,59,21,38,2,32,12,20,40,38,0,1,1,1
"2011","E00016834","E00016834","Total",139,46,11,35,1,48,18,30,43,39,0,4,0,1
"2011","E00016842","E00016842","Total",100,46,17,29,0,42,35,7,12,11,0,1,0,0
"2011","E00016856","E00016856","Total",188,55,12,43,1,17,15,2,113,107,0,6,0,2
"2011","E00016876","E00016876","Total",106,20,3,17,1,65,17,48,17,14,0,1,2,3
"2011","E00016877","E00016877","Total",111,34,10,24,0,63,60,3,13,13,0,0,0,1
"2011","E00016115","E00016115","Total",125,33,8,25,1,76,20,56,14,10,0,4,0,1
"2011","E00016136","E00016136","Total",119,37,8,29,0,69,24,45,12,12,0,0,0,1
"2011","E00016137","E00016137","Total",129,51,16,35,0,62,16,46,13,12,0,1,0,3
"2011","E00016138","E00016138","Total",122,39,8,31,0,68,32,36,14,11,0,1,2,1
"2011","E00016139","E00016139","Total",129,52,15,37,1,68,23,45,7,7,0,0,0,1
"2011","E00016116","E00016116","Total",134,92,26,66,1,14,6,8,27,26,0,1,0,0
"2011","E00016129","E00016129","Total",141,65,25,40,0,41,14,27,34,31,0,2,1,1
"2011","E00016142","E00016142","Total",140,22,10,12,1,101,79,22,13,13,0,0,0,3
"2011","E00016144","E00016144","Total",119,24,8,16,0,87,44,43,6,5,0,0,1,2
"2011","E00016145","E00016145","Total",137,10,4,6,0,104,101,3,23,23,0,0,0,0
"2011","E00016150","E00016150","Total",138,20,6,14,0,97,93,4,20,18,0,2,0,1
"2011","E00016117","E00016117","Total",147,62,27,35,1,53,10,43,29,24,0,3,2,2
"2011","E00016132","E00016132","Total",127,62,19,43,11,25,8,17,27,26,0,1,0,2
"2011","E00016143","E00016143","Total",113,57,15,42,0,47,17,30,9,7,0,1,1,0
"2011","E00016147","E00016147","Total",153,57,24,33,8,70,12,58,18,17,0,0,1,0
"2011","E00016153","E00016153","Total",125,30,13,17,0,82,8,74,13,11,0,2,0,0
"2011","E00016141","E00016141","Total",118,41,20,21,1,66,22,44,8,8,0,0,0,2
"2011","E00016146","E00016146","Total",127,37,17,20,0,70,28,42,18,17,0,0,1,2
"2011","E00016148","E00016148","Total",127,43,9,34,10,62,21,41,11,9,0,2,0,1
"2011","E00016149","E00016149","Total",132,26,2,24,1,89,37,52,15,14,0,1,0,1
"2011","E00016151","E00016151","Total",112,26,6,20,0,74,31,43,12,10,0,2,0,0
"2011","E00016152","E00016152","Total",125,23,4,19,0,88,28,60,13,10,1,1,1,1
"2011","E00016843","E00016843","Total",106,59,23,36,0,20,14,6,26,22,0,3,1,1
"2011","E00016863","E00016863","Total",146,49,10,39,9,33,5,28,55,53,0,1,1,0
"2011","E00016868","E00016868","Total",128,55,27,28,2,50,32,18,20,20,0,0,0,1
"2011","E00016870","E00016870","Total",139,81,31,50,1,25,8,17,31,31,0,0,0,1
"2011","E00016871","E00016871","Total",119,68,33,35,0,39,28,11,11,10,0,0,1,1
"2011","E00016848","E00016848","Total",98,70,27,43,1,19,2,17,7,7,0,0,0,1
"2011","E00016859","E00016859","Total",146,99,49,50,0,10,3,7,36,34,0,2,0,1
"2011","E00016861","E00016861","Total",181,70,23,47,0,34,16,18,73,66,1,5,1,4
"2011","E00016862","E00016862","Total",141,69,19,50,0,33,10,23,38,36,0,2,0,1
"2011","E00016866","E00016866","Total",148,62,24,38,0,39,21,18,46,40,2,1,3,1
"2011","E00016829","E00016829","Total",135,54,9,45,0,29,17,12,52,50,0,1,1,0
"2011","E00016851","E00016851","Total",134,109,47,62,0,7,3,4,15,15,0,0,0,3
"2011","E00016860","E00016860","Total",155,44,11,33,1,45,30,15,64,64,0,0,0,1
"2011","E00016864","E00016864","Total",154,57,17,40,0,71,65,6,25,23,0,2,0,1
"2011","E00016867","E00016867","Total",132,74,32,42,1,33,22,11,23,22,0,1,0,1
"2011","E00016869","E00016869","Total",123,26,3,23,2,78,48,30,17,17,0,0,0,0
"2011","E00016835","E00016835","Total",151,69,20,49,1,50,26,24,31,31,0,0,0,0
"2011","E00016837","E00016837","Total",125,72,23,49,0,19,16,3,34,30,0,4,0,0
"2011","E00016846","E00016846","Total",140,75,26,49,3,20,12,8,38,37,0,1,0,4
"2011","E00016849","E00016849","Total",102,28,1,27,0,35,16,19,39,37,0,0,2,0
"2011","E00016865","E00016865","Total",139,62,23,39,0,55,5,50,21,20,0,1,0,1
"2011","E00016825","E00016825","Total",113,19,3,16,0,73,66,7,20,20,0,0,0,1
"2011","E00016836","E00016836","Total",124,67,30,37,0,46,22,24,9,9,0,0,0,2
"2011","E00016841","E00016841","Total",130,28,8,20,0,92,80,12,9,9,0,0,0,1
"2011","E00016844","E00016844","Total",111,63,28,35,0,38,11,27,10,10,0,0,0,0
"2011","E00016853","E00016853","Total",116,12,7,5,2,89,86,3,13,13,0,0,0,0
"2011","E00016350","E00016350","Total",133,55,17,38,1,58,13,45,18,17,0,1,0,1
"2011","E00016369","E00016369","Total",132,50,13,37,1,61,27,34,19,18,0,1,0,1
"2011","E00016370","E00016370","Total",144,54,16,38,0,57,15,42,33,33,0,0,0,0
"2011","E00016371","E00016371","Total",119,57,17,40,0,40,13,27,22,20,0,2,0,0
"2011","E00016374","E00016374","Total",120,44,20,24,0,60,21,39,16,14,0,2,0,0
"2011","E00016352","E00016352","Total",110,49,10,39,0,48,13,35,13,13,0,0,0,0
"2011","E00016373","E00016373","Total",123,44,14,30,1,49,11,38,27,24,1,2,0,2
"2011","E00016378","E00016378","Total",125,51,16,35,2,60,16,44,12,11,0,1,0,0
"2011","E00016381","E00016381","Total",143,55,20,35,1,49,21,28,37,33,0,0,4,1
"2011","E00016382","E00016382","Total",107,53,20,33,2,40,11,29,11,9,0,1,1,1
"2011","E00016348","E00016348","Total",91,47,15,32,9,25,9,16,10,10,0,0,0,0
"2011","E00016372","E00016372","Total",118,44,7,37,3,53,19,34,17,16,0,0,1,1
"2011","E00016375","E00016375","Total",105,53,13,40,0,30,12,18,21,18,0,2,1,1
"2011","E00016377","E00016377","Total",120,49,15,34,1,56,22,34,14,12,0,1,1,0
"2011","E00016379","E00016379","Total",131,60,30,30,0,58,36,22,13,10,0,3,0,0
"2011","E00016349","E00016349","Total",125,53,14,39,0,58,21,37,13,11,0,1,1,1
"2011","E00016351","E00016351","Total",196,76,17,59,0,102,35,67,15,14,0,1,0,3
"2011","E00016376","E00016376","Total",111,49,20,29,0,47,12,35,13,12,0,1,0,2
"2011","E00016383","E00016383","Total",132,67,18,49,0,50,15,35,15,15,0,0,0,0
"2011","E00016356","E00016356","Total",136,67,15,52,2,58,17,41,8,7,0,0,1,1
"2011","E00016387","E00016387","Total",146,62,23,39,1,61,21,40,20,17,0,3,0,2
"2011","E00016393","E00016393","Total",118,55,18,37,2,45,20,25,16,16,0,0,0,0
"2011","E00165790","E00165790","Total",108,46,14,32,0,51,12,39,11,10,0,1,0,0
"2011","E00016361","E00016361","Total",104,48,22,26,0,29,13,16,27,24,1,2,0,0
"2011","E00016363","E00016363","Total",139,65,25,40,0,66,18,48,5,5,0,0,0,3
"2011","E00016366","E00016366","Total",99,80,33,47,0,17,4,13,2,2,0,0,0,0
"2011","E00016367","E00016367","Total",81,51,23,28,0,18,2,16,9,8,0,0,1,3
"2011","E00016368","E00016368","Total",100,72,21,51,0,21,4,17,7,6,0,0,1,0
"2011","E00016353","E00016353","Total",117,57,19,38,0,46,18,28,13,12,0,1,0,1
"2011","E00016360","E00016360","Total",194,82,20,62,8,55,21,34,47,44,0,3,0,2
"2011","E00016380","E00016380","Total",100,43,11,32,0,42,12,30,12,11,0,1,0,3
"2011","E00016389","E00016389","Total",110,46,19,27,1,50,13,37,11,11,0,0,0,2
"2011","E00016390","E00016390","Total",85,50,20,30,1,23,8,15,10,8,0,2,0,1
"2011","E00016392","E00016392","Total",119,51,10,41,0,61,26,35,7,6,0,1,0,0
"2011","E00016359","E00016359","Total",120,82,39,43,0,27,4,23,9,9,0,0,0,2
"2011","E00016384","E00016384","Total",121,85,32,53,0,15,6,9,20,19,0,1,0,1
"2011","E00016385","E00016385","Total",177,31,10,21,1,132,40,92,10,9,0,1,0,3
"2011","E00016386","E00016386","Total",145,16,4,12,0,114,33,81,14,10,0,4,0,1
"2011","E00016388","E00016388","Total",132,105,50,55,0,10,4,6,16,16,0,0,0,1
"2011","E00016346","E00016346","Total",106,48,21,27,0,38,9,29,15,13,0,1,1,5
"2011","E00016354","E00016354","Total",104,24,9,15,0,39,5,34,36,33,0,2,1,5
"2011","E00016357","E00016357","Total",131,23,5,18,1,96,40,56,10,10,0,0,0,1
"2011","E00016358","E00016358","Total",122,39,9,30,6,35,10,25,39,29,1,7,2,3
"2011","E00016391","E00016391","Total",118,97,40,57,2,3,0,3,16,14,0,2,0,0
"2011","E00016362","E00016362","Total",131,64,21,43,4,46,11,35,15,14,0,0,1,2
"2011","E00016364","E00016364","Total",126,59,17,42,0,51,20,31,14,11,0,2,1,2
"2011","E00016365","E00016365","Total",109,34,12,22,0,66,14,52,7,7,0,0,0,2
"2011","E00016394","E00016394","Total",120,60,14,46,0,47,13,34,13,12,0,1,0,0
"2011","E00165789","E00165789","Total",158,27,7,20,0,113,23,90,15,9,0,0,6,3
"2011","E00016678","E00016678","Total",105,20,9,11,1,73,67,6,9,9,0,0,0,2
"2011","E00016722","E00016722","Total",150,16,3,13,1,115,64,51,12,9,0,3,0,6
"2011","E00016724","E00016724","Total",110,39,5,34,5,20,11,9,46,45,0,1,0,0
"2011","E00016727","E00016727","Total",110,26,7,19,0,62,58,4,22,20,0,2,0,0
"2011","E00016676","E00016676","Total",96,24,10,14,0,50,37,13,18,17,0,1,0,4
"2011","E00016685","E00016685","Total",127,28,10,18,1,83,43,40,15,13,0,1,1,0
"2011","E00016690","E00016690","Total",128,14,4,10,0,103,58,45,8,8,0,0,0,3
"2011","E00016691","E00016691","Total",108,44,12,32,0,37,29,8,27,25,2,0,0,0
"2011","E00016726","E00016726","Total",102,3,0,3,1,85,78,7,11,10,0,1,0,2
"2011","E00016688","E00016688","Total",107,42,17,25,0,51,50,1,13,10,0,2,1,1
"2011","E00016695","E00016695","Total",108,39,18,21,0,47,43,4,21,20,0,1,0,1
"2011","E00016705","E00016705","Total",124,28,7,21,0,22,8,14,72,71,0,0,1,2
"2011","E00016710","E00016710","Total",124,31,11,20,1,53,47,6,39,38,0,1,0,0
"2011","E00016712","E00016712","Total",97,12,0,12,0,40,33,7,45,41,0,1,3,0
"2011","E00016682","E00016682","Total",129,46,9,37,1,5,4,1,74,70,0,4,0,3
"2011","E00016686","E00016686","Total",133,29,7,22,0,72,71,1,29,29,0,0,0,3
"2011","E00016699","E00016699","Total",126,34,5,29,0,60,50,10,27,26,0,1,0,5
"2011","E00016702","E00016702","Total",186,16,3,13,1,128,27,101,40,39,0,1,0,1
"2011","E00016707","E00016707","Total",183,31,9,22,0,32,28,4,118,113,0,4,1,2
"2011","E00016711","E00016711","Total",146,35,8,27,1,21,6,15,88,85,0,2,1,1
"2011","E00016696","E00016696","Total",104,25,10,15,1,54,52,2,23,23,0,0,0,1
"2011","E00016698","E00016698","Total",160,34,13,21,0,86,73,13,39,37,0,2,0,1
"2011","E00016703","E00016703","Total",112,19,8,11,1,67,65,2,21,19,0,1,1,4
"2011","E00016713","E00016713","Total",223,21,4,17,7,101,46,55,91,86,2,2,1,3
"2011","E00165804","E00165804","Total",112,29,12,17,2,51,47,4,27,25,0,2,0,3
"2011","E00017907","E00017907","Total",126,84,40,44,0,14,7,7,27,26,0,1,0,1
"2011","E00017908","E00017908","Total",113,66,29,37,0,12,2,10,35,34,0,1,0,0
"2011","E00017909","E00017909","Total",119,35,12,23,1,41,35,6,41,40,0,1,0,1
"2011","E00017917","E00017917","Total",135,63,34,29,2,24,6,18,44,42,0,2,0,2
"2011","E00174982","E00174982","Total",111,17,6,11,9,32,4,28,52,52,0,0,0,1
"2011","E00174983","E00174983","Total",111,48,14,34,1,22,3,19,39,39,0,0,0,1
"2011","E00174984","E00174984","Total",135,1,0,1,25,94,1,93,15,15,0,0,0,0
"2011","E00017901","E00017901","Total",141,55,25,30,3,22,5,17,57,56,0,1,0,4
"2011","E00017915","E00017915","Total",128,56,25,31,0,28,14,14,44,44,0,0,0,0
"2011","E00017921","E00017921","Total",134,46,22,24,1,29,9,20,54,54,0,0,0,4
"2011","E00017923","E00017923","Total",146,39,8,31,20,37,5,32,48,47,0,0,1,2
"2011","E00017930","E00017930","Total",115,48,24,24,0,12,2,10,54,47,0,0,7,1
"2011","E00017910","E00017910","Total",119,42,14,28,2,34,20,14,41,39,0,2,0,0
"2011","E00017913","E00017913","Total",114,43,10,33,1,40,33,7,29,27,1,1,0,1
"2011","E00017914","E00017914","Total",99,39,16,23,2,25,7,18,31,28,0,3,0,2
"2011","E00017920","E00017920","Total",111,42,18,24,1,36,28,8,30,30,0,0,0,2
"2011","E00017926","E00017926","Total",145,29,7,22,1,83,63,20,30,28,0,1,1,2
"2011","E00017899","E00017899","Total",121,21,4,17,0,74,64,10,23,21,0,1,1,3
"2011","E00017903","E00017903","Total",190,101,43,58,0,26,12,14,62,61,0,1,0,1
"2011","E00017904","E00017904","Total",93,45,20,25,0,15,3,12,33,31,1,1,0,0
"2011","E00017905","E00017905","Total",103,26,6,20,0,43,38,5,31,30,0,1,0,3
"2011","E00017911","E00017911","Total",124,53,22,31,0,24,12,12,46,42,0,3,1,1
"2011","E00018053","E00018053","Total",143,23,4,19,0,87,84,3,30,30,0,0,0,3
"2011","E00018054","E00018054","Total",150,19,7,12,1,40,27,13,87,86,0,1,0,3
"2011","E00018055","E00018055","Total",96,10,3,7,0,77,76,1,8,8,0,0,0,1
"2011","E00018057","E00018057","Total",150,33,7,26,1,92,86,6,23,22,0,0,1,1
"2011","E00018067","E00018067","Total",171,49,24,25,0,49,20,29,70,68,0,2,0,3
"2011","E00018062","E00018062","Total",122,58,28,30,0,16,4,12,47,46,0,0,1,1
"2011","E00018064","E00018064","Total",125,64,30,34,3,11,5,6,44,40,0,4,0,3
"2011","E00018071","E00018071","Total",121,47,14,33,0,14,5,9,58,55,0,1,2,2
"2011","E00018072","E00018072","Total",118,49,21,28,0,14,10,4,54,54,0,0,0,1
"2011","E00018068","E00018068","Total",123,54,22,32,0,9,4,5,58,57,0,0,1,2
"2011","E00018070","E00018070","Total",123,50,18,32,0,27,17,10,45,44,0,1,0,1
"2011","E00018073","E00018073","Total",134,28,9,19,0,81,75,6,24,21,0,2,1,1
"2011","E00018074","E00018074","Total",119,45,18,27,0,33,25,8,39,38,0,0,1,2
"2011","E00018076","E00018076","Total",121,53,15,38,3,8,3,5,56,56,0,0,0,1
"2011","E00018078","E00018078","Total",151,42,22,20,0,27,21,6,79,78,0,0,1,3
"2011","E00018079","E00018079","Total",131,71,34,37,0,14,13,1,42,40,0,2,0,4
"2011","E00018082","E00018082","Total",136,66,29,37,2,13,7,6,52,48,0,2,2,3
"2011","E00018058","E00018058","Total",150,42,15,27,0,26,10,16,75,71,0,1,3,7
"2011","E00018061","E00018061","Total",106,32,14,18,2,14,9,5,56,53,0,1,2,2
"2011","E00018063","E00018063","Total",195,44,17,27,1,44,19,25,101,100,1,0,0,5
"2011","E00018066","E00018066","Total",150,33,13,20,3,20,7,13,94,90,0,4,0,0
"2011","E00018089","E00018089","Total",94,60,24,36,0,10,8,2,23,21,0,2,0,1
"2011","E00018094","E00018094","Total",137,62,25,37,2,27,10,17,45,44,0,0,1,1
"2011","E00018097","E00018097","Total",158,82,29,53,2,11,0,11,61,60,1,0,0,2
"2011","E00018098","E00018098","Total",131,71,33,38,10,21,10,11,29,28,0,0,1,0
"2011","E00018101","E00018101","Total",118,51,17,34,6,28,15,13,28,28,0,0,0,5
"2011","E00018106","E00018106","Total",161,63,31,32,1,22,10,12,73,70,0,2,1,2
"2011","E00018107","E00018107","Total",101,49,21,28,1,10,2,8,40,36,0,3,1,1
"2011","E00018108","E00018108","Total",121,55,17,38,1,15,2,13,48,46,0,1,1,2
"2011","E00018109","E00018109","Total",126,59,22,37,0,8,3,5,59,56,1,0,2,0
"2011","E00018083","E00018083","Total",136,26,6,20,2,82,34,48,24,22,1,1,0,2
"2011","E00018084","E00018084","Total",143,30,9,21,7,88,26,62,17,17,0,0,0,1
"2011","E00018088","E00018088","Total",140,48,26,22,1,49,47,2,41,39,0,1,1,1
"2011","E00018092","E00018092","Total",153,31,12,19,0,80,46,34,40,39,0,0,1,2
"2011","E00018069","E00018069","Total",103,40,20,20,0,20,20,0,43,42,0,1,0,0
"2011","E00018075","E00018075","Total",131,48,22,26,1,40,32,8,40,39,0,0,1,2
"2011","E00018077","E00018077","Total",149,70,29,41,8,13,7,6,52,50,0,1,1,6
"2011","E00018081","E00018081","Total",116,46,18,28,0,22,14,8,44,42,1,1,0,4
"2011","E00018093","E00018093","Total",119,67,30,37,0,7,5,2,45,44,0,1,0,0
"2011","E00018100","E00018100","Total",125,74,37,37,1,12,7,5,37,35,0,2,0,1
"2011","E00175019","E00175019","Total",83,46,25,21,1,8,1,7,28,26,0,1,1,0
"2011","E00175061","E00175061","Total",80,33,12,21,1,7,5,2,37,35,0,1,1,2
"2011","E00018102","E00018102","Total",162,65,19,46,2,35,28,7,57,54,0,2,1,3
"2011","E00018104","E00018104","Total",130,15,1,14,1,55,4,51,56,55,1,0,0,3
"2011","E00018105","E00018105","Total",153,46,10,36,1,59,31,28,43,42,0,1,0,4
"2011","E00018112","E00018112","Total",100,46,27,19,1,18,8,10,34,33,0,0,1,1
"2011","E00175056","E00175056","Total",177,46,14,32,10,25,11,14,95,89,0,5,1,1
"2011","E00175083","E00175083","Total",101,19,1,18,4,44,8,36,33,33,0,0,0,1
"2011","E00018090","E00018090","Total",122,26,13,13,0,12,6,6,84,81,0,2,1,0
"2011","E00018091","E00018091","Total",143,31,13,18,3,46,36,10,63,57,0,5,1,0
"2011","E00018095","E00018095","Total",120,67,30,37,0,16,8,8,35,33,0,2,0,2
"2011","E00018096","E00018096","Total",158,30,7,23,2,83,79,4,42,40,0,1,1,1
"2011","E00018099","E00018099","Total",128,27,6,21,1,46,39,7,53,51,0,2,0,1
"2011","E00017833","E00017833","Total",133,78,35,43,0,15,7,8,38,35,0,2,1,2
"2011","E00017835","E00017835","Total",147,20,9,11,0,106,103,3,18,18,0,0,0,3
"2011","E00017857","E00017857","Total",151,19,4,15,0,122,119,3,9,9,0,0,0,1
"2011","E00018045","E00018045","Total",148,84,40,44,2,18,6,12,41,40,1,0,0,3
"2011","E00018047","E00018047","Total",154,66,24,42,0,21,18,3,66,65,0,1,0,1
"2011","E00018051","E00018051","Total",75,37,6,31,0,25,22,3,13,11,0,2,0,0
"2011","E00018052","E00018052","Total",114,50,21,29,0,30,24,6,33,33,0,0,0,1
"2011","E00018046","E00018046","Total",144,20,5,15,5,108,93,15,8,8,0,0,0,3
"2011","E00018056","E00018056","Total",137,17,4,13,0,94,91,3,25,25,0,0,0,1
"2011","E00018059","E00018059","Total",122,22,6,16,5,71,56,15,22,22,0,0,0,2
"2011","E00018060","E00018060","Total",173,38,9,29,5,99,83,16,28,27,0,0,1,3
"2011","E00018065","E00018065","Total",97,7,1,6,0,73,72,1,14,13,0,1,0,3
"2011","E00018044","E00018044","Total",153,39,13,26,2,63,35,28,47,46,0,1,0,2
"2011","E00018048","E00018048","Total",105,38,16,22,0,53,51,2,12,11,0,0,1,2
"2011","E00018049","E00018049","Total",140,49,13,36,0,35,21,14,55,53,1,1,0,1
"2011","E00018050","E00018050","Total",99,56,16,40,2,14,9,5,24,23,0,1,0,3
"2011","E00018080","E00018080","Total",118,43,18,25,1,23,16,7,50,47,0,2,1,1
"2011","E00017900","E00017900","Total",138,10,1,9,2,99,24,75,27,27,0,0,0,0
"2011","E00017925","E00017925","Total",128,21,9,12,12,68,14,54,26,25,0,0,1,1
"2011","E00017931","E00017931","Total",133,32,13,19,3,52,37,15,45,45,0,0,0,1
"2011","E00017932","E00017932","Total",111,25,11,14,3,45,5,40,38,37,0,1,0,0
"2011","E00017935","E00017935","Total",134,77,38,39,0,12,4,8,42,39,0,1,2,3
"2011","E00017918","E00017918","Total",130,53,14,39,0,17,3,14,59,59,0,0,0,1
"2011","E00017924","E00017924","Total",154,17,10,7,2,80,24,56,48,47,0,1,0,7
"2011","E00017927","E00017927","Total",150,51,14,37,2,25,15,10,71,70,0,1,0,1
"2011","E00017928","E00017928","Total",107,25,7,18,0,39,34,5,40,40,0,0,0,3
"2011","E00017934","E00017934","Total",157,77,31,46,0,14,7,7,65,64,0,0,1,1
"2011","E00017937","E00017937","Total",154,46,17,29,3,33,18,15,72,71,0,0,1,0
"2011","E00017898","E00017898","Total",133,39,17,22,0,51,43,8,42,40,0,2,0,1
"2011","E00017933","E00017933","Total",140,31,12,19,1,77,69,8,30,30,0,0,0,1
"2011","E00017936","E00017936","Total",112,49,34,15,7,17,1,16,37,36,0,0,1,2
"2011","E00017938","E00017938","Total",117,28,11,17,1,60,50,10,26,24,0,0,2,2
"2011","E00174986","E00174986","Total",155,25,6,19,23,32,1,31,75,72,0,3,0,0
"2011","E00175027","E00175027","Total",133,39,16,23,4,38,37,1,52,50,0,2,0,0
"2011","E00017940","E00017940","Total",155,44,20,24,2,49,8,41,56,53,1,1,1,4
"2011","E00017948","E00017948","Total",75,16,7,9,0,11,6,5,48,46,0,1,1,0
"2011","E00017953","E00017953","Total",140,37,15,22,0,47,17,30,55,53,0,2,0,1
"2011","E00017954","E00017954","Total",130,35,14,21,0,32,8,24,63,59,1,3,0,0
"2011","E00017955","E00017955","Total",151,37,16,21,0,24,3,21,87,87,0,0,0,3
"2011","E00017906","E00017906","Total",125,83,32,51,1,25,9,16,15,14,0,1,0,1
"2011","E00017912","E00017912","Total",149,84,27,57,0,17,3,14,46,41,0,3,2,2
"2011","E00017916","E00017916","Total",140,86,37,49,0,18,2,16,33,31,0,2,0,3
"2011","E00017919","E00017919","Total",115,67,25,42,0,16,4,12,30,29,0,0,1,2
"2011","E00017922","E00017922","Total",170,70,27,43,1,53,8,45,46,42,0,4,0,0
"2011","E00017946","E00017946","Total",116,63,30,33,0,22,9,13,30,30,0,0,0,1
"2011","E00017950","E00017950","Total",154,55,28,27,0,17,8,9,77,75,0,2,0,5
"2011","E00017979","E00017979","Total",113,71,32,39,1,13,6,7,28,26,0,2,0,0
"2011","E00017980","E00017980","Total",117,58,27,31,0,24,7,17,35,34,0,1,0,0
"2011","E00017984","E00017984","Total",118,34,13,21,0,16,5,11,68,67,0,0,1,0
"2011","E00017987","E00017987","Total",108,67,32,35,1,6,1,5,33,31,0,1,1,1
"2011","E00017990","E00017990","Total",144,65,34,31,0,15,7,8,63,59,0,4,0,1
"2011","E00018010","E00018010","Total",111,71,30,41,0,6,5,1,34,31,0,0,3,0
"2011","E00017981","E00017981","Total",134,22,8,14,3,40,30,10,64,60,0,2,2,5
"2011","E00017986","E00017986","Total",129,64,34,30,2,13,6,7,48,43,0,5,0,2
"2011","E00018011","E00018011","Total",160,57,34,23,10,25,9,16,66,62,0,1,3,2
"2011","E00018012","E00018012","Total",117,40,21,19,2,13,5,8,60,58,1,1,0,2
"2011","E00017939","E00017939","Total",86,24,8,16,1,20,3,17,41,40,0,1,0,0
"2011","E00017947","E00017947","Total",152,35,12,23,1,47,33,14,66,62,0,2,2,3
"2011","E00017949","E00017949","Total",80,23,8,15,0,41,27,14,15,13,0,2,0,1
"2011","E00017952","E00017952","Total",127,12,3,9,0,93,76,17,21,21,0,0,0,1
"2011","E00174979","E00174979","Total",113,39,16,23,9,37,19,18,26,23,0,2,1,2
"2011","E00174981","E00174981","Total",71,1,0,1,0,20,2,18,50,43,0,0,7,0
"2011","E00017957","E00017957","Total",117,14,7,7,2,28,11,17,70,65,0,2,3,3
"2011","E00017962","E00017962","Total",102,48,23,25,0,24,9,15,30,30,0,0,0,0
"2011","E00017967","E00017967","Total",136,18,8,10,3,10,4,6,101,98,1,1,1,4
"2011","E00017973","E00017973","Total",136,81,42,39,0,16,4,12,39,38,0,1,0,0
"2011","E00018013","E00018013","Total",168,49,19,30,0,28,7,21,87,86,0,0,1,4
"2011","E00018017","E00018017","Total",164,61,27,34,1,32,17,15,66,64,0,0,2,4
"2011","E00018042","E00018042","Total",110,41,18,23,0,10,0,10,58,57,0,0,1,1
"2011","E00018043","E00018043","Total",143,87,37,50,1,15,5,10,38,35,0,3,0,2
"2011","E00018014","E00018014","Total",146,78,41,37,0,12,4,8,54,53,0,1,0,2
"2011","E00018018","E00018018","Total",141,73,45,28,1,15,5,10,47,44,0,2,1,5
"2011","E00018019","E00018019","Total",154,45,23,22,0,16,5,11,88,82,1,4,1,5
"2011","E00018021","E00018021","Total",145,62,26,36,3,9,3,6,71,68,0,3,0,0
"2011","E00018020","E00018020","Total",111,58,35,23,1,7,2,5,45,45,0,0,0,0
"2011","E00018022","E00018022","Total",129,42,25,17,1,29,8,21,56,54,0,1,1,1
"2011","E00018024","E00018024","Total",99,58,36,22,2,9,2,7,29,27,0,0,2,1
"2011","E00018025","E00018025","Total",107,51,22,29,1,13,5,8,41,35,1,4,1,1
"2011","E00017941","E00017941","Total",168,27,13,14,13,41,1,40,87,86,0,1,0,0
"2011","E00017943","E00017943","Total",107,22,6,16,1,17,6,11,67,65,0,2,0,0
"2011","E00017965","E00017965","Total",118,38,12,26,0,48,5,43,30,30,0,0,0,2
"2011","E00017970","E00017970","Total",80,35,16,19,0,13,9,4,30,30,0,0,0,2
"2011","E00017974","E00017974","Total",113,56,25,31,1,11,3,8,45,45,0,0,0,0
"2011","E00017942","E00017942","Total",176,44,18,26,0,44,22,22,87,85,0,2,0,1
"2011","E00017958","E00017958","Total",118,37,11,26,2,44,35,9,34,30,0,2,2,1
"2011","E00017961","E00017961","Total",148,24,10,14,1,51,48,3,69,68,0,1,0,3
"2011","E00017963","E00017963","Total",147,21,5,16,2,86,51,35,37,37,0,0,0,1
"2011","E00017968","E00017968","Total",144,15,5,10,2,100,100,0,24,23,0,1,0,3
"2011","E00017945","E00017945","Total",146,44,20,24,1,42,3,39,54,52,0,0,2,5
"2011","E00017972","E00017972","Total",125,64,29,35,1,17,9,8,43,41,0,1,1,0
"2011","E00017975","E00017975","Total",113,42,25,17,1,25,3,22,44,42,0,2,0,1
"2011","E00017977","E00017977","Total",127,48,21,27,0,20,4,16,57,56,0,1,0,2
"2011","E00017978","E00017978","Total",112,35,20,15,0,29,20,9,48,41,0,4,3,0
"2011","E00017956","E00017956","Total",140,37,11,26,4,44,11,33,54,53,0,1,0,1
"2011","E00017959","E00017959","Total",230,70,35,35,28,50,7,43,81,77,0,4,0,1
"2011","E00017960","E00017960","Total",122,47,21,26,3,22,8,14,50,49,0,1,0,0
"2011","E00017966","E00017966","Total",123,29,14,15,3,40,31,9,49,47,0,1,1,2
"2011","E00175040","E00175040","Total",103,18,2,16,2,18,0,18,65,64,0,1,0,0
"2011","E00175070","E00175070","Total",88,18,3,15,18,13,1,12,39,38,0,1,0,0
"2011","E00175079","E00175079","Total",125,15,5,10,22,34,3,31,54,52,0,2,0,0
"2011","E00175080","E00175080","Total",70,13,4,9,1,15,2,13,41,41,0,0,0,0
"2011","E00017834","E00017834","Total",72,44,25,19,0,5,2,3,22,21,0,1,0,1
"2011","E00017838","E00017838","Total",151,43,20,23,0,17,13,4,86,81,2,3,0,5
"2011","E00017841","E00017841","Total",111,71,46,25,0,8,2,6,31,29,0,2,0,1
"2011","E00175069","E00175069","Total",132,70,38,32,1,12,5,7,49,46,0,3,0,0
"2011","E00175082","E00175082","Total",131,71,31,40,3,5,0,5,50,47,0,2,1,2
"2011","E00017836","E00017836","Total",131,55,24,31,0,20,9,11,54,52,0,2,0,2
"2011","E00017837","E00017837","Total",126,77,40,37,0,8,5,3,41,41,0,0,0,0
"2011","E00017842","E00017842","Total",103,67,33,34,1,7,2,5,27,27,0,0,0,1
"2011","E00017848","E00017848","Total",108,64,38,26,1,5,2,3,37,34,0,3,0,1
"2011","E00017840","E00017840","Total",128,77,51,26,2,18,14,4,28,26,0,1,1,3
"2011","E00017843","E00017843","Total",106,42,20,22,0,30,22,8,32,30,1,1,0,2
"2011","E00017846","E00017846","Total",124,18,7,11,1,23,10,13,80,73,2,2,3,2
"2011","E00017852","E00017852","Total",158,63,33,30,0,42,37,5,52,49,1,1,1,1
"2011","E00017839","E00017839","Total",125,78,47,31,1,8,4,4,37,35,0,1,1,1
"2011","E00017844","E00017844","Total",147,85,53,32,0,12,10,2,50,45,0,4,1,0
"2011","E00017845","E00017845","Total",121,58,38,20,1,23,15,8,38,38,0,0,0,1
"2011","E00017850","E00017850","Total",120,58,33,25,1,12,6,6,49,46,0,0,3,0
"2011","E00017854","E00017854","Total",88,35,13,22,0,10,4,6,43,40,0,1,2,0
"2011","E00017855","E00017855","Total",150,54,23,31,1,18,4,14,71,65,3,2,1,6
"2011","E00017856","E00017856","Total",155,81,35,46,1,8,0,8,63,59,0,2,2,2
"2011","E00175059","E00175059","Total",143,76,35,41,0,6,6,0,59,59,0,0,0,2
"2011","E00175064","E00175064","Total",107,55,21,34,0,10,8,2,40,39,0,0,1,2
"2011","E00017847","E00017847","Total",103,61,22,39,0,11,6,5,29,28,0,0,1,2
"2011","E00017849","E00017849","Total",137,61,25,36,1,43,37,6,28,28,0,0,0,4
"2011","E00017851","E00017851","Total",123,48,25,23,0,23,7,16,48,46,0,0,2,4
"2011","E00017853","E00017853","Total",119,63,37,26,1,16,7,9,36,35,0,1,0,3
"2011","E00017985","E00017985","Total",103,52,27,25,1,9,6,3,39,38,0,1,0,2
"2011","E00017988","E00017988","Total",110,73,42,31,1,7,2,5,28,28,0,0,0,1
"2011","E00017989","E00017989","Total",128,76,28,48,0,10,9,1,42,36,0,6,0,0
"2011","E00017992","E00017992","Total",107,51,26,25,2,6,3,3,47,43,1,1,2,1
"2011","E00017993","E00017993","Total",133,66,22,44,2,5,3,2,60,58,0,2,0,0
"2011","E00017994","E00017994","Total",118,57,16,41,0,15,9,6,46,40,0,3,3,0
"2011","E00017996","E00017996","Total",116,46,32,14,2,11,5,6,55,54,0,1,0,2
"2011","E00175052","E00175052","Total",106,44,14,30,2,4,1,3,55,51,0,3,1,1
"2011","E00175065","E00175065","Total",65,33,12,21,0,7,2,5,23,22,0,1,0,2
"2011","E00018111","E00018111","Total",121,60,34,26,1,22,3,19,37,35,0,1,1,1
"2011","E00018113","E00018113","Total",132,57,24,33,0,31,24,7,43,42,0,1,0,1
"2011","E00018115","E00018115","Total",98,47,19,28,0,8,5,3,43,41,0,2,0,0
"2011","E00018116","E00018116","Total",103,51,23,28,1,5,1,4,46,46,0,0,0,0
"2011","E00018085","E00018085","Total",121,46,14,32,1,8,8,0,65,62,0,2,1,1
"2011","E00018086","E00018086","Total",144,87,48,39,1,5,2,3,49,47,0,2,0,2
"2011","E00018087","E00018087","Total",109,44,18,26,2,19,15,4,43,42,0,1,0,1
"2011","E00018114","E00018114","Total",138,57,23,34,1,8,3,5,70,66,2,1,1,2
"2011","E00018222","E00018222","Total",115,23,6,17,4,59,36,23,25,23,1,1,0,4
"2011","E00018223","E00018223","Total",141,15,3,12,0,77,49,28,46,45,0,1,0,3
"2011","E00018224","E00018224","Total",115,17,3,14,0,22,10,12,74,73,0,1,0,2
"2011","E00018257","E00018257","Total",147,53,22,31,1,23,14,9,69,64,0,2,3,1
"2011","E00018259","E00018259","Total",140,45,13,32,7,45,26,19,43,42,0,1,0,0
"2011","E00018225","E00018225","Total",126,6,1,5,0,107,88,19,10,10,0,0,0,3
"2011","E00018226","E00018226","Total",134,30,6,24,0,72,70,2,30,30,0,0,0,2
"2011","E00018227","E00018227","Total",127,26,10,16,0,69,66,3,31,30,0,0,1,1
"2011","E00174985","E00174985","Total",109,13,0,13,5,12,0,12,79,75,1,3,0,0
"2011","E00174988","E00174988","Total",106,19,8,11,2,21,18,3,64,62,0,0,2,0
"2011","E00174989","E00174989","Total",125,19,5,14,1,50,45,5,54,53,0,0,1,1
"2011","E00174991","E00174991","Total",125,39,11,28,8,26,2,24,49,46,0,3,0,3
"2011","E00175060","E00175060","Total",151,30,8,22,1,7,4,3,113,110,0,3,0,0
"2011","E00175063","E00175063","Total",100,5,1,4,32,43,4,39,18,17,0,0,1,2
"2011","E00018218","E00018218","Total",115,30,9,21,1,30,2,28,53,52,0,1,0,1
"2011","E00018231","E00018231","Total",120,47,26,21,0,7,3,4,63,63,0,0,0,3
"2011","E00018233","E00018233","Total",149,19,6,13,2,53,5,48,71,64,0,1,6,4
"2011","E00018235","E00018235","Total",127,62,26,36,2,10,2,8,52,52,0,0,0,1
"2011","E00018236","E00018236","Total",96,38,18,20,0,9,6,3,48,48,0,0,0,1
"2011","E00018238","E00018238","Total",136,34,16,18,0,39,27,12,61,58,0,1,2,2
"2011","E00018242","E00018242","Total",80,25,12,13,0,8,2,6,46,44,0,1,1,1
"2011","E00018230","E00018230","Total",145,21,10,11,0,51,9,42,73,72,0,0,1,0
"2011","E00018237","E00018237","Total",114,6,2,4,5,90,12,78,13,12,0,1,0,0
"2011","E00018239","E00018239","Total",125,14,5,9,13,52,1,51,42,42,0,0,0,4
"2011","E00018240","E00018240","Total",209,13,6,7,8,132,50,82,50,47,0,0,3,6
"2011","E00018241","E00018241","Total",106,27,12,15,9,19,0,19,50,47,0,1,2,1
"2011","E00175020","E00175020","Total",137,21,5,16,1,48,41,7,66,60,0,2,4,1
"2011","E00175021","E00175021","Total",117,25,5,20,31,5,3,2,56,55,0,0,1,0
"2011","E00175023","E00175023","Total",134,8,2,6,79,21,3,18,26,26,0,0,0,0
"2011","E00018221","E00018221","Total",170,70,31,39,0,27,18,9,70,67,0,1,2,3
"2011","E00018251","E00018251","Total",105,28,13,15,1,51,50,1,25,24,0,1,0,0
"2011","E00018252","E00018252","Total",126,40,16,24,1,22,17,5,61,61,0,0,0,2
"2011","E00018254","E00018254","Total",109,33,14,19,0,36,34,2,37,35,0,1,1,3
"2011","E00018260","E00018260","Total",133,10,4,6,0,76,73,3,47,46,0,1,0,0
"2011","E00174987","E00174987","Total",98,8,1,7,1,67,66,1,21,21,0,0,0,1
"2011","E00175067","E00175067","Total",134,24,4,20,6,5,5,0,98,95,1,2,0,1
"2011","E00175068","E00175068","Total",135,10,6,4,1,5,1,4,119,118,1,0,0,0
"2011","E00175074","E00175074","Total",129,14,2,12,15,4,3,1,95,93,0,2,0,1
"2011","E00175078","E00175078","Total",107,6,0,6,3,67,29,38,30,29,1,0,0,1
"2011","E00174990","E00174990","Total",191,25,4,21,6,7,6,1,153,148,0,5,0,0
"2011","E00175037","E00175037","Total",142,8,2,6,20,56,5,51,57,57,0,0,0,1
"2011","E00175073","E00175073","Total",162,26,7,19,5,14,0,14,116,112,0,3,1,1
"2011","E00175077","E00175077","Total",42,10,5,5,3,12,9,3,17,15,0,2,0,0
"2011","E00175081","E00175081","Total",81,15,3,12,2,40,27,13,23,23,0,0,0,1
"2011","E00018232","E00018232","Total",80,14,1,13,0,41,39,2,25,25,0,0,0,0
"2011","E00018244","E00018244","Total",50,9,3,6,0,29,27,2,11,11,0,0,0,1
"2011","E00018246","E00018246","Total",61,15,5,10,1,29,28,1,15,15,0,0,0,1
"2011","E00018253","E00018253","Total",144,45,25,20,1,17,6,11,80,77,0,2,1,1
"2011","E00018255","E00018255","Total",116,43,16,27,0,31,28,3,41,40,0,0,1,1
"2011","E00175022","E00175022","Total",61,11,4,7,6,4,1,3,39,38,0,0,1,1
"2011","E00175024","E00175024","Total",74,1,0,1,21,12,0,12,40,39,0,0,1,0
"2011","E00175025","E00175025","Total",128,13,0,13,2,2,1,1,111,111,0,0,0,0
"2011","E00175026","E00175026","Total",109,15,6,9,1,61,31,30,31,31,0,0,0,1
"2011","E00175033","E00175033","Total",126,29,12,17,1,73,66,7,23,23,0,0,0,0
"2011","E00175034","E00175034","Total",110,26,7,19,27,25,11,14,29,29,0,0,0,3
"2011","E00175035","E00175035","Total",146,37,13,24,8,45,36,9,56,54,0,1,1,0
"2011","E00018220","E00018220","Total",143,20,6,14,1,88,80,8,34,30,0,3,1,0
"2011","E00018243","E00018243","Total",180,64,22,42,6,59,41,18,48,47,0,1,0,3
"2011","E00018250","E00018250","Total",116,24,3,21,1,32,1,31,57,56,0,1,0,2
"2011","E00175053","E00175053","Total",81,11,3,8,6,50,9,41,14,14,0,0,0,0
"2011","E00175054","E00175054","Total",77,17,5,12,1,41,39,2,17,16,0,1,0,1
"2011","E00017982","E00017982","Total",142,73,42,31,0,12,7,5,56,56,0,0,0,1
"2011","E00017991","E00017991","Total",127,55,22,33,2,9,0,9,59,57,0,0,2,2
"2011","E00017995","E00017995","Total",152,96,57,39,1,8,5,3,47,44,1,2,0,0
"2011","E00017997","E00017997","Total",155,55,29,26,0,17,6,11,81,72,1,5,3,2
"2011","E00017999","E00017999","Total",155,80,39,41,1,8,1,7,62,60,0,2,0,4
"2011","E00018000","E00018000","Total",148,72,33,39,2,19,8,11,54,53,0,1,0,1
"2011","E00018001","E00018001","Total",154,69,39,30,0,22,4,18,61,55,0,3,3,2
"2011","E00174980","E00174980","Total",114,35,14,21,0,22,1,21,55,49,1,2,3,2
"2011","E00175036","E00175036","Total",101,32,3,29,0,13,5,8,56,56,0,0,0,0
"2011","E00017983","E00017983","Total",135,51,30,21,2,12,5,7,67,64,0,3,0,3
"2011","E00018003","E00018003","Total",112,44,20,24,0,20,5,15,46,43,0,3,0,2
"2011","E00018004","E00018004","Total",127,55,27,28,3,8,3,5,59,56,0,1,2,2
"2011","E00018007","E00018007","Total",122,39,17,22,1,22,11,11,60,59,0,1,0,0
"2011","E00018005","E00018005","Total",104,60,39,21,2,7,4,3,33,31,0,2,0,2
"2011","E00018006","E00018006","Total",146,23,12,11,1,34,33,1,87,84,0,3,0,1
"2011","E00018008","E00018008","Total",133,49,26,23,0,29,20,9,54,54,0,0,0,1
"2011","E00018009","E00018009","Total",124,20,6,14,1,74,73,1,29,28,0,0,1,0
"2011","E00018262","E00018262","Total",116,32,10,22,1,42,26,16,40,38,0,1,1,1
"2011","E00018282","E00018282","Total",101,48,18,30,3,10,7,3,40,39,0,1,0,0
"2011","E00018283","E00018283","Total",89,36,7,29,0,22,3,19,28,28,0,0,0,3
"2011","E00018284","E00018284","Total",72,31,12,19,0,5,3,2,36,33,0,1,2,0
"2011","E00018286","E00018286","Total",106,44,17,27,4,10,2,8,46,42,0,4,0,2
"2011","E00018263","E00018263","Total",147,73,32,41,0,8,6,2,63,55,0,5,3,3
"2011","E00018285","E00018285","Total",88,54,25,29,0,4,1,3,28,27,0,0,1,2
"2011","E00175041","E00175041","Total",140,63,24,39,0,4,3,1,72,71,0,1,0,1
"2011","E00175075","E00175075","Total",45,23,6,17,0,2,0,2,20,17,0,3,0,0
"2011","E00018287","E00018287","Total",133,51,28,23,1,7,6,1,72,70,1,1,0,2
"2011","E00018288","E00018288","Total",105,65,35,30,0,8,4,4,31,29,0,1,1,1
"2011","E00018291","E00018291","Total",106,65,36,29,1,11,3,8,29,27,0,2,0,0
"2011","E00018294","E00018294","Total",88,37,15,22,0,20,19,1,30,28,0,2,0,1
"2011","E00018267","E00018267","Total",82,52,28,24,1,5,3,2,24,23,0,1,0,0
"2011","E00018289","E00018289","Total",91,50,18,32,1,5,2,3,35,34,0,1,0,0
"2011","E00018293","E00018293","Total",116,76,25,51,0,4,3,1,35,35,0,0,0,1
"2011","E00018295","E00018295","Total",131,63,26,37,2,11,1,10,52,50,0,2,0,3
"2011","E00018264","E00018264","Total",137,32,15,17,0,10,4,6,93,89,0,3,1,2
"2011","E00018269","E00018269","Total",121,73,30,43,1,9,8,1,37,31,1,3,2,1
"2011","E00018290","E00018290","Total",121,63,30,33,0,2,2,0,51,47,0,4,0,5
"2011","E00018292","E00018292","Total",102,34,17,17,1,11,4,7,56,55,0,1,0,0
"2011","E00017944","E00017944","Total",145,46,24,22,1,35,5,30,60,56,1,2,1,3
"2011","E00017969","E00017969","Total",102,58,26,32,4,10,1,9,27,25,1,1,0,3
"2011","E00017971","E00017971","Total",173,54,19,35,6,37,5,32,73,68,0,3,2,3
"2011","E00017976","E00017976","Total",124,36,16,20,2,40,4,36,43,41,0,2,0,3
"2011","E00018130","E00018130","Total",110,44,19,25,1,14,4,10,50,48,0,2,0,1
"2011","E00018131","E00018131","Total",110,36,17,19,1,23,1,22,48,42,0,5,1,2
"2011","E00018133","E00018133","Total",142,55,21,34,0,29,15,14,57,56,0,1,0,1
"2011","E00018134","E00018134","Total",72,38,15,23,0,22,14,8,12,12,0,0,0,0
"2011","E00018135","E00018135","Total",143,37,21,16,3,64,12,52,38,33,0,1,4,1
"2011","E00018132","E00018132","Total",68,24,9,15,0,24,5,19,20,19,0,1,0,0
"2011","E00018136","E00018136","Total",136,79,37,42,5,13,1,12,38,38,0,0,0,1
"2011","E00018137","E00018137","Total",134,57,23,34,2,23,3,20,51,48,0,1,2,1
"2011","E00018138","E00018138","Total",137,40,24,16,4,27,5,22,64,59,0,3,2,2
"2011","E00018297","E00018297","Total",118,77,46,31,0,5,1,4,35,32,2,0,1,1
"2011","E00018298","E00018298","Total",110,43,23,20,0,16,0,16,48,44,1,3,0,3
"2011","E00018300","E00018300","Total",113,42,21,21,0,41,20,21,28,26,0,0,2,2
"2011","E00018325","E00018325","Total",120,66,38,28,0,9,3,6,44,42,0,2,0,1
"2011","E00018328","E00018328","Total",150,47,22,25,2,41,22,19,58,53,0,3,2,2
"2011","E00018036","E00018036","Total",106,59,40,19,1,15,7,8,30,29,0,1,0,1
"2011","E00018037","E00018037","Total",146,79,42,37,0,24,9,15,43,37,0,5,1,0
"2011","E00018038","E00018038","Total",120,59,32,27,1,16,7,9,44,41,0,2,1,0
"2011","E00018040","E00018040","Total",107,48,25,23,1,16,5,11,42,41,0,0,1,0
"2011","E00018041","E00018041","Total",115,56,32,24,0,13,5,8,43,40,0,3,0,3
"2011","E00018016","E00018016","Total",111,58,25,33,0,20,2,18,33,31,0,2,0,0
"2011","E00018033","E00018033","Total",127,14,6,8,1,14,4,10,97,92,2,1,2,1
"2011","E00018034","E00018034","Total",108,65,38,27,0,9,2,7,34,29,0,3,2,0
"2011","E00018039","E00018039","Total",163,58,31,27,0,8,4,4,93,89,2,0,2,4
"2011","E00018023","E00018023","Total",137,75,29,46,0,14,3,11,46,43,0,0,3,2
"2011","E00018026","E00018026","Total",124,51,23,28,0,21,0,21,51,48,0,2,1,1
"2011","E00018028","E00018028","Total",150,77,44,33,0,14,6,8,58,56,0,2,0,1
"2011","E00018029","E00018029","Total",131,69,42,27,1,8,3,5,50,46,0,3,1,3
"2011","E00018015","E00018015","Total",128,57,28,29,1,22,9,13,45,45,0,0,0,3
"2011","E00018027","E00018027","Total",132,15,11,4,0,96,5,91,21,21,0,0,0,0
"2011","E00018030","E00018030","Total",153,72,37,35,0,14,3,11,64,60,0,3,1,3
"2011","E00018031","E00018031","Total",142,63,32,31,2,16,5,11,57,54,0,3,0,4
"2011","E00018032","E00018032","Total",158,73,33,40,1,8,3,5,75,74,0,1,0,1
"2011","E00018035","E00018035","Total",85,25,13,12,1,5,1,4,52,51,0,1,0,2
"2011","E00017825","E00017825","Total",127,29,11,18,0,29,26,3,68,66,0,1,1,1
"2011","E00017826","E00017826","Total",149,50,21,29,1,14,6,8,83,81,0,2,0,1
"2011","E00017827","E00017827","Total",190,52,24,28,0,61,10,51,73,72,0,0,1,4
"2011","E00017830","E00017830","Total",117,61,35,26,1,11,3,8,41,38,0,2,1,3
"2011","E00017804","E00017804","Total",154,84,36,48,2,6,3,3,61,57,0,2,2,1
"2011","E00017805","E00017805","Total",149,22,15,7,0,23,3,20,102,96,1,3,2,2
"2011","E00017828","E00017828","Total",146,55,25,30,0,9,8,1,81,72,3,4,2,1
"2011","E00174997","E00174997","Total",124,46,14,32,0,11,6,5,67,62,1,2,2,0
"2011","E00174998","E00174998","Total",50,7,1,6,1,5,1,4,35,35,0,0,0,2
"2011","E00017798","E00017798","Total",137,61,27,34,1,13,10,3,61,58,0,2,1,1
"2011","E00017799","E00017799","Total",129,45,15,30,0,36,32,4,48,47,0,1,0,0
"2011","E00017801","E00017801","Total",133,50,26,24,0,10,7,3,71,65,2,2,2,2
"2011","E00017829","E00017829","Total",151,83,32,51,0,15,9,6,49,48,0,1,0,4
"2011","E00017806","E00017806","Total",114,59,27,32,0,6,4,2,45,44,0,1,0,4
"2011","E00017814","E00017814","Total",143,40,19,21,0,11,7,4,89,87,1,1,0,3
"2011","E00017818","E00017818","Total",112,60,26,34,0,7,4,3,44,37,0,6,1,1
"2011","E00174996","E00174996","Total",87,31,17,14,0,16,14,2,40,40,0,0,0,0
"2011","E00175047","E00175047","Total",63,28,14,14,1,14,12,2,20,19,0,1,0,0
"2011","E00017811","E00017811","Total",107,68,27,41,0,9,5,4,29,27,0,2,0,1
"2011","E00017812","E00017812","Total",116,43,22,21,0,45,13,32,26,26,0,0,0,2
"2011","E00017816","E00017816","Total",159,80,27,53,0,22,10,12,53,51,0,2,0,4
"2011","E00175004","E00175004","Total",114,66,26,40,0,9,4,5,39,37,0,2,0,0
"2011","E00175048","E00175048","Total",54,21,15,6,0,5,3,2,28,28,0,0,0,0
"2011","E00017644","E00017644","Total",121,52,30,22,1,33,11,22,30,30,0,0,0,5
"2011","E00017645","E00017645","Total",131,8,4,4,1,109,15,94,10,10,0,0,0,3
"2011","E00017650","E00017650","Total",156,21,6,15,0,107,77,30,25,24,0,0,1,3
"2011","E00017673","E00017673","Total",122,12,3,9,1,90,89,1,17,15,0,2,0,2
"2011","E00017674","E00017674","Total",139,20,6,14,0,99,94,5,17,17,0,0,0,3
"2011","E00017648","E00017648","Total",136,17,6,11,8,87,78,9,22,20,0,2,0,2
"2011","E00017665","E00017665","Total",118,33,8,25,1,18,17,1,65,61,0,2,2,1
"2011","E00017667","E00017667","Total",163,43,25,18,0,81,14,67,36,35,0,1,0,3
"2011","E00017670","E00017670","Total",103,13,3,10,0,69,69,0,20,18,1,1,0,1
"2011","E00017646","E00017646","Total",106,41,20,21,0,18,11,7,43,43,0,0,0,4
"2011","E00017647","E00017647","Total",127,53,19,34,9,37,19,18,28,28,0,0,0,0
"2011","E00017663","E00017663","Total",92,27,5,22,0,31,28,3,33,32,0,1,0,1
"2011","E00017664","E00017664","Total",94,28,8,20,0,13,10,3,52,52,0,0,0,1
"2011","E00017672","E00017672","Total",120,59,21,38,1,16,10,6,43,42,0,1,0,1
"2011","E00017802","E00017802","Total",151,53,25,28,4,7,5,2,86,84,0,2,0,1
"2011","E00017808","E00017808","Total",146,59,37,22,1,14,9,5,72,66,0,2,4,0
"2011","E00017810","E00017810","Total",144,62,31,31,1,26,10,16,54,53,0,1,0,1
"2011","E00175002","E00175002","Total",99,41,21,20,0,15,9,6,42,42,0,0,0,1
"2011","E00175005","E00175005","Total",58,10,4,6,0,35,31,4,11,11,0,0,0,2
"2011","E00018296","E00018296","Total",121,24,9,15,0,60,50,10,35,34,0,1,0,2
"2011","E00018318","E00018318","Total",115,47,14,33,1,21,5,16,45,45,0,0,0,1
"2011","E00018320","E00018320","Total",118,26,8,18,1,68,35,33,23,21,0,2,0,0
"2011","E00018322","E00018322","Total",92,32,12,20,0,45,41,4,14,12,1,1,0,1
"2011","E00018323","E00018323","Total",106,27,6,21,2,32,25,7,44,44,0,0,0,1
"2011","E00018324","E00018324","Total",175,41,4,37,0,17,13,4,117,115,0,2,0,0
"2011","E00018314","E00018314","Total",132,37,7,30,0,69,40,29,25,25,0,0,0,1
"2011","E00018315","E00018315","Total",138,69,30,39,2,10,2,8,55,53,0,2,0,2
"2011","E00018316","E00018316","Total",172,79,28,51,1,13,5,8,78,75,0,2,1,1
"2011","E00018317","E00018317","Total",183,80,27,53,9,43,24,19,47,44,0,3,0,4
"2011","E00018321","E00018321","Total",124,68,28,40,1,10,4,6,43,42,0,1,0,2
"2011","E00018302","E00018302","Total",103,21,6,15,0,54,52,2,26,26,0,0,0,2
"2011","E00018305","E00018305","Total",121,9,3,6,0,107,104,3,4,4,0,0,0,1
"2011","E00018309","E00018309","Total",136,27,6,21,0,87,85,2,20,19,1,0,0,2
"2011","E00018311","E00018311","Total",118,8,1,7,0,98,98,0,11,11,0,0,0,1
"2011","E00018312","E00018312","Total",107,13,4,9,0,82,80,2,7,7,0,0,0,5
"2011","E00018319","E00018319","Total",100,18,3,15,0,71,67,4,9,9,0,0,0,2
"2011","E00018306","E00018306","Total",119,32,9,23,0,61,55,6,26,24,0,1,1,0
"2011","E00018329","E00018329","Total",127,27,8,19,0,76,76,0,23,23,0,0,0,1
"2011","E00018330","E00018330","Total",134,31,8,23,7,71,66,5,24,23,0,0,1,1
"2011","E00018331","E00018331","Total",127,29,5,24,0,69,65,4,27,23,0,4,0,2
"2011","E00018333","E00018333","Total",95,16,4,12,0,57,55,2,21,20,0,1,0,1
"2011","E00018299","E00018299","Total",141,32,11,21,2,48,15,33,58,57,0,0,1,1
"2011","E00018301","E00018301","Total",203,45,21,24,14,87,43,44,56,52,1,3,0,1
"2011","E00018326","E00018326","Total",116,22,1,21,0,68,65,3,23,22,0,0,1,3
"2011","E00018327","E00018327","Total",116,28,9,19,1,55,53,2,31,31,0,0,0,1
"2011","E00018336","E00018336","Total",126,20,8,12,0,89,70,19,15,14,1,0,0,2
"2011","E00018121","E00018121","Total",195,34,17,17,7,118,82,36,36,34,0,1,1,0
"2011","E00018139","E00018139","Total",107,13,7,6,8,77,65,12,8,8,0,0,0,1
"2011","E00018140","E00018140","Total",118,12,7,5,1,74,59,15,29,28,0,0,1,2
"2011","E00018141","E00018141","Total",125,20,3,17,10,75,47,28,16,16,0,0,0,4
"2011","E00018143","E00018143","Total",113,13,4,9,32,58,15,43,9,7,1,0,1,1
"2011","E00018124","E00018124","Total",143,44,14,30,0,65,53,12,30,27,0,2,1,4
"2011","E00018126","E00018126","Total",187,41,15,26,2,90,31,59,50,47,0,2,1,4
"2011","E00018145","E00018145","Total",126,39,19,20,1,63,51,12,22,19,1,2,0,1
"2011","E00018148","E00018148","Total",113,10,3,7,0,94,92,2,5,5,0,0,0,4
"2011","E00018149","E00018149","Total",121,14,5,9,0,85,82,3,19,18,0,1,0,3
"2011","E00018304","E00018304","Total",158,33,10,23,1,48,39,9,74,72,1,1,0,2
"2011","E00018307","E00018307","Total",148,29,11,18,2,91,33,58,21,19,0,2,0,5
"2011","E00018308","E00018308","Total",151,5,0,5,13,112,35,77,17,17,0,0,0,4
"2011","E00018310","E00018310","Total",142,35,17,18,1,65,52,13,38,38,0,0,0,3
"2011","E00018313","E00018313","Total",132,28,11,17,1,65,50,15,35,34,0,1,0,3
"2011","E00018303","E00018303","Total",175,61,28,33,2,41,18,23,71,64,0,5,2,0
"2011","E00018332","E00018332","Total",130,33,10,23,3,51,37,14,40,36,0,2,2,3
"2011","E00018334","E00018334","Total",145,55,31,24,3,36,13,23,49,49,0,0,0,2
"2011","E00018335","E00018335","Total",143,68,38,30,1,19,10,9,52,49,0,1,2,3
"2011","E00017649","E00017649","Total",178,70,35,35,0,20,6,14,85,80,0,4,1,3
"2011","E00017666","E00017666","Total",84,28,14,14,0,20,5,15,35,35,0,0,0,1
"2011","E00017668","E00017668","Total",110,5,4,1,2,98,78,20,2,1,0,0,1,3
"2011","E00017669","E00017669","Total",126,40,18,22,1,16,4,12,66,65,0,1,0,3
"2011","E00017671","E00017671","Total",139,44,19,25,2,40,7,33,52,50,0,1,1,1
"2011","E00018123","E00018123","Total",106,39,15,24,2,23,8,15,41,38,0,3,0,1
"2011","E00018142","E00018142","Total",76,31,15,16,0,33,19,14,10,9,0,0,1,2
"2011","E00018147","E00018147","Total",92,19,11,8,1,56,37,19,15,14,0,0,1,1
"2011","E00018151","E00018151","Total",131,63,25,38,1,25,16,9,40,40,0,0,0,2
"2011","E00018153","E00018153","Total",150,86,35,51,0,13,7,6,50,48,0,2,0,1
"2011","E00018122","E00018122","Total",124,20,7,13,3,79,63,16,20,19,0,0,1,2
"2011","E00018125","E00018125","Total",151,55,27,28,0,45,29,16,49,47,0,2,0,2
"2011","E00018144","E00018144","Total",80,18,6,12,0,48,46,2,13,10,0,3,0,1
"2011","E00018146","E00018146","Total",133,55,31,24,1,21,11,10,55,54,0,1,0,1
"2011","E00018168","E00018168","Total",117,56,20,36,3,8,4,4,47,47,0,0,0,3
"2011","E00018169","E00018169","Total",142,67,22,45,0,22,8,14,52,51,0,1,0,1
"2011","E00018171","E00018171","Total",120,59,26,33,1,25,17,8,35,35,0,0,0,0
"2011","E00018173","E00018173","Total",149,51,19,32,3,55,26,29,37,36,0,1,0,3
"2011","E00018176","E00018176","Total",147,60,22,38,3,18,7,11,65,62,0,1,2,1
"2011","E00017858","E00017858","Total",122,36,2,34,0,72,67,5,11,11,0,0,0,3
"2011","E00017862","E00017862","Total",119,42,10,32,2,37,31,6,38,36,0,0,2,0
"2011","E00017872","E00017872","Total",83,19,3,16,0,59,51,8,4,4,0,0,0,1
"2011","E00017876","E00017876","Total",81,22,4,18,1,46,40,6,12,12,0,0,0,0
"2011","E00017877","E00017877","Total",88,18,5,13,2,53,51,2,14,12,0,1,1,1
"2011","E00017878","E00017878","Total",55,9,3,6,0,36,31,5,9,9,0,0,0,1
"2011","E00017863","E00017863","Total",139,59,18,41,1,32,21,11,44,42,0,2,0,3
"2011","E00017865","E00017865","Total",108,53,15,38,0,37,15,22,13,12,0,0,1,5
"2011","E00174971","E00174971","Total",115,47,16,31,1,19,14,5,48,47,0,0,1,0
"2011","E00174972","E00174972","Total",116,60,21,39,1,16,4,12,39,38,0,1,0,0
"2011","E00174973","E00174973","Total",120,63,23,40,2,16,6,10,38,35,0,3,0,1
"2011","E00018273","E00018273","Total",105,45,15,30,2,10,7,3,47,46,0,1,0,1
"2011","E00018274","E00018274","Total",144,64,22,42,2,28,18,10,50,48,0,2,0,0
"2011","E00018275","E00018275","Total",79,41,14,27,0,5,1,4,33,31,0,2,0,0
"2011","E00018276","E00018276","Total",114,62,25,37,1,14,8,6,35,32,0,2,1,2
"2011","E00018268","E00018268","Total",63,31,12,19,0,9,3,6,23,21,0,1,1,0
"2011","E00018270","E00018270","Total",79,15,5,10,0,51,50,1,12,12,0,0,0,1
"2011","E00018271","E00018271","Total",63,10,4,6,0,11,9,2,41,40,0,1,0,1
"2011","E00018272","E00018272","Total",121,66,15,51,0,16,9,7,38,34,0,3,1,1
"2011","E00018278","E00018278","Total",170,51,24,27,1,62,58,4,55,51,0,2,2,1
"2011","E00018277","E00018277","Total",130,57,14,43,2,21,19,2,50,45,0,5,0,0
"2011","E00018279","E00018279","Total",106,52,18,34,1,17,14,3,34,33,0,1,0,2
"2011","E00175007","E00175007","Total",135,48,11,37,0,58,53,5,26,25,0,0,1,3
"2011","E00175008","E00175008","Total",119,26,9,17,0,55,52,3,36,33,0,3,0,2
"2011","E00017803","E00017803","Total",161,70,27,43,1,18,12,6,71,69,0,2,0,1
"2011","E00017807","E00017807","Total",147,54,24,30,3,68,20,48,22,21,0,1,0,0
"2011","E00017817","E00017817","Total",128,34,12,22,1,65,65,0,27,26,0,1,0,1
"2011","E00017819","E00017819","Total",90,35,13,22,0,35,32,3,20,18,0,2,0,0
"2011","E00017820","E00017820","Total",143,81,37,44,0,10,5,5,50,48,0,0,2,2
"2011","E00017821","E00017821","Total",129,78,28,50,0,11,10,1,39,37,0,2,0,1
"2011","E00017822","E00017822","Total",145,81,28,53,1,22,18,4,40,38,0,2,0,1
"2011","E00017823","E00017823","Total",163,103,41,62,0,13,10,3,41,40,0,1,0,6
"2011","E00017824","E00017824","Total",133,99,31,68,1,8,2,6,24,24,0,0,0,1
"2011","E00017866","E00017866","Total",107,57,18,39,1,15,12,3,33,33,0,0,0,1
"2011","E00017875","E00017875","Total",165,89,35,54,0,14,9,5,59,55,0,3,1,3
"2011","E00017879","E00017879","Total",110,45,10,35,1,45,42,3,18,17,0,1,0,1
"2011","E00017880","E00017880","Total",154,96,28,68,1,15,9,6,41,39,0,1,1,1
"2011","E00017881","E00017881","Total",61,40,14,26,2,3,3,0,14,12,0,1,1,2
"2011","E00017883","E00017883","Total",71,44,17,27,0,8,7,1,18,18,0,0,0,1
"2011","E00017860","E00017860","Total",122,72,32,40,2,11,9,2,36,34,0,1,1,1
"2011","E00017861","E00017861","Total",126,49,20,29,0,35,31,4,39,37,0,1,1,3
"2011","E00017873","E00017873","Total",102,17,3,14,0,70,67,3,15,15,0,0,0,0
"2011","E00017874","E00017874","Total",97,12,3,9,0,73,65,8,11,10,0,1,0,1
"2011","E00175038","E00175038","Total",113,28,14,14,0,65,62,3,19,15,0,4,0,1
"2011","E00175062","E00175062","Total",108,29,9,20,2,57,53,4,20,20,0,0,0,0
"2011","E00018280","E00018280","Total",95,57,33,24,0,12,8,4,24,22,0,1,1,2
"2011","E00175009","E00175009","Total",128,53,15,38,1,50,42,8,23,22,0,0,1,1
"2011","E00175010","E00175010","Total",133,46,11,35,1,53,35,18,31,30,0,1,0,2
"2011","E00175011","E00175011","Total",137,51,21,30,3,54,46,8,29,28,0,1,0,0
"2011","E00017652","E00017652","Total",161,82,26,56,2,4,0,4,69,68,0,1,0,4
"2011","E00017678","E00017678","Total",127,75,35,40,0,9,4,5,42,40,0,1,1,1
"2011","E00017679","E00017679","Total",145,73,30,43,0,16,9,7,54,49,0,4,1,2
"2011","E00017680","E00017680","Total",103,52,27,25,1,14,6,8,35,35,0,0,0,1
"2011","E00017651","E00017651","Total",163,35,17,18,4,67,66,1,51,50,0,0,1,6
"2011","E00017654","E00017654","Total",120,78,30,48,0,12,7,5,29,29,0,0,0,1
"2011","E00017675","E00017675","Total",190,71,34,37,2,23,17,6,93,90,0,3,0,1
"2011","E00017676","E00017676","Total",159,70,42,28,1,15,5,10,71,67,0,4,0,2
"2011","E00017677","E00017677","Total",100,41,10,31,1,21,7,14,37,33,0,3,1,0
"2011","E00017655","E00017655","Total",111,42,19,23,1,25,3,22,42,41,0,1,0,1
"2011","E00017657","E00017657","Total",123,87,34,53,0,5,4,1,30,28,0,1,1,1
"2011","E00017660","E00017660","Total",157,112,36,76,0,4,1,3,41,37,0,4,0,0
"2011","E00175049","E00175049","Total",130,62,16,46,2,8,6,2,57,52,0,4,1,1
"2011","E00175050","E00175050","Total",124,83,25,58,1,10,2,8,27,24,0,3,0,3
"2011","E00017656","E00017656","Total",132,85,30,55,0,13,4,9,34,34,0,0,0,0
"2011","E00017658","E00017658","Total",113,79,20,59,1,5,1,4,28,26,0,1,1,0
"2011","E00017659","E00017659","Total",131,89,28,61,1,2,0,2,39,36,1,2,0,0
"2011","E00017661","E00017661","Total",126,83,21,62,1,11,4,7,29,28,1,0,0,2
"2011","E00017662","E00017662","Total",148,107,37,70,2,7,2,5,32,28,0,3,1,0
"2011","E00018119","E00018119","Total",120,40,8,32,0,56,46,10,23,22,0,0,1,1
"2011","E00018120","E00018120","Total",161,28,5,23,34,64,41,23,31,29,0,1,1,4
"2011","E00018152","E00018152","Total",81,36,11,25,0,14,7,7,30,29,0,0,1,1
"2011","E00018156","E00018156","Total",76,33,12,21,0,19,7,12,24,24,0,0,0,0
"2011","E00018157","E00018157","Total",102,39,17,22,1,18,7,11,44,39,3,1,1,0
"2011","E00018117","E00018117","Total",123,36,15,21,0,47,18,29,40,39,0,1,0,0
"2011","E00018118","E00018118","Total",110,14,8,6,0,66,10,56,29,29,0,0,0,1
"2011","E00018155","E00018155","Total",84,22,8,14,2,40,18,22,19,19,0,0,0,1
"2011","E00175032","E00175032","Total",72,10,4,6,1,53,43,10,7,6,1,0,0,1
"2011","E00175071","E00175071","Total",112,13,3,10,0,68,66,2,28,26,0,1,1,3
"2011","E00175076","E00175076","Total",80,35,13,22,2,23,19,4,20,18,0,1,1,0
"2011","E00018182","E00018182","Total",152,50,19,31,1,36,17,19,65,63,0,2,0,0
"2011","E00018184","E00018184","Total",156,57,21,36,0,57,51,6,36,36,0,0,0,6
"2011","E00018189","E00018189","Total",122,67,31,36,1,9,7,2,42,38,0,3,1,3
"2011","E00018193","E00018193","Total",175,88,28,60,0,25,13,12,59,55,0,3,1,3
"2011","E00018159","E00018159","Total",130,23,10,13,7,66,12,54,33,29,1,1,2,1
"2011","E00018160","E00018160","Total",115,45,24,21,1,29,17,12,40,37,0,3,0,0
"2011","E00018175","E00018175","Total",135,38,13,25,0,33,21,12,62,61,0,1,0,2
"2011","E00018177","E00018177","Total",180,50,13,37,14,78,32,46,38,34,0,1,3,0
"2011","E00017685","E00017685","Total",133,30,3,27,1,63,54,9,35,32,0,2,1,4
"2011","E00017687","E00017687","Total",77,23,10,13,0,37,20,17,17,14,0,1,2,0
"2011","E00017718","E00017718","Total",131,20,5,15,0,63,19,44,48,45,0,3,0,0
"2011","E00017720","E00017720","Total",133,15,5,10,0,72,19,53,42,40,0,2,0,4
"2011","E00017721","E00017721","Total",117,10,1,9,0,78,50,28,28,25,0,3,0,1
"2011","E00017686","E00017686","Total",138,9,2,7,0,117,85,32,12,12,0,0,0,0
"2011","E00017690","E00017690","Total",111,15,3,12,0,75,53,22,19,17,0,0,2,2
"2011","E00017693","E00017693","Total",160,32,13,19,1,43,15,28,83,79,0,0,4,1
"2011","E00017694","E00017694","Total",126,29,3,26,2,68,64,4,23,21,0,1,1,4
"2011","E00017719","E00017719","Total",139,66,24,42,0,24,14,10,48,46,0,1,1,1
"2011","E00017691","E00017691","Total",144,41,14,27,0,67,61,6,36,32,0,1,3,0
"2011","E00017697","E00017697","Total",130,56,15,41,1,43,29,14,29,27,1,0,1,1
"2011","E00017698","E00017698","Total",186,35,5,30,0,105,21,84,45,43,0,1,1,1
"2011","E00017699","E00017699","Total",113,34,7,27,1,48,8,40,29,27,1,0,1,1
"2011","E00017701","E00017701","Total",159,33,11,22,1,101,69,32,23,22,0,1,0,1
"2011","E00018127","E00018127","Total",163,38,14,24,0,78,23,55,44,40,0,3,1,3
"2011","E00018129","E00018129","Total",175,58,23,35,9,60,28,32,47,45,0,2,0,1
"2011","E00018150","E00018150","Total",95,17,6,11,1,69,54,15,7,6,0,1,0,1
"2011","E00018154","E00018154","Total",126,21,6,15,2,78,76,2,22,21,0,0,1,3
"2011","E00018163","E00018163","Total",103,27,8,19,1,61,57,4,14,14,0,0,0,0
"2011","E00018191","E00018191","Total",145,33,12,21,3,57,53,4,51,50,0,0,1,1
"2011","E00018192","E00018192","Total",179,113,46,67,3,12,4,8,49,47,0,2,0,2
"2011","E00018194","E00018194","Total",142,37,9,28,1,68,55,13,33,32,1,0,0,3
"2011","E00018195","E00018195","Total",136,49,17,32,2,67,39,28,17,17,0,0,0,1
"2011","E00018178","E00018178","Total",159,92,28,64,2,12,6,6,51,48,0,2,1,2
"2011","E00018179","E00018179","Total",111,69,28,41,0,9,6,3,32,32,0,0,0,1
"2011","E00018181","E00018181","Total",108,54,15,39,2,14,7,7,37,36,0,1,0,1
"2011","E00018188","E00018188","Total",120,66,17,49,0,11,5,6,43,43,0,0,0,0
"2011","E00018190","E00018190","Total",126,65,28,37,1,29,5,24,31,29,0,2,0,0
"2011","E00018161","E00018161","Total",160,60,21,39,1,51,39,12,47,45,0,2,0,1
"2011","E00018162","E00018162","Total",139,43,16,27,2,67,61,6,27,24,1,1,1,0
"2011","E00018170","E00018170","Total",108,50,24,26,1,28,18,10,27,27,0,0,0,2
"2011","E00018172","E00018172","Total",180,45,24,21,0,51,23,28,83,80,1,2,0,1
"2011","E00018174","E00018174","Total",137,79,28,51,2,12,7,5,43,41,0,0,2,1
"2011","E00018180","E00018180","Total",185,87,23,64,2,21,5,16,73,70,0,1,2,2
"2011","E00018183","E00018183","Total",176,99,34,65,4,20,9,11,53,51,0,2,0,0
"2011","E00018185","E00018185","Total",149,88,24,64,2,14,8,6,44,43,0,1,0,1
"2011","E00018186","E00018186","Total",110,67,24,43,2,12,4,8,28,28,0,0,0,1
"2011","E00018187","E00018187","Total",94,50,22,28,0,9,3,6,33,33,0,0,0,2
"2011","E00017867","E00017867","Total",109,29,12,17,0,59,56,3,19,17,0,1,1,2
"2011","E00017882","E00017882","Total",132,18,2,16,0,88,65,23,26,25,0,1,0,0
"2011","E00017884","E00017884","Total",127,53,22,31,0,15,9,6,59,58,0,1,0,0
"2011","E00017885","E00017885","Total",69,41,16,25,0,11,6,5,17,17,0,0,0,0
"2011","E00017887","E00017887","Total",111,39,12,27,0,19,12,7,52,50,0,0,2,1
"2011","E00017889","E00017889","Total",104,59,15,44,2,21,15,6,22,20,0,2,0,0
"2011","E00017886","E00017886","Total",129,29,8,21,0,75,71,4,25,22,0,2,1,0
"2011","E00174995","E00174995","Total",85,37,11,26,3,13,8,5,32,31,0,1,0,0
"2011","E00175006","E00175006","Total",121,89,32,57,0,7,3,4,24,23,0,0,1,1
"2011","E00175012","E00175012","Total",68,36,7,29,0,7,5,2,25,22,0,1,2,0
"2011","E00175013","E00175013","Total",41,9,3,6,1,10,8,2,21,20,0,0,1,0
"2011","E00175014","E00175014","Total",110,68,32,36,0,11,9,2,29,29,0,0,0,2
"2011","E00175055","E00175055","Total",127,74,21,53,1,13,5,8,35,33,0,0,2,4
"2011","E00017870","E00017870","Total",111,31,12,19,1,60,55,5,17,17,0,0,0,2
"2011","E00017871","E00017871","Total",148,62,25,37,1,53,37,16,29,26,0,1,2,3
"2011","E00017888","E00017888","Total",95,36,7,29,1,33,29,4,22,20,0,2,0,3
"2011","E00017890","E00017890","Total",122,24,7,17,0,72,69,3,25,25,0,0,0,1
"2011","E00017893","E00017893","Total",119,47,16,31,1,41,27,14,28,27,0,1,0,2
"2011","E00017891","E00017891","Total",108,53,22,31,4,27,18,9,24,21,0,1,2,0
"2011","E00017892","E00017892","Total",122,64,20,44,1,23,14,9,34,34,0,0,0,0
"2011","E00017894","E00017894","Total",82,46,17,29,0,12,7,5,24,23,0,1,0,0
"2011","E00017895","E00017895","Total",85,54,20,34,0,9,4,5,20,19,0,1,0,2
"2011","E00017896","E00017896","Total",76,44,15,29,0,11,3,8,21,20,0,1,0,0
"2011","E00017897","E00017897","Total",97,41,14,27,0,24,21,3,32,31,0,1,0,0
"2011","E00017688","E00017688","Total",118,15,8,7,0,82,30,52,20,18,0,1,1,1
"2011","E00017689","E00017689","Total",143,39,18,21,1,62,50,12,38,37,0,0,1,3
"2011","E00017692","E00017692","Total",150,49,17,32,0,75,71,4,22,20,0,2,0,4
"2011","E00017695","E00017695","Total",136,19,6,13,1,92,85,7,21,21,0,0,0,3
"2011","E00017696","E00017696","Total",123,28,13,15,1,75,72,3,16,14,0,2,0,3
"2011","E00017702","E00017702","Total",192,29,11,18,0,85,72,13,76,69,1,5,1,2
"2011","E00017681","E00017681","Total",122,57,17,40,0,38,31,7,26,23,0,1,2,1
"2011","E00017703","E00017703","Total",110,32,13,19,0,37,17,20,37,35,0,0,2,4
"2011","E00017705","E00017705","Total",142,69,23,46,0,47,40,7,25,23,1,0,1,1
"2011","E00017707","E00017707","Total",137,29,9,20,0,86,76,10,20,16,0,3,1,2
"2011","E00017708","E00017708","Total",204,40,14,26,1,71,61,10,91,88,0,3,0,1
"2011","E00017682","E00017682","Total",151,26,5,21,0,95,91,4,27,25,0,0,2,3
"2011","E00017683","E00017683","Total",133,55,12,43,0,37,19,18,37,34,0,0,3,4
"2011","E00017711","E00017711","Total",138,45,25,20,0,44,12,32,48,47,0,1,0,1
"2011","E00017712","E00017712","Total",112,20,8,12,0,71,70,1,19,15,1,1,2,2
"2011","E00017714","E00017714","Total",135,30,10,20,0,48,48,0,56,54,0,1,1,1
"2011","E00017684","E00017684","Total",98,24,8,16,0,63,58,5,11,11,0,0,0,0
"2011","E00017710","E00017710","Total",103,18,6,12,0,64,59,5,21,20,0,1,0,0
"2011","E00017713","E00017713","Total",136,22,5,17,1,98,96,2,13,11,0,1,1,2
"2011","E00017717","E00017717","Total",69,15,7,8,1,47,44,3,6,4,0,1,1,0
"2011","E00175051","E00175051","Total",134,4,2,2,27,72,10,62,28,28,0,0,0,3
"2011","E00175057","E00175057","Total",107,16,3,13,1,69,68,1,20,18,1,1,0,1
"2011","E00017727","E00017727","Total",233,60,19,41,1,64,37,27,102,96,0,5,1,6
"2011","E00017739","E00017739","Total",144,64,28,36,1,53,6,47,25,25,0,0,0,1
"2011","E00017740","E00017740","Total",106,2,1,1,2,88,85,3,11,11,0,0,0,3
"2011","E00017741","E00017741","Total",166,88,32,56,1,24,18,6,52,48,0,3,1,1
"2011","E00017744","E00017744","Total",158,72,35,37,1,33,16,17,49,48,0,0,1,3
"2011","E00017723","E00017723","Total",92,19,10,9,3,52,48,4,16,16,0,0,0,2
"2011","E00017728","E00017728","Total",149,55,21,34,1,46,35,11,46,46,0,0,0,1
"2011","E00017742","E00017742","Total",172,29,17,12,0,86,68,18,54,51,0,1,2,3
"2011","E00017746","E00017746","Total",142,46,20,26,0,39,30,9,56,52,0,3,1,1
"2011","E00017722","E00017722","Total",226,60,24,36,0,38,25,13,124,123,0,0,1,4
"2011","E00017743","E00017743","Total",148,6,1,5,0,8,3,5,133,132,0,0,1,1
"2011","E00017745","E00017745","Total",139,24,5,19,0,37,8,29,77,77,0,0,0,1
"2011","E00017747","E00017747","Total",147,25,6,19,1,40,22,18,79,74,0,4,1,2
"2011","E00017748","E00017748","Total",135,5,3,2,0,11,4,7,118,117,0,1,0,1
"2011","E00018158","E00018158","Total",152,50,12,38,1,32,11,21,69,69,0,0,0,0
"2011","E00018164","E00018164","Total",123,39,10,29,1,62,55,7,20,20,0,0,0,1
"2011","E00018165","E00018165","Total",170,53,15,38,4,66,28,38,43,40,0,2,1,4
"2011","E00018166","E00018166","Total",173,62,20,42,4,68,25,43,39,38,0,1,0,0
"2011","E00018167","E00018167","Total",167,72,26,46,3,37,22,15,55,54,0,1,0,0
"2011","E00017628","E00017628","Total",133,20,1,19,0,98,44,54,15,14,0,0,1,0
"2011","E00017629","E00017629","Total",123,12,2,10,0,77,11,66,33,33,0,0,0,1
"2011","E00017630","E00017630","Total",122,30,12,18,5,62,40,22,24,24,0,0,0,1
"2011","E00017631","E00017631","Total",114,43,16,27,0,50,11,39,19,14,0,3,2,2
"2011","E00017613","E00017613","Total",183,94,25,69,3,23,20,3,63,60,0,3,0,0
"2011","E00017614","E00017614","Total",102,47,11,36,4,1,0,1,49,48,0,1,0,1
"2011","E00017632","E00017632","Total",138,34,5,29,16,25,1,24,62,61,0,1,0,1
"2011","E00017634","E00017634","Total",143,51,6,45,2,7,3,4,80,80,0,0,0,3
"2011","E00017760","E00017760","Total",102,16,7,9,0,65,21,44,17,16,0,0,1,4
"2011","E00017761","E00017761","Total",116,5,1,4,4,98,4,94,6,6,0,0,0,3
"2011","E00017770","E00017770","Total",107,20,5,15,1,66,62,4,20,19,0,1,0,0
"2011","E00017772","E00017772","Total",111,30,8,22,0,51,49,2,26,26,0,0,0,4
"2011","E00017778","E00017778","Total",103,12,5,7,2,63,22,41,25,24,0,0,1,1
"2011","E00017781","E00017781","Total",113,32,9,23,0,59,53,6,22,20,0,2,0,0
"2011","E00017762","E00017762","Total",116,25,8,17,2,67,63,4,21,19,0,0,2,1
"2011","E00017763","E00017763","Total",128,74,18,56,2,10,4,6,42,42,0,0,0,0
"2011","E00017771","E00017771","Total",128,82,16,66,1,10,3,7,34,34,0,0,0,1
"2011","E00017773","E00017773","Total",106,62,20,42,2,3,2,1,38,37,0,1,0,1
"2011","E00017780","E00017780","Total",110,64,20,44,2,2,0,2,40,39,0,1,0,2
"2011","E00017776","E00017776","Total",126,59,22,37,1,9,3,6,54,52,0,1,1,3
"2011","E00017777","E00017777","Total",132,64,24,40,1,23,13,10,43,40,1,2,0,1
"2011","E00017782","E00017782","Total",114,20,8,12,1,56,18,38,37,35,0,1,1,0
"2011","E00017784","E00017784","Total",112,27,11,16,0,65,23,42,20,19,0,1,0,0
"2011","E00017607","E00017607","Total",144,34,9,25,1,50,24,26,56,52,0,2,2,3
"2011","E00017609","E00017609","Total",115,24,8,16,2,73,66,7,16,14,0,0,2,0
"2011","E00017623","E00017623","Total",124,59,14,45,6,17,8,9,41,41,0,0,0,1
"2011","E00017626","E00017626","Total",115,33,6,27,1,58,54,4,22,22,0,0,0,1
"2011","E00175039","E00175039","Total",108,32,9,23,0,40,20,20,36,32,0,1,3,0
"2011","E00175066","E00175066","Total",56,2,2,0,1,16,3,13,36,9,0,0,27,1
"2011","E00017611","E00017611","Total",183,33,9,24,15,50,6,44,84,79,1,4,0,1
"2011","E00017627","E00017627","Total",109,48,3,45,0,7,5,2,54,52,0,0,2,0
"2011","E00017633","E00017633","Total",80,13,3,10,0,46,1,45,21,21,0,0,0,0
"2011","E00017635","E00017635","Total",97,37,2,35,0,7,3,4,53,51,0,2,0,0
"2011","E00017638","E00017638","Total",87,22,3,19,0,33,4,29,31,30,0,1,0,1
"2011","E00174974","E00174974","Total",90,4,0,4,1,72,10,62,12,12,0,0,0,1
"2011","E00174975","E00174975","Total",100,24,4,20,25,18,0,18,32,32,0,0,0,1
"2011","E00174976","E00174976","Total",172,64,18,46,21,28,0,28,56,56,0,0,0,3
"2011","E00174977","E00174977","Total",115,53,4,49,1,0,0,0,58,55,0,2,1,3
"2011","E00017604","E00017604","Total",149,3,2,1,1,125,8,117,17,17,0,0,0,3
"2011","E00017612","E00017612","Total",101,15,1,14,0,67,9,58,17,17,0,0,0,2
"2011","E00017618","E00017618","Total",84,4,0,4,1,74,5,69,4,2,1,0,1,1
"2011","E00017637","E00017637","Total",121,6,1,5,1,106,7,99,8,8,0,0,0,0
"2011","E00017639","E00017639","Total",77,17,2,15,0,38,1,37,21,19,0,0,2,1
"2011","E00017641","E00017641","Total",102,13,4,9,5,74,4,70,8,7,0,0,1,2
"2011","E00017642","E00017642","Total",66,12,4,8,4,41,3,38,9,8,1,0,0,0
"2011","E00174978","E00174978","Total",136,7,3,4,2,114,8,106,9,9,0,0,0,4
"2011","E00175085","E00175085","Total",43,16,2,14,0,7,2,5,20,19,0,1,0,0
"2011","E00017700","E00017700","Total",109,21,5,16,3,70,58,12,13,13,0,0,0,2
"2011","E00017704","E00017704","Total",132,21,7,14,1,24,22,2,86,84,0,1,1,0
"2011","E00017706","E00017706","Total",130,41,19,22,5,29,9,20,49,47,0,0,2,6
"2011","E00017709","E00017709","Total",130,31,9,22,0,71,67,4,26,24,0,2,0,2
"2011","E00017715","E00017715","Total",121,42,19,23,1,61,60,1,16,16,0,0,0,1
"2011","E00017733","E00017733","Total",99,19,5,14,0,61,59,2,17,17,0,0,0,2
"2011","E00017734","E00017734","Total",88,22,7,15,0,53,51,2,11,10,0,1,0,2
"2011","E00017735","E00017735","Total",104,19,9,10,0,55,54,1,27,25,0,2,0,3
"2011","E00017736","E00017736","Total",93,25,6,19,0,47,44,3,19,18,0,0,1,2
"2011","E00017738","E00017738","Total",105,23,6,17,2,57,53,4,23,23,0,0,0,0
"2011","E00174960","E00174960","Total",191,49,13,36,5,2,1,1,134,134,0,0,0,1
"2011","E00174962","E00174962","Total",147,20,0,20,1,5,3,2,115,114,0,1,0,6
"2011","E00175018","E00175018","Total",241,30,8,22,40,14,3,11,156,154,0,1,1,1
"2011","E00174961","E00174961","Total",92,17,4,13,1,2,0,2,72,72,0,0,0,0
"2011","E00174966","E00174966","Total",238,9,2,7,13,12,2,10,202,201,1,0,0,2
"2011","E00175016","E00175016","Total",100,21,3,18,1,4,1,3,72,72,0,0,0,2
"2011","E00175017","E00175017","Total",115,11,1,10,13,12,1,11,79,78,0,0,1,0
"2011","E00174967","E00174967","Total",52,3,1,2,38,2,1,1,9,9,0,0,0,0
"2011","E00174970","E00174970","Total",131,42,7,35,1,6,1,5,81,81,0,0,0,1
"2011","E00175028","E00175028","Total",94,7,3,4,5,27,0,27,54,52,0,1,1,1
"2011","E00175043","E00175043","Total",151,37,14,23,0,83,53,30,31,30,0,0,1,0
"2011","E00175044","E00175044","Total",144,33,8,25,20,34,16,18,56,53,1,2,0,1
"2011","E00175086","E00175086","Total",46,14,10,4,0,17,16,1,15,14,0,1,0,0
"2011","E00017729","E00017729","Total",122,17,9,8,1,89,82,7,14,12,0,1,1,1
"2011","E00017732","E00017732","Total",157,10,5,5,6,125,53,72,15,15,0,0,0,1
"2011","E00175045","E00175045","Total",89,28,9,19,1,32,26,6,28,26,0,1,1,0
"2011","E00175072","E00175072","Total",61,17,1,16,9,25,3,22,10,10,0,0,0,0
"2011","E00175084","E00175084","Total",135,14,4,10,1,98,45,53,19,16,0,2,1,3
"2011","E00017725","E00017725","Total",116,22,13,9,1,80,69,11,13,13,0,0,0,0
"2011","E00017749","E00017749","Total",115,17,6,11,0,90,87,3,7,5,1,0,1,1
"2011","E00017750","E00017750","Total",72,11,4,7,1,42,38,4,15,14,1,0,0,3
"2011","E00017753","E00017753","Total",92,13,5,8,0,60,57,3,15,15,0,0,0,4
"2011","E00017758","E00017758","Total",215,32,11,21,4,121,96,25,54,52,0,0,2,4
"2011","E00017759","E00017759","Total",228,31,2,29,4,29,5,24,162,158,0,2,2,2
"2011","E00175046","E00175046","Total",116,19,6,13,1,74,70,4,22,21,0,1,0,0
"2011","E00017603","E00017603","Total",118,50,12,38,0,12,4,8,54,50,0,4,0,2
"2011","E00017617","E00017617","Total",117,53,21,32,1,19,4,15,44,41,0,2,1,0
"2011","E00017619","E00017619","Total",114,13,2,11,2,82,6,76,16,15,0,0,1,1
"2011","E00017621","E00017621","Total",125,55,14,41,3,2,0,2,64,62,0,1,1,1
"2011","E00017624","E00017624","Total",138,64,22,42,0,3,1,2,71,68,0,2,1,0
"2011","E00017608","E00017608","Total",111,61,19,42,1,22,14,8,25,24,0,1,0,2
"2011","E00017610","E00017610","Total",108,22,7,15,0,73,65,8,10,7,0,0,3,3
"2011","E00017620","E00017620","Total",154,41,6,35,2,43,9,34,63,62,1,0,0,5
"2011","E00017625","E00017625","Total",127,24,7,17,0,83,78,5,18,17,0,1,0,2
"2011","E00017605","E00017605","Total",174,79,23,56,1,20,10,10,71,69,0,2,0,3
"2011","E00017615","E00017615","Total",168,94,40,54,0,22,14,8,50,50,0,0,0,2
"2011","E00017616","E00017616","Total",51,10,1,9,0,11,1,10,30,29,0,1,0,0
"2011","E00017636","E00017636","Total",91,40,11,29,0,27,5,22,24,24,0,0,0,0
"2011","E00017640","E00017640","Total",76,25,3,22,2,12,2,10,37,36,0,0,1,0
"2011","E00017764","E00017764","Total",112,57,14,43,1,13,8,5,39,36,0,2,1,2
"2011","E00017775","E00017775","Total",111,70,22,48,0,7,2,5,33,33,0,0,0,1
"2011","E00017779","E00017779","Total",66,24,10,14,6,15,2,13,20,19,0,1,0,1
"2011","E00017793","E00017793","Total",129,55,8,47,1,10,4,6,63,62,0,1,0,0
"2011","E00017797","E00017797","Total",140,53,8,45,2,22,0,22,61,60,0,0,1,2
"2011","E00017726","E00017726","Total",155,7,5,2,0,134,43,91,8,8,0,0,0,6
"2011","E00017751","E00017751","Total",88,27,11,16,0,47,42,5,9,7,0,2,0,5
"2011","E00017754","E00017754","Total",68,14,3,11,2,39,38,1,12,12,0,0,0,1
"2011","E00017756","E00017756","Total",141,23,5,18,2,92,73,19,22,21,0,1,0,2
"2011","E00017785","E00017785","Total",151,51,10,41,7,48,43,5,40,37,0,2,1,5
"2011","E00017786","E00017786","Total",126,42,21,21,0,60,48,12,24,23,0,0,1,0
"2011","E00017787","E00017787","Total",136,35,16,19,0,77,55,22,23,21,0,1,1,1
"2011","E00017789","E00017789","Total",126,31,7,24,0,73,63,10,22,21,0,1,0,0
"2011","E00017795","E00017795","Total",139,51,15,36,0,38,33,5,49,48,0,0,1,1
"2011","E00017766","E00017766","Total",140,35,9,26,4,59,17,42,40,38,0,0,2,2
"2011","E00017783","E00017783","Total",140,28,5,23,0,86,78,8,26,25,0,1,0,0
"2011","E00017792","E00017792","Total",119,30,12,18,1,71,65,6,16,16,0,0,0,1
"2011","E00017794","E00017794","Total",133,33,5,28,1,72,24,48,27,26,0,1,0,0
"2011","E00017767","E00017767","Total",132,27,8,19,6,76,71,5,23,22,0,0,1,0
"2011","E00017768","E00017768","Total",125,11,3,8,15,81,40,41,17,15,1,1,0,1
"2011","E00017769","E00017769","Total",172,34,18,16,0,95,68,27,37,36,0,1,0,6
"2011","E00017791","E00017791","Total",176,41,10,31,13,81,70,11,40,37,0,1,2,1
"2011","E00017796","E00017796","Total",150,22,6,16,13,87,61,26,24,23,0,0,1,4
"2011","E00017765","E00017765","Total",144,31,3,28,12,82,53,29,18,17,0,1,0,1
"2011","E00017774","E00017774","Total",172,30,5,25,14,106,29,77,22,21,0,0,1,0
"2011","E00017788","E00017788","Total",150,39,12,27,18,71,66,5,21,19,0,0,2,1
"2011","E00017790","E00017790","Total",139,49,12,37,3,32,25,7,54,51,0,3,0,1
"2011","E00018201","E00018201","Total",168,23,7,16,4,102,92,10,37,37,0,0,0,2
"2011","E00018205","E00018205","Total",127,30,8,22,3,61,51,10,32,31,0,1,0,1
"2011","E00018206","E00018206","Total",111,19,6,13,1,64,30,34,27,26,0,0,1,0
"2011","E00174964","E00174964","Total",132,36,5,31,2,0,0,0,92,91,0,1,0,2
"2011","E00174965","E00174965","Total",112,33,1,32,3,3,3,0,73,72,0,1,0,0
"2011","E00175015","E00175015","Total",139,22,8,14,0,83,4,79,32,31,0,0,1,2
"2011","E00175031","E00175031","Total",131,33,21,12,2,53,46,7,41,40,0,1,0,2
"2011","E00175058","E00175058","Total",138,29,5,24,0,44,1,43,62,60,0,1,1,3
"2011","E00018210","E00018210","Total",94,20,3,17,0,57,51,6,16,16,0,0,0,1
"2011","E00018213","E00018213","Total",139,12,4,8,1,109,108,1,17,17,0,0,0,0
"2011","E00018215","E00018215","Total",113,14,4,10,0,80,79,1,18,18,0,0,0,1
"2011","E00018216","E00018216","Total",108,13,3,10,0,74,69,5,19,18,0,1,0,2
"2011","E00174963","E00174963","Total",127,18,3,15,12,48,30,18,48,48,0,0,0,1
"2011","E00174969","E00174969","Total",75,25,15,10,1,29,28,1,18,18,0,0,0,2
"2011","E00175042","E00175042","Total",44,5,1,4,0,26,25,1,12,12,0,0,0,1
"2011","E00018199","E00018199","Total",164,9,4,5,0,117,9,108,35,27,6,0,2,3
"2011","E00174968","E00174968","Total",207,82,19,63,1,1,0,1,120,116,0,3,1,3
"2011","E00174992","E00174992","Total",82,21,3,18,2,1,1,0,58,58,0,0,0,0
"2011","E00174994","E00174994","Total",155,44,9,35,0,24,8,16,86,84,0,2,0,1
"2011","E00018197","E00018197","Total",190,72,9,63,0,3,2,1,113,110,0,3,0,2
"2011","E00018198","E00018198","Total",161,52,11,41,0,6,5,1,101,97,0,4,0,2
"2011","E00018204","E00018204","Total",155,52,14,38,8,20,6,14,75,71,1,3,0,0
"2011","E00174993","E00174993","Total",153,58,10,48,0,1,0,1,93,92,1,0,0,1
"2011","E00018208","E00018208","Total",119,17,5,12,4,82,73,9,15,13,0,0,2,1
"2011","E00018209","E00018209","Total",141,47,15,32,7,58,43,15,29,28,0,1,0,0
"2011","E00018211","E00018211","Total",131,32,10,22,3,68,43,25,27,26,0,1,0,1
"2011","E00018212","E00018212","Total",115,26,8,18,1,65,41,24,22,22,0,0,0,1
"2011","E00018214","E00018214","Total",72,16,3,13,1,40,40,0,14,14,0,0,0,1
"2011","E00174999","E00174999","Total",136,35,6,29,0,2,1,1,96,95,0,1,0,3
"2011","E00175000","E00175000","Total",121,41,4,37,0,4,4,0,75,70,1,4,0,1
"2011","E00175001","E00175001","Total",129,36,5,31,0,9,6,3,81,80,0,1,0,3
"2011","E00175003","E00175003","Total",133,42,3,39,3,3,2,1,85,85,0,0,0,0
"2011","E00175029","E00175029","Total",122,46,8,38,2,6,4,2,65,65,0,0,0,3
"2011","E00175030","E00175030","Total",126,54,7,47,0,1,0,1,70,69,0,0,1,1
"2011","E00020301","E00020301","Total",125,29,8,21,1,65,32,33,28,26,0,0,2,2
"2011","E00020305","E00020305","Total",152,35,9,26,44,16,2,14,54,50,0,3,1,3
"2011","E00020308","E00020308","Total",230,59,20,39,22,53,5,48,94,87,0,3,4,2
"2011","E00020330","E00020330","Total",168,77,22,55,0,3,1,2,85,79,2,2,2,3
"2011","E00020331","E00020331","Total",144,64,26,38,2,3,2,1,75,70,0,4,1,0
"2011","E00020298","E00020298","Total",135,75,19,56,2,6,4,2,51,49,0,0,2,1
"2011","E00020299","E00020299","Total",125,49,18,31,5,19,0,19,50,47,0,3,0,2
"2011","E00020303","E00020303","Total",114,75,20,55,1,2,0,2,36,36,0,0,0,0
"2011","E00020307","E00020307","Total",208,87,32,55,11,5,2,3,102,94,2,6,0,3
"2011","E00020310","E00020310","Total",132,33,11,22,21,4,3,1,70,67,0,3,0,4
"2011","E00020419","E00020419","Total",131,61,19,42,1,18,0,18,51,49,0,1,1,0
"2011","E00020420","E00020420","Total",143,78,30,48,0,45,1,44,20,18,0,2,0,0
"2011","E00020434","E00020434","Total",128,66,21,45,1,0,0,0,59,55,2,2,0,2
"2011","E00020436","E00020436","Total",109,45,7,38,0,20,1,19,43,40,0,3,0,1
"2011","E00020438","E00020438","Total",137,77,19,58,3,1,0,1,54,49,1,3,1,2
"2011","E00020441","E00020441","Total",229,110,30,80,3,8,1,7,105,99,1,5,0,3
"2011","E00020416","E00020416","Total",167,95,22,73,1,3,1,2,66,65,0,1,0,2
"2011","E00020417","E00020417","Total",158,67,22,45,7,24,7,17,59,58,0,0,1,1
"2011","E00020435","E00020435","Total",156,89,22,67,1,7,6,1,54,50,0,3,1,5
"2011","E00020437","E00020437","Total",152,90,27,63,0,0,0,0,58,58,0,0,0,4
"2011","E00020440","E00020440","Total",149,56,15,41,6,28,1,27,57,56,0,1,0,2
"2011","E00020418","E00020418","Total",110,25,8,17,0,77,3,74,6,6,0,0,0,2
"2011","E00020421","E00020421","Total",135,31,12,19,0,94,92,2,8,7,0,0,1,2
"2011","E00020439","E00020439","Total",151,5,3,2,0,140,5,135,6,6,0,0,0,0
"2011","E00020442","E00020442","Total",117,28,8,20,3,73,72,1,13,13,0,0,0,0
"2011","E00019784","E00019784","Total",153,22,8,14,2,65,8,57,60,55,1,3,1,4
"2011","E00019794","E00019794","Total",113,23,10,13,0,62,31,31,27,22,0,1,4,1
"2011","E00019797","E00019797","Total",107,22,8,14,1,63,59,4,17,17,0,0,0,4
"2011","E00166633","E00166633","Total",150,31,3,28,13,28,8,20,76,73,1,2,0,2
"2011","E00166635","E00166635","Total",142,28,4,24,37,19,6,13,58,56,1,1,0,0
"2011","E00166637","E00166637","Total",148,44,13,31,3,44,34,10,56,53,2,0,1,1
"2011","E00166638","E00166638","Total",108,10,0,10,5,49,42,7,43,40,2,0,1,1
"2011","E00166640","E00166640","Total",74,35,8,27,0,19,4,15,17,16,0,1,0,3
"2011","E00019779","E00019779","Total",221,71,34,37,16,19,9,10,108,102,5,1,0,7
"2011","E00019783","E00019783","Total",155,19,6,13,0,71,9,62,63,59,1,1,2,2
"2011","E00019789","E00019789","Total",184,21,7,14,12,115,7,108,36,33,0,2,1,0
"2011","E00019791","E00019791","Total",231,56,17,39,4,96,65,31,74,67,0,7,0,1
"2011","E00167494","E00167494","Total",123,41,15,26,0,44,41,3,37,33,0,3,1,1
"2011","E00167496","E00167496","Total",58,22,10,12,0,5,5,0,29,26,1,1,1,2
"2011","E00167497","E00167497","Total",102,25,5,20,0,5,4,1,68,64,0,4,0,4
"2011","E00019773","E00019773","Total",129,42,24,18,0,67,37,30,20,17,0,2,1,0
"2011","E00019774","E00019774","Total",155,53,21,32,1,78,1,77,22,20,0,2,0,1
"2011","E00019777","E00019777","Total",139,49,32,17,1,63,3,60,25,20,0,4,1,1
"2011","E00019778","E00019778","Total",103,56,18,38,3,1,0,1,40,37,0,1,2,3
"2011","E00019781","E00019781","Total",177,24,9,15,7,54,20,34,70,62,2,6,0,22
"2011","E00019785","E00019785","Total",108,20,6,14,0,68,68,0,16,14,1,0,1,4
"2011","E00019780","E00019780","Total",131,16,3,13,0,104,93,11,11,10,1,0,0,0
"2011","E00019782","E00019782","Total",112,2,1,1,3,96,17,79,10,9,0,0,1,1
"2011","E00166632","E00166632","Total",111,46,15,31,0,10,2,8,52,49,1,2,0,3
"2011","E00167481","E00167481","Total",97,22,6,16,1,46,17,29,27,22,0,3,2,1
"2011","E00019839","E00019839","Total",206,23,4,19,1,57,39,18,120,40,55,0,25,5
"2011","E00019842","E00019842","Total",107,39,19,20,5,2,2,0,58,51,0,7,0,3
"2011","E00019847","E00019847","Total",142,25,8,17,0,85,66,19,29,26,1,1,1,3
"2011","E00019848","E00019848","Total",84,20,4,16,0,53,50,3,11,10,0,1,0,0
"2011","E00167992","E00167992","Total",138,45,25,20,24,5,3,2,60,54,2,3,1,4
"2011","E00168079","E00168079","Total",159,44,9,35,0,68,46,22,46,41,1,4,0,1
"2011","E00020011","E00020011","Total",155,35,9,26,1,67,21,46,50,45,0,5,0,2
"2011","E00020037","E00020037","Total",113,26,6,20,0,60,59,1,25,24,0,1,0,2
"2011","E00020043","E00020043","Total",131,18,3,15,0,77,76,1,36,34,0,2,0,0
"2011","E00020044","E00020044","Total",244,83,20,63,3,53,51,2,104,99,0,2,3,1
"2011","E00020046","E00020046","Total",135,25,8,17,0,86,85,1,24,20,0,4,0,0
"2011","E00020048","E00020048","Total",138,18,6,12,2,87,63,24,27,26,0,1,0,4
"2011","E00020255","E00020255","Total",234,56,16,40,11,37,31,6,129,122,1,3,3,1
"2011","E00020263","E00020263","Total",111,19,8,11,1,63,53,10,27,25,0,2,0,1
"2011","E00020264","E00020264","Total",191,52,14,38,0,93,83,10,44,43,0,0,1,2
"2011","E00020266","E00020266","Total",145,25,10,15,0,79,74,5,38,36,0,2,0,3
"2011","E00020275","E00020275","Total",165,34,11,23,2,89,73,16,36,34,0,2,0,4
"2011","E00020278","E00020278","Total",147,19,6,13,0,71,62,9,56,53,0,3,0,1
"2011","E00020267","E00020267","Total",129,46,16,30,0,2,2,0,76,72,0,4,0,5
"2011","E00166629","E00166629","Total",107,46,14,32,0,0,0,0,56,54,0,1,1,5
"2011","E00167477","E00167477","Total",136,55,18,37,1,1,1,0,76,75,0,1,0,3
"2011","E00167483","E00167483","Total",182,52,7,45,4,1,0,1,118,117,0,0,1,7
"2011","E00167681","E00167681","Total",87,45,10,35,0,1,1,0,41,40,0,0,1,0
"2011","E00020268","E00020268","Total",103,51,20,31,0,2,1,1,45,43,0,2,0,5
"2011","E00020269","E00020269","Total",195,106,43,63,0,3,2,1,84,79,3,2,0,2
"2011","E00166641","E00166641","Total",125,59,21,38,1,1,1,0,64,64,0,0,0,0
"2011","E00167519","E00167519","Total",120,61,24,37,1,0,0,0,58,57,0,1,0,0
"2011","E00167678","E00167678","Total",110,46,12,34,0,3,3,0,61,59,0,2,0,0
"2011","E00020260","E00020260","Total",125,45,12,33,0,2,2,0,73,72,0,1,0,5
"2011","E00020262","E00020262","Total",117,53,26,27,0,1,1,0,61,57,0,4,0,2
"2011","E00167485","E00167485","Total",125,62,25,37,0,1,1,0,58,57,0,0,1,4
"2011","E00167679","E00167679","Total",105,60,15,45,0,0,0,0,41,36,0,5,0,4
"2011","E00167688","E00167688","Total",80,35,21,14,0,1,1,0,41,41,0,0,0,3
"2011","E00167751","E00167751","Total",120,33,9,24,0,0,0,0,85,81,0,4,0,2
"2011","E00020034","E00020034","Total",122,20,5,15,1,74,54,20,26,23,0,1,2,1
"2011","E00020035","E00020035","Total",132,43,15,28,2,43,34,9,42,38,1,3,0,2
"2011","E00167490","E00167490","Total",114,17,4,13,0,26,12,14,67,62,0,1,4,4
"2011","E00167982","E00167982","Total",119,49,16,33,0,9,5,4,59,57,0,2,0,2
"2011","E00168026","E00168026","Total",116,34,12,22,0,2,0,2,76,71,0,2,3,4
"2011","E00168029","E00168029","Total",134,54,11,43,8,1,0,1,71,69,0,1,1,0
"2011","E00020010","E00020010","Total",146,53,19,34,4,4,3,1,81,78,0,2,1,4
"2011","E00020041","E00020041","Total",76,15,4,11,0,50,48,2,10,8,0,2,0,1
"2011","E00167987","E00167987","Total",160,48,11,37,3,7,1,6,99,97,0,1,1,3
"2011","E00168023","E00168023","Total",134,54,13,41,2,19,4,15,58,56,0,1,1,1
"2011","E00168027","E00168027","Total",142,37,7,30,16,4,3,1,84,82,0,1,1,1
"2011","E00020259","E00020259","Total",189,68,26,42,0,1,0,1,115,110,0,5,0,5
"2011","E00020261","E00020261","Total",172,93,45,48,0,0,0,0,75,69,0,5,1,4
"2011","E00020270","E00020270","Total",186,69,22,47,0,18,17,1,96,92,1,3,0,3
"2011","E00020271","E00020271","Total",119,50,27,23,0,3,2,1,62,60,0,2,0,4
"2011","E00020045","E00020045","Total",122,13,2,11,2,95,94,1,12,11,0,1,0,0
"2011","E00020047","E00020047","Total",125,15,7,8,7,83,54,29,19,18,0,1,0,1
"2011","E00020049","E00020049","Total",74,4,1,3,0,54,19,35,14,13,0,1,0,2
"2011","E00020050","E00020050","Total",123,18,2,16,1,89,89,0,13,13,0,0,0,2
"2011","E00020052","E00020052","Total",223,45,14,31,32,120,84,36,24,22,1,1,0,2
"2011","E00020012","E00020012","Total",118,19,6,13,0,87,54,33,11,11,0,0,0,1
"2011","E00020013","E00020013","Total",171,26,4,22,2,91,45,46,50,48,0,2,0,2
"2011","E00020017","E00020017","Total",209,75,12,63,11,77,44,33,46,42,0,4,0,0
"2011","E00020028","E00020028","Total",205,86,21,65,8,47,1,46,62,57,1,3,1,2
"2011","E00020051","E00020051","Total",205,48,9,39,5,35,28,7,116,110,1,4,1,1
"2011","E00020250","E00020250","Total",188,36,11,25,29,99,63,36,23,19,0,4,0,1
"2011","E00020280","E00020280","Total",116,18,5,13,1,81,80,1,14,14,0,0,0,2
"2011","E00020284","E00020284","Total",98,23,9,14,0,46,45,1,27,27,0,0,0,2
"2011","E00020286","E00020286","Total",125,38,21,17,5,53,45,8,29,28,0,1,0,0
"2011","E00020290","E00020290","Total",156,58,19,39,5,57,22,35,34,33,0,1,0,2
"2011","E00167993","E00167993","Total",121,10,4,6,79,28,3,25,4,3,0,1,0,0
"2011","E00168006","E00168006","Total",142,36,13,23,3,83,53,30,17,15,0,2,0,3
"2011","E00168007","E00168007","Total",200,41,11,30,38,96,9,87,24,23,0,1,0,1
"2011","E00020257","E00020257","Total",129,47,22,25,0,48,47,1,31,27,0,2,2,3
"2011","E00020273","E00020273","Total",111,37,16,21,1,54,53,1,18,13,0,4,1,1
"2011","E00020276","E00020276","Total",128,28,15,13,1,85,83,2,14,14,0,0,0,0
"2011","E00020277","E00020277","Total",122,37,10,27,0,58,58,0,27,26,1,0,0,0
"2011","E00020287","E00020287","Total",106,12,3,9,1,83,83,0,9,9,0,0,0,1
"2011","E00020289","E00020289","Total",107,15,2,13,0,76,76,0,14,11,1,2,0,2
"2011","E00020274","E00020274","Total",167,26,5,21,19,99,98,1,23,22,0,1,0,0
"2011","E00020281","E00020281","Total",155,21,2,19,2,108,107,1,23,22,0,1,0,1
"2011","E00020282","E00020282","Total",113,17,4,13,1,75,75,0,19,16,0,2,1,1
"2011","E00020283","E00020283","Total",122,27,9,18,1,77,75,2,15,15,0,0,0,2
"2011","E00167484","E00167484","Total",156,29,7,22,5,75,62,13,37,28,1,6,2,10
"2011","E00019811","E00019811","Total",124,22,5,17,6,65,63,2,31,28,0,3,0,0
"2011","E00019841","E00019841","Total",134,20,4,16,0,82,80,2,30,24,0,6,0,2
"2011","E00019844","E00019844","Total",97,14,4,10,2,55,54,1,26,26,0,0,0,0
"2011","E00019845","E00019845","Total",102,13,4,9,2,63,53,10,22,20,0,2,0,2
"2011","E00167766","E00167766","Total",170,54,23,31,6,69,57,12,36,34,0,2,0,5
"2011","E00167989","E00167989","Total",163,15,3,12,64,69,11,58,15,14,0,1,0,0
"2011","E00019815","E00019815","Total",151,27,11,16,0,92,91,1,32,30,0,2,0,0
"2011","E00019816","E00019816","Total",111,12,0,12,1,78,72,6,17,17,0,0,0,3
"2011","E00019817","E00019817","Total",88,16,1,15,1,59,57,2,11,11,0,0,0,1
"2011","E00019820","E00019820","Total",123,15,3,12,0,85,75,10,19,16,0,3,0,4
"2011","E00019826","E00019826","Total",147,23,6,17,0,96,91,5,26,24,0,2,0,2
"2011","E00019808","E00019808","Total",219,57,9,48,4,105,87,18,52,48,0,3,1,1
"2011","E00019818","E00019818","Total",198,77,19,58,12,39,20,19,67,57,1,7,2,3
"2011","E00019822","E00019822","Total",178,26,10,16,2,62,47,15,88,86,0,2,0,0
"2011","E00167755","E00167755","Total",121,13,4,9,0,84,67,17,24,21,0,3,0,0
"2011","E00167995","E00167995","Total",196,116,28,88,0,5,4,1,75,71,1,3,0,0
"2011","E00019814","E00019814","Total",100,8,0,8,1,75,68,7,15,14,0,0,1,1
"2011","E00019825","E00019825","Total",92,18,6,12,0,56,45,11,17,15,0,1,1,1
"2011","E00019828","E00019828","Total",97,13,0,13,0,73,62,11,9,9,0,0,0,2
"2011","E00019830","E00019830","Total",138,29,11,18,0,76,63,13,30,29,0,1,0,3
"2011","E00019833","E00019833","Total",134,28,7,21,0,82,73,9,22,21,0,1,0,2
"2011","E00020014","E00020014","Total",164,63,18,45,1,12,1,11,85,77,0,7,1,3
"2011","E00020015","E00020015","Total",124,11,0,11,0,99,74,25,12,11,1,0,0,2
"2011","E00020018","E00020018","Total",130,25,5,20,4,52,15,37,47,43,3,1,0,2
"2011","E00020021","E00020021","Total",142,12,4,8,0,90,30,60,39,38,0,1,0,1
"2011","E00020024","E00020024","Total",124,1,0,1,0,111,11,100,11,8,0,2,1,1
"2011","E00020027","E00020027","Total",125,77,22,55,0,1,0,1,46,44,0,2,0,1
"2011","E00020008","E00020008","Total",138,17,5,12,1,60,16,44,54,53,0,0,1,6
"2011","E00020009","E00020009","Total",148,32,7,25,0,70,6,64,44,43,0,1,0,2
"2011","E00020036","E00020036","Total",127,19,9,10,0,56,40,16,47,29,12,2,4,5
"2011","E00020039","E00020039","Total",149,14,5,9,2,119,100,19,13,12,0,1,0,1
"2011","E00020040","E00020040","Total",131,22,8,14,0,58,57,1,46,39,1,6,0,5
"2011","E00020292","E00020292","Total",183,45,11,34,1,98,4,94,37,34,0,3,0,2
"2011","E00020293","E00020293","Total",173,68,23,45,0,40,40,0,60,59,0,1,0,5
"2011","E00020300","E00020300","Total",124,10,4,6,0,99,15,84,13,11,0,1,1,2
"2011","E00020304","E00020304","Total",140,27,8,19,1,86,85,1,24,22,1,0,1,2
"2011","E00020332","E00020332","Total",106,25,10,15,0,63,46,17,18,18,0,0,0,0
"2011","E00020295","E00020295","Total",131,41,10,31,0,62,43,19,26,25,0,1,0,2
"2011","E00020296","E00020296","Total",101,14,3,11,3,61,60,1,23,22,0,1,0,0
"2011","E00020314","E00020314","Total",132,38,6,32,2,57,49,8,35,33,0,2,0,0
"2011","E00020318","E00020318","Total",156,63,13,50,18,35,12,23,39,37,0,2,0,1
"2011","E00167486","E00167486","Total",94,33,13,20,2,40,5,35,19,17,0,1,1,0
"2011","E00167487","E00167487","Total",153,50,23,27,13,31,7,24,53,50,0,1,2,6
"2011","E00167758","E00167758","Total",113,34,17,17,0,58,56,2,20,19,0,1,0,1
"2011","E00020302","E00020302","Total",129,30,5,25,10,56,47,9,30,30,0,0,0,3
"2011","E00020306","E00020306","Total",160,32,10,22,14,68,58,10,42,40,1,1,0,4
"2011","E00020312","E00020312","Total",137,16,5,11,0,96,48,48,20,17,2,0,1,5
"2011","E00020313","E00020313","Total",124,14,2,12,4,92,89,3,14,13,0,1,0,0
"2011","E00020315","E00020315","Total",149,9,1,8,0,123,121,2,16,15,0,1,0,1
"2011","E00020294","E00020294","Total",118,7,1,6,0,91,89,2,18,17,0,1,0,2
"2011","E00020309","E00020309","Total",133,50,14,36,7,50,48,2,23,22,0,1,0,3
"2011","E00020311","E00020311","Total",139,25,5,20,0,72,71,1,40,37,0,3,0,2
"2011","E00020317","E00020317","Total",141,18,3,15,0,104,104,0,19,19,0,0,0,0
"2011","E00020319","E00020319","Total",104,16,6,10,0,70,69,1,18,15,0,3,0,0
"2011","E00020321","E00020321","Total",130,9,3,6,0,114,111,3,7,6,0,1,0,0
"2011","E00020323","E00020323","Total",172,32,8,24,3,23,8,15,113,110,0,2,1,1
"2011","E00020325","E00020325","Total",148,19,7,12,0,108,105,3,16,14,0,2,0,5
"2011","E00020327","E00020327","Total",112,12,4,8,0,80,77,3,20,20,0,0,0,0
"2011","E00020328","E00020328","Total",110,13,5,8,0,83,83,0,14,13,0,1,0,0
"2011","E00020329","E00020329","Total",134,14,8,6,1,97,95,2,21,18,2,1,0,1
"2011","E00020443","E00020443","Total",197,81,18,63,1,3,1,2,112,111,0,1,0,0
"2011","E00020444","E00020444","Total",219,75,14,61,2,39,2,37,102,97,0,4,1,1
"2011","E00020445","E00020445","Total",127,26,10,16,4,79,17,62,18,18,0,0,0,0
"2011","E00020447","E00020447","Total",131,17,6,11,0,96,1,95,15,15,0,0,0,3
"2011","E00020448","E00020448","Total",106,9,2,7,0,77,3,74,17,16,0,0,1,3
"2011","E00020449","E00020449","Total",126,54,14,40,12,5,0,5,50,46,0,3,1,5
"2011","E00020422","E00020422","Total",129,82,26,56,1,3,1,2,43,43,0,0,0,0
"2011","E00020423","E00020423","Total",111,25,10,15,0,57,3,54,26,25,0,1,0,3
"2011","E00020450","E00020450","Total",133,81,36,45,2,2,1,1,44,43,0,1,0,4
"2011","E00020451","E00020451","Total",144,84,42,42,0,4,4,0,55,54,0,1,0,1
"2011","E00020455","E00020455","Total",151,5,3,2,1,141,0,141,2,1,0,0,1,2
"2011","E00020415","E00020415","Total",169,64,14,50,1,2,1,1,95,93,0,2,0,7
"2011","E00020426","E00020426","Total",122,63,20,43,0,0,0,0,59,58,0,1,0,0
"2011","E00020427","E00020427","Total",193,104,59,45,5,4,1,3,79,76,0,3,0,1
"2011","E00020428","E00020428","Total",123,53,19,34,1,1,0,1,66,65,0,1,0,2
"2011","E00020452","E00020452","Total",102,50,7,43,30,2,1,1,19,19,0,0,0,1
"2011","E00020453","E00020453","Total",146,76,18,58,2,0,0,0,66,64,0,1,1,2
"2011","E00020424","E00020424","Total",116,46,17,29,0,1,0,1,69,69,0,0,0,0
"2011","E00020425","E00020425","Total",155,42,16,26,0,9,1,8,101,99,0,1,1,3
"2011","E00020429","E00020429","Total",128,68,23,45,0,4,0,4,56,54,0,2,0,0
"2011","E00020446","E00020446","Total",159,65,18,47,1,10,1,9,76,72,0,2,2,7
"2011","E00020454","E00020454","Total",104,52,19,33,0,0,0,0,51,48,0,3,0,1
"2011","E00020430","E00020430","Total",152,18,8,10,1,105,96,9,27,25,0,1,1,1
"2011","E00020431","E00020431","Total",122,15,2,13,0,82,40,42,24,24,0,0,0,1
"2011","E00020432","E00020432","Total",150,33,8,25,0,65,43,22,51,50,0,1,0,1
"2011","E00020433","E00020433","Total",83,3,2,1,0,75,5,70,4,4,0,0,0,1
"2011","E00167488","E00167488","Total",127,37,11,26,1,36,2,34,53,49,1,1,2,0
"2011","E00167489","E00167489","Total",151,68,18,50,1,3,1,2,78,66,0,10,2,1
"2011","E00019812","E00019812","Total",105,14,3,11,0,40,0,40,50,48,0,1,1,1
"2011","E00019823","E00019823","Total",101,10,5,5,0,46,10,36,44,40,1,3,0,1
"2011","E00019843","E00019843","Total",204,67,23,44,1,58,6,52,74,70,0,4,0,4
"2011","E00166630","E00166630","Total",61,18,7,11,0,5,2,3,37,24,3,3,7,1
"2011","E00168080","E00168080","Total",81,36,9,27,1,1,1,0,43,40,0,3,0,0
"2011","E00019810","E00019810","Total",174,25,5,20,78,15,4,11,55,52,0,3,0,1
"2011","E00019813","E00019813","Total",135,22,4,18,0,73,71,2,39,37,0,2,0,1
"2011","E00019819","E00019819","Total",124,50,20,30,2,26,26,0,43,41,0,2,0,3
"2011","E00167499","E00167499","Total",176,63,27,36,11,4,3,1,96,90,0,6,0,2
"2011","E00167500","E00167500","Total",125,39,11,28,5,3,3,0,74,70,1,2,1,4
"2011","E00019824","E00019824","Total",79,12,4,8,0,47,46,1,19,15,0,4,0,1
"2011","E00019827","E00019827","Total",107,13,8,5,0,64,61,3,29,27,0,2,0,1
"2011","E00019829","E00019829","Total",105,19,4,15,1,76,76,0,8,8,0,0,0,1
"2011","E00019831","E00019831","Total",141,21,4,17,0,86,79,7,30,27,0,3,0,4
"2011","E00019838","E00019838","Total",117,14,2,12,1,80,77,3,20,17,0,3,0,2
"2011","E00019834","E00019834","Total",103,9,3,6,0,74,73,1,20,20,0,0,0,0
"2011","E00019836","E00019836","Total",151,20,5,15,0,92,90,2,37,34,0,2,1,2
"2011","E00167979","E00167979","Total",154,17,6,11,13,88,87,1,34,32,0,0,2,2
"2011","E00167999","E00167999","Total",114,12,5,7,6,75,66,9,21,20,0,1,0,0
"2011","E00168082","E00168082","Total",159,39,14,25,18,7,6,1,91,91,0,0,0,4
"2011","E00020016","E00020016","Total",126,22,6,16,1,77,76,1,18,17,0,1,0,8
"2011","E00020019","E00020019","Total",137,26,7,19,1,90,88,2,19,19,0,0,0,1
"2011","E00020020","E00020020","Total",131,50,10,40,7,29,26,3,42,41,0,1,0,3
"2011","E00020022","E00020022","Total",117,20,5,15,0,87,86,1,9,8,0,1,0,1
"2011","E00020025","E00020025","Total",139,35,13,22,0,73,67,6,29,27,0,1,1,2
"2011","E00020026","E00020026","Total",150,15,3,12,0,116,108,8,17,17,0,0,0,2
"2011","E00020335","E00020335","Total",166,12,2,10,21,120,57,63,13,12,0,0,1,0
"2011","E00020339","E00020339","Total",171,18,2,16,0,131,126,5,22,22,0,0,0,0
"2011","E00020342","E00020342","Total",125,60,11,49,0,8,4,4,57,56,0,1,0,0
"2011","E00020345","E00020345","Total",155,63,7,56,6,5,1,4,77,73,0,4,0,4
"2011","E00020348","E00020348","Total",120,39,6,33,13,14,3,11,54,50,0,4,0,0
"2011","E00020374","E00020374","Total",141,23,6,17,0,98,98,0,19,17,0,2,0,1
"2011","E00020338","E00020338","Total",154,7,1,6,1,21,5,16,125,125,0,0,0,0
"2011","E00020344","E00020344","Total",181,8,4,4,10,142,6,136,19,16,0,3,0,2
"2011","E00020355","E00020355","Total",107,42,4,38,30,4,4,0,31,29,0,2,0,0
"2011","E00020356","E00020356","Total",177,57,4,53,31,40,4,36,49,44,0,5,0,0
"2011","E00167502","E00167502","Total",109,7,3,4,48,44,17,27,9,8,0,0,1,1
"2011","E00167516","E00167516","Total",102,21,4,17,1,48,4,44,32,30,0,1,1,0
"2011","E00167517","E00167517","Total",90,16,2,14,6,48,3,45,18,18,0,0,0,2
"2011","E00020333","E00020333","Total",130,23,12,11,0,89,88,1,18,17,0,1,0,0
"2011","E00020340","E00020340","Total",139,19,7,12,1,103,58,45,13,13,0,0,0,3
"2011","E00020361","E00020361","Total",162,19,6,13,3,108,107,1,32,31,0,1,0,0
"2011","E00020365","E00020365","Total",169,33,14,19,1,82,78,4,52,50,0,1,1,1
"2011","E00020370","E00020370","Total",162,19,8,11,2,128,118,10,13,12,0,1,0,0
"2011","E00020334","E00020334","Total",137,79,44,35,0,38,14,24,19,19,0,0,0,1
"2011","E00020363","E00020363","Total",99,39,19,20,1,44,40,4,13,12,0,1,0,2
"2011","E00020364","E00020364","Total",106,46,16,30,0,42,26,16,18,16,0,1,1,0
"2011","E00020366","E00020366","Total",128,36,12,24,6,59,59,0,23,20,0,3,0,4
"2011","E00020367","E00020367","Total",129,47,26,21,0,46,22,24,34,32,0,1,1,2
"2011","E00020059","E00020059","Total",158,11,6,5,2,122,34,88,17,16,0,0,1,6
"2011","E00020087","E00020087","Total",108,13,4,9,0,78,61,17,13,12,0,0,1,4
"2011","E00020088","E00020088","Total",96,4,0,4,0,85,58,27,6,5,0,1,0,1
"2011","E00020089","E00020089","Total",124,18,6,12,1,89,86,3,13,13,0,0,0,3
"2011","E00020090","E00020090","Total",63,3,1,2,0,57,44,13,1,1,0,0,0,2
"2011","E00020057","E00020057","Total",126,14,6,8,0,98,42,56,14,14,0,0,0,0
"2011","E00020091","E00020091","Total",90,12,6,6,0,77,42,35,1,1,0,0,0,0
"2011","E00020092","E00020092","Total",111,8,2,6,0,87,86,1,16,16,0,0,0,0
"2011","E00020093","E00020093","Total",109,10,1,9,0,89,89,0,10,10,0,0,0,0
"2011","E00167984","E00167984","Total",120,42,10,32,2,37,4,33,39,39,0,0,0,0
"2011","E00168003","E00168003","Total",115,6,3,3,23,73,3,70,8,7,0,1,0,5
"2011","E00168004","E00168004","Total",83,3,0,3,3,63,4,59,14,14,0,0,0,0
"2011","E00020249","E00020249","Total",148,21,4,17,0,93,93,0,31,29,0,2,0,3
"2011","E00020251","E00020251","Total",177,30,6,24,1,111,105,6,35,35,0,0,0,0
"2011","E00020252","E00020252","Total",181,24,7,17,0,131,130,1,25,24,0,1,0,1
"2011","E00020253","E00020253","Total",151,19,3,16,0,118,114,4,13,11,0,1,1,1
"2011","E00020254","E00020254","Total",107,8,4,4,3,73,72,1,20,19,0,0,1,3
"2011","E00020291","E00020291","Total",55,13,7,6,0,23,7,16,19,19,0,0,0,0
"2011","E00020297","E00020297","Total",126,30,12,18,0,83,76,7,11,11,0,0,0,2
"2011","E00020320","E00020320","Total",134,37,11,26,1,72,62,10,24,21,0,3,0,0
"2011","E00020322","E00020322","Total",146,7,4,3,0,130,126,4,9,9,0,0,0,0
"2011","E00020324","E00020324","Total",144,12,4,8,0,106,74,32,26,23,0,3,0,0
"2011","E00020326","E00020326","Total",137,18,11,7,0,98,90,8,20,19,0,1,0,1
"2011","E00019923","E00019923","Total",244,40,10,30,33,115,30,85,54,52,0,1,1,2
"2011","E00019924","E00019924","Total",118,24,10,14,0,65,64,1,27,24,0,2,1,2
"2011","E00019937","E00019937","Total",99,40,12,28,5,12,4,8,42,38,0,3,1,0
"2011","E00019942","E00019942","Total",85,16,5,11,1,10,7,3,54,53,1,0,0,4
"2011","E00019943","E00019943","Total",101,40,11,29,0,3,2,1,57,53,1,3,0,1
"2011","E00019945","E00019945","Total",119,22,5,17,2,72,71,1,22,22,0,0,0,1
"2011","E00019947","E00019947","Total",141,23,4,19,0,97,92,5,20,19,0,0,1,1
"2011","E00019949","E00019949","Total",209,15,3,12,0,160,85,75,30,29,0,1,0,4
"2011","E00019950","E00019950","Total",131,12,2,10,0,97,94,3,21,21,0,0,0,1
"2011","E00019953","E00019953","Total",135,25,11,14,3,83,79,4,21,21,0,0,0,3
"2011","E00019955","E00019955","Total",103,16,3,13,0,74,72,2,12,10,0,2,0,1
"2011","E00019957","E00019957","Total",178,29,15,14,9,90,61,29,43,40,1,2,0,7
"2011","E00020102","E00020102","Total",119,23,3,20,0,87,84,3,9,9,0,0,0,0
"2011","E00020106","E00020106","Total",189,39,12,27,0,118,76,42,31,27,0,1,3,1
"2011","E00020110","E00020110","Total",93,28,11,17,0,42,38,4,22,21,0,1,0,1
"2011","E00020113","E00020113","Total",88,10,1,9,2,9,5,4,65,61,0,1,3,2
"2011","E00020115","E00020115","Total",133,21,2,19,3,85,77,8,23,19,0,4,0,1
"2011","E00019938","E00019938","Total",63,11,3,8,1,36,18,18,15,15,0,0,0,0
"2011","E00019944","E00019944","Total",92,10,4,6,7,64,4,60,10,10,0,0,0,1
"2011","E00019948","E00019948","Total",115,14,4,10,0,8,0,8,93,92,0,0,1,0
"2011","E00019960","E00019960","Total",119,25,8,17,0,59,50,9,34,33,0,0,1,1
"2011","E00019964","E00019964","Total",147,17,4,13,3,71,67,4,53,51,0,1,1,3
"2011","E00167981","E00167981","Total",179,11,2,9,1,142,8,134,25,23,0,0,2,0
"2011","E00167985","E00167985","Total",217,35,11,24,6,36,15,21,139,137,0,2,0,1
"2011","E00020023","E00020023","Total",132,19,8,11,1,94,80,14,16,15,0,1,0,2
"2011","E00020029","E00020029","Total",128,27,12,15,0,84,78,6,17,16,0,1,0,0
"2011","E00020030","E00020030","Total",128,9,3,6,0,105,66,39,13,13,0,0,0,1
"2011","E00020031","E00020031","Total",148,14,1,13,0,98,8,90,35,31,0,3,1,1
"2011","E00020032","E00020032","Total",131,8,2,6,0,99,1,98,23,21,0,1,1,1
"2011","E00020033","E00020033","Total",180,24,8,16,1,42,9,33,108,104,0,3,1,5
"2011","E00020336","E00020336","Total",157,52,16,36,2,58,55,3,43,41,0,2,0,2
"2011","E00020337","E00020337","Total",116,59,20,39,1,5,1,4,51,48,0,3,0,0
"2011","E00020347","E00020347","Total",142,47,7,40,1,43,39,4,50,48,0,2,0,1
"2011","E00020351","E00020351","Total",102,13,1,12,0,66,57,9,22,21,0,0,1,1
"2011","E00020369","E00020369","Total",116,55,10,45,2,4,4,0,53,51,0,2,0,2
"2011","E00020352","E00020352","Total",187,18,7,11,1,153,150,3,13,12,0,1,0,2
"2011","E00020353","E00020353","Total",129,2,0,2,18,101,45,56,8,8,0,0,0,0
"2011","E00020354","E00020354","Total",164,3,2,1,12,136,45,91,12,9,0,0,3,1
"2011","E00020357","E00020357","Total",125,12,3,9,0,94,54,40,17,11,0,0,6,2
"2011","E00020358","E00020358","Total",75,13,1,12,0,54,50,4,8,8,0,0,0,0
"2011","E00020341","E00020341","Total",97,6,4,2,0,56,6,50,33,32,0,0,1,2
"2011","E00020346","E00020346","Total",102,30,10,20,0,28,3,25,43,42,0,1,0,1
"2011","E00020349","E00020349","Total",124,8,3,5,1,91,42,49,23,17,1,0,5,1
"2011","E00020350","E00020350","Total",108,7,4,3,1,88,47,41,12,9,0,1,2,0
"2011","E00020359","E00020359","Total",123,19,3,16,0,87,37,50,15,11,0,2,2,2
"2011","E00020360","E00020360","Total",145,17,6,11,0,112,42,70,16,9,0,2,5,0
"2011","E00020362","E00020362","Total",110,17,2,15,0,76,72,4,17,16,0,1,0,0
"2011","E00020368","E00020368","Total",134,22,5,17,0,94,90,4,16,16,0,0,0,2
"2011","E00020371","E00020371","Total",96,31,14,17,5,42,42,0,18,18,0,0,0,0
"2011","E00020372","E00020372","Total",100,13,5,8,1,81,78,3,4,4,0,0,0,1
"2011","E00020373","E00020373","Total",116,35,11,24,1,64,61,3,13,11,0,0,2,3
"2011","E00020095","E00020095","Total",126,31,12,19,0,62,57,5,30,27,0,1,2,3
"2011","E00020124","E00020124","Total",87,13,3,10,0,61,57,4,11,10,0,1,0,2
"2011","E00020128","E00020128","Total",124,9,4,5,1,102,85,17,12,12,0,0,0,0
"2011","E00020129","E00020129","Total",110,24,10,14,2,71,69,2,13,13,0,0,0,0
"2011","E00020130","E00020130","Total",143,24,12,12,3,96,95,1,19,17,0,1,1,1
"2011","E00020103","E00020103","Total",74,7,5,2,0,65,40,25,2,2,0,0,0,0
"2011","E00020104","E00020104","Total",97,32,10,22,0,47,46,1,18,18,0,0,0,0
"2011","E00020105","E00020105","Total",105,35,18,17,1,54,54,0,15,14,0,1,0,0
"2011","E00020108","E00020108","Total",115,18,4,14,1,68,32,36,28,28,0,0,0,0
"2011","E00020109","E00020109","Total",122,33,9,24,0,64,63,1,23,21,1,1,0,2
"2011","E00020138","E00020138","Total",107,3,2,1,0,100,7,93,4,3,0,1,0,0
"2011","E00020139","E00020139","Total",118,32,11,21,0,67,58,9,19,19,0,0,0,0
"2011","E00020107","E00020107","Total",121,42,21,21,1,49,42,7,28,28,0,0,0,1
"2011","E00020111","E00020111","Total",119,27,15,12,2,58,43,15,31,29,1,0,1,1
"2011","E00020112","E00020112","Total",100,53,17,36,0,7,5,2,40,35,0,5,0,0
"2011","E00020114","E00020114","Total",180,32,7,25,0,116,22,94,32,26,0,5,1,0
"2011","E00020117","E00020117","Total",112,36,11,25,2,49,38,11,23,21,1,1,0,2
"2011","E00020116","E00020116","Total",98,14,4,10,3,71,69,2,9,8,0,1,0,1
"2011","E00020118","E00020118","Total",135,66,24,42,1,13,12,1,53,49,0,4,0,2
"2011","E00020121","E00020121","Total",127,41,6,35,1,63,63,0,22,18,0,4,0,0
"2011","E00020122","E00020122","Total",109,17,4,13,2,70,67,3,20,20,0,0,0,0
"2011","E00020127","E00020127","Total",133,32,12,20,0,70,66,4,28,28,0,0,0,3
"2011","E00020100","E00020100","Total",130,38,11,27,0,75,71,4,15,14,0,1,0,2
"2011","E00167478","E00167478","Total",105,14,3,11,10,63,51,12,17,15,0,0,2,1
"2011","E00167479","E00167479","Total",90,14,1,13,0,3,3,0,72,72,0,0,0,1
"2011","E00167480","E00167480","Total",156,15,3,12,2,23,6,17,111,109,0,1,1,5
"2011","E00167491","E00167491","Total",109,37,6,31,1,25,8,17,43,39,2,2,0,3
"2011","E00167492","E00167492","Total",98,18,3,15,21,39,30,9,16,16,0,0,0,4
"2011","E00020136","E00020136","Total",159,23,11,12,3,102,98,4,31,31,0,0,0,0
"2011","E00020137","E00020137","Total",148,27,9,18,1,91,90,1,23,19,1,3,0,6
"2011","E00167763","E00167763","Total",181,35,15,20,14,15,14,1,113,111,0,2,0,4
"2011","E00168001","E00168001","Total",135,15,6,9,1,100,94,6,16,14,0,2,0,3
"2011","E00019926","E00019926","Total",136,34,16,18,0,80,57,23,21,20,0,0,1,1
"2011","E00019930","E00019930","Total",128,13,2,11,0,104,100,4,8,8,0,0,0,3
"2011","E00019932","E00019932","Total",110,18,9,9,2,58,32,26,31,29,0,1,1,1
"2011","E00019933","E00019933","Total",133,31,12,19,4,70,7,63,28,25,0,2,1,0
"2011","E00019934","E00019934","Total",157,28,7,21,3,62,37,25,64,60,0,4,0,0
"2011","E00019935","E00019935","Total",66,24,7,17,0,12,4,8,27,25,0,1,1,3
"2011","E00019928","E00019928","Total",123,14,4,10,0,93,92,1,13,13,0,0,0,3
"2011","E00019931","E00019931","Total",139,21,8,13,2,76,73,3,38,37,0,0,1,2
"2011","E00019956","E00019956","Total",148,19,5,14,0,109,107,2,20,20,0,0,0,0
"2011","E00019959","E00019959","Total",114,18,6,12,2,23,19,4,71,67,0,2,2,0
"2011","E00019963","E00019963","Total",101,12,5,7,1,34,20,14,51,49,0,2,0,3
"2011","E00019965","E00019965","Total",120,11,5,6,0,91,58,33,17,12,0,4,1,1
"2011","E00019977","E00019977","Total",235,10,8,2,0,206,205,1,18,16,1,0,1,1
"2011","E00019984","E00019984","Total",99,14,3,11,0,74,72,2,9,8,0,1,0,2
"2011","E00019988","E00019988","Total",94,17,9,8,0,66,65,1,10,8,0,2,0,1
"2011","E00019990","E00019990","Total",97,11,3,8,2,78,76,2,6,6,0,0,0,0
"2011","E00019966","E00019966","Total",110,10,0,10,0,95,94,1,5,5,0,0,0,0
"2011","E00019969","E00019969","Total",124,12,1,11,0,99,97,2,11,9,0,1,1,2
"2011","E00019970","E00019970","Total",153,14,7,7,1,125,113,12,12,11,0,1,0,1
"2011","E00020001","E00020001","Total",125,10,2,8,0,103,102,1,12,12,0,0,0,0
"2011","E00020002","E00020002","Total",96,16,9,7,0,77,76,1,3,2,0,0,1,0
"2011","E00019971","E00019971","Total",105,19,10,9,0,51,6,45,34,34,0,0,0,1
"2011","E00019973","E00019973","Total",96,14,6,8,0,78,77,1,4,4,0,0,0,0
"2011","E00019976","E00019976","Total",89,9,3,6,1,75,75,0,1,1,0,0,0,3
"2011","E00019982","E00019982","Total",112,6,4,2,1,100,100,0,5,4,0,1,0,0
"2011","E00020007","E00020007","Total",87,13,0,13,0,64,64,0,5,5,0,0,0,5
"2011","E00019927","E00019927","Total",151,23,3,20,0,99,96,3,27,27,0,0,0,2
"2011","E00019929","E00019929","Total",125,12,9,3,0,86,28,58,25,23,0,1,1,2
"2011","E00019958","E00019958","Total",141,14,3,11,1,98,94,4,24,23,0,1,0,4
"2011","E00019961","E00019961","Total",123,12,3,9,1,78,71,7,30,28,0,2,0,2
"2011","E00019962","E00019962","Total",122,17,3,14,0,84,50,34,17,17,0,0,0,4
"2011","E00019985","E00019985","Total",131,15,4,11,2,93,47,46,18,12,0,4,2,3
"2011","E00019989","E00019989","Total",74,10,0,10,0,53,53,0,9,8,0,1,0,2
"2011","E00019991","E00019991","Total",103,18,6,12,0,78,77,1,5,5,0,0,0,2
"2011","E00019993","E00019993","Total",195,5,3,2,2,175,169,6,13,9,0,3,1,0
"2011","E00019996","E00019996","Total",97,8,3,5,0,78,77,1,10,10,0,0,0,1
"2011","E00019980","E00019980","Total",108,7,4,3,0,85,75,10,16,16,0,0,0,0
"2011","E00019981","E00019981","Total",98,8,7,1,0,80,76,4,10,9,0,1,0,0
"2011","E00019986","E00019986","Total",98,6,1,5,0,86,82,4,6,5,0,0,1,0
"2011","E00019987","E00019987","Total",126,50,24,26,0,52,43,9,23,21,0,2,0,1
"2011","E00019994","E00019994","Total",149,4,0,4,0,141,141,0,4,3,0,0,1,0
"2011","E00019972","E00019972","Total",92,0,0,0,0,56,6,50,36,36,0,0,0,0
"2011","E00019975","E00019975","Total",82,2,1,1,0,44,1,43,35,35,0,0,0,1
"2011","E00019998","E00019998","Total",130,26,6,20,0,73,69,4,30,29,0,1,0,1
"2011","E00019999","E00019999","Total",88,10,5,5,0,70,69,1,7,6,0,0,1,1
"2011","E00020000","E00020000","Total",205,11,3,8,2,179,177,2,11,10,0,1,0,2
"2011","E00020006","E00020006","Total",117,48,10,38,0,31,12,19,38,32,0,5,1,0
"2011","E00019968","E00019968","Total",126,20,6,14,4,89,86,3,11,10,0,1,0,2
"2011","E00019974","E00019974","Total",124,3,0,3,0,79,3,76,41,40,0,1,0,1
"2011","E00019979","E00019979","Total",109,0,0,0,1,62,1,61,44,44,0,0,0,2
"2011","E00020003","E00020003","Total",131,8,1,7,0,109,108,1,12,12,0,0,0,2
"2011","E00020004","E00020004","Total",121,8,0,8,0,109,108,1,4,4,0,0,0,0
"2011","E00020005","E00020005","Total",128,20,5,15,0,71,60,11,36,34,0,1,1,1
"2011","E00019722","E00019722","Total",122,35,6,29,2,60,59,1,25,23,0,1,1,0
"2011","E00019752","E00019752","Total",168,59,21,38,23,41,29,12,43,43,0,0,0,2
"2011","E00019753","E00019753","Total",109,30,11,19,3,48,37,11,27,24,0,3,0,1
"2011","E00019754","E00019754","Total",217,43,9,34,0,95,75,20,76,73,0,2,1,3
"2011","E00019755","E00019755","Total",114,31,7,24,0,71,70,1,12,11,0,1,0,0
"2011","E00019967","E00019967","Total",243,67,23,44,1,88,65,23,85,84,0,1,0,2
"2011","E00019978","E00019978","Total",85,17,4,13,0,40,18,22,28,25,0,3,0,0
"2011","E00019983","E00019983","Total",98,25,5,20,3,13,4,9,57,56,0,1,0,0
"2011","E00019992","E00019992","Total",123,25,7,18,0,70,67,3,28,28,0,0,0,0
"2011","E00019995","E00019995","Total",79,36,9,27,0,12,7,5,28,26,0,1,1,3
"2011","E00019997","E00019997","Total",136,53,29,24,0,26,20,6,56,55,0,1,0,1
"2011","E00020094","E00020094","Total",114,29,12,17,1,69,68,1,14,13,0,0,1,1
"2011","E00020096","E00020096","Total",115,15,5,10,1,90,90,0,9,9,0,0,0,0
"2011","E00020099","E00020099","Total",119,37,12,25,0,68,67,1,12,11,0,0,1,2
"2011","E00020125","E00020125","Total",97,14,6,8,1,65,63,2,14,10,0,3,1,3
"2011","E00020131","E00020131","Total",114,23,10,13,0,73,72,1,18,18,0,0,0,0
"2011","E00020097","E00020097","Total",110,19,5,14,2,77,75,2,11,11,0,0,0,1
"2011","E00020098","E00020098","Total",126,20,8,12,0,90,88,2,15,15,0,0,0,1
"2011","E00020132","E00020132","Total",132,9,3,6,0,108,107,1,13,13,0,0,0,2
"2011","E00020133","E00020133","Total",124,19,6,13,1,96,95,1,7,7,0,0,0,1
"2011","E00020134","E00020134","Total",138,27,3,24,2,100,100,0,9,9,0,0,0,0
"2011","E00020119","E00020119","Total",112,56,22,34,2,6,5,1,47,43,0,4,0,1
"2011","E00020120","E00020120","Total",87,31,10,21,0,37,37,0,18,17,0,1,0,1
"2011","E00020123","E00020123","Total",148,24,7,17,1,105,102,3,16,15,0,0,1,2
"2011","E00020126","E00020126","Total",125,47,11,36,3,52,52,0,19,18,0,1,0,4
"2011","E00020065","E00020065","Total",179,14,8,6,2,142,137,5,20,18,0,2,0,1
"2011","E00020070","E00020070","Total",130,6,1,5,1,114,105,9,9,7,0,0,2,0
"2011","E00020075","E00020075","Total",147,23,10,13,0,98,82,16,20,18,0,1,1,6
"2011","E00020077","E00020077","Total",123,10,2,8,1,101,101,0,9,8,0,1,0,2
"2011","E00020081","E00020081","Total",151,13,3,10,0,122,119,3,15,15,0,0,0,1
"2011","E00020053","E00020053","Total",107,26,12,14,1,56,47,9,24,24,0,0,0,0
"2011","E00020054","E00020054","Total",171,18,8,10,1,135,132,3,17,16,0,1,0,0
"2011","E00020064","E00020064","Total",150,53,15,38,0,41,39,2,56,53,0,2,1,0
"2011","E00020072","E00020072","Total",140,48,19,29,2,53,42,11,29,27,1,1,0,8
"2011","E00020074","E00020074","Total",178,14,7,7,0,144,139,5,17,17,0,0,0,3
"2011","E00020079","E00020079","Total",152,14,3,11,1,128,118,10,9,9,0,0,0,0
"2011","E00020060","E00020060","Total",89,5,0,5,1,79,51,28,4,3,0,0,1,0
"2011","E00020061","E00020061","Total",181,27,8,19,5,99,90,9,47,43,0,3,1,3
"2011","E00020063","E00020063","Total",155,21,5,16,0,118,114,4,13,11,0,2,0,3
"2011","E00020068","E00020068","Total",135,17,1,16,0,102,99,3,15,15,0,0,0,1
"2011","E00020073","E00020073","Total",160,21,2,19,0,116,109,7,21,21,0,0,0,2
"2011","E00020062","E00020062","Total",160,27,12,15,7,101,29,72,23,22,0,1,0,2
"2011","E00020066","E00020066","Total",132,14,1,13,0,111,107,4,5,5,0,0,0,2
"2011","E00020067","E00020067","Total",124,16,5,11,0,94,89,5,13,13,0,0,0,1
"2011","E00020069","E00020069","Total",109,3,1,2,0,92,53,39,13,12,0,1,0,1
"2011","E00020071","E00020071","Total",123,29,8,21,5,69,38,31,18,15,0,0,3,2
"2011","E00020080","E00020080","Total",121,34,18,16,4,60,38,22,22,21,0,0,1,1
"2011","E00020180","E00020180","Total",142,14,0,14,0,114,83,31,14,11,0,2,1,0
"2011","E00020182","E00020182","Total",75,13,0,13,0,52,44,8,10,7,0,2,1,0
"2011","E00020184","E00020184","Total",121,15,1,14,11,83,21,62,12,10,0,1,1,0
"2011","E00020188","E00020188","Total",98,11,4,7,0,80,76,4,5,5,0,0,0,2
"2011","E00019710","E00019710","Total",157,8,3,5,0,135,132,3,14,12,0,2,0,0
"2011","E00019713","E00019713","Total",154,10,4,6,4,130,129,1,8,7,0,1,0,2
"2011","E00019714","E00019714","Total",113,4,2,2,0,104,97,7,5,5,0,0,0,0
"2011","E00168015","E00168015","Total",147,13,1,12,1,117,52,65,16,15,0,0,1,0
"2011","E00020181","E00020181","Total",101,15,1,14,2,75,68,7,9,9,0,0,0,0
"2011","E00020191","E00020191","Total",229,12,2,10,3,199,42,157,15,12,0,0,3,0
"2011","E00020196","E00020196","Total",119,19,0,19,0,85,61,24,13,11,0,1,1,2
"2011","E00167510","E00167510","Total",87,28,0,28,1,22,8,14,33,32,0,1,0,3
"2011","E00167511","E00167511","Total",99,13,1,12,1,77,45,32,7,7,0,0,0,1
"2011","E00167752","E00167752","Total",89,16,4,12,0,68,41,27,4,4,0,0,0,1
"2011","E00020204","E00020204","Total",158,14,2,12,2,133,131,2,9,5,0,4,0,0
"2011","E00020206","E00020206","Total",66,16,0,16,2,41,27,14,7,5,0,2,0,0
"2011","E00167505","E00167505","Total",88,47,4,43,7,12,7,5,22,22,0,0,0,0
"2011","E00167506","E00167506","Total",90,32,4,28,0,13,6,7,44,41,0,3,0,1
"2011","E00167508","E00167508","Total",110,31,7,24,0,32,23,9,47,45,0,2,0,0
"2011","E00167513","E00167513","Total",112,31,6,25,10,36,4,32,35,34,0,1,0,0
"2011","E00167754","E00167754","Total",109,13,2,11,10,50,3,47,34,34,0,0,0,2
"2011","E00168017","E00168017","Total",94,17,1,16,2,66,35,31,7,6,0,1,0,2
"2011","E00168018","E00168018","Total",107,7,1,6,13,79,47,32,5,5,0,0,0,3
"2011","E00020193","E00020193","Total",121,14,2,12,0,85,67,18,20,19,0,0,1,2
"2011","E00020195","E00020195","Total",107,10,3,7,0,93,38,55,4,4,0,0,0,0
"2011","E00020199","E00020199","Total",155,26,2,24,9,96,57,39,21,20,0,0,1,3
"2011","E00020202","E00020202","Total",223,60,8,52,0,104,62,42,58,57,0,0,1,1
"2011","E00020178","E00020178","Total",233,51,9,42,7,128,99,29,42,39,0,1,2,5
"2011","E00020203","E00020203","Total",188,16,2,14,1,155,151,4,15,15,0,0,0,1
"2011","E00020207","E00020207","Total",192,22,5,17,8,126,101,25,35,32,0,2,1,1
"2011","E00020208","E00020208","Total",97,14,1,13,0,68,65,3,12,9,0,2,1,3
"2011","E00019716","E00019716","Total",180,45,13,32,0,88,79,9,45,44,0,1,0,2
"2011","E00019717","E00019717","Total",177,15,1,14,0,139,78,61,22,21,0,0,1,1
"2011","E00019719","E00019719","Total",148,25,5,20,0,93,89,4,29,28,0,1,0,1
"2011","E00019720","E00019720","Total",121,26,3,23,1,73,64,9,18,17,0,0,1,3
"2011","E00019721","E00019721","Total",116,29,7,22,3,62,61,1,21,18,0,3,0,1
"2011","E00019690","E00019690","Total",142,80,31,49,0,26,16,10,36,36,0,0,0,0
"2011","E00019705","E00019705","Total",180,73,21,52,23,36,20,16,45,43,1,1,0,3
"2011","E00019706","E00019706","Total",125,28,7,21,3,53,45,8,38,38,0,0,0,3
"2011","E00019709","E00019709","Total",113,24,8,16,0,77,76,1,11,10,0,1,0,1
"2011","E00167975","E00167975","Total",218,53,7,46,12,74,51,23,77,72,0,5,0,2
"2011","E00168013","E00168013","Total",52,18,6,12,0,8,5,3,26,25,0,0,1,0
"2011","E00019691","E00019691","Total",156,57,14,43,9,53,12,41,35,34,0,1,0,2
"2011","E00019692","E00019692","Total",159,92,38,54,1,29,6,23,36,35,0,1,0,1
"2011","E00019707","E00019707","Total",126,27,9,18,2,83,79,4,14,13,0,1,0,0
"2011","E00019711","E00019711","Total",97,25,2,23,1,58,54,4,12,12,0,0,0,1
"2011","E00019712","E00019712","Total",112,48,13,35,5,28,25,3,30,30,0,0,0,1
"2011","E00019718","E00019718","Total",137,23,4,19,0,105,99,6,9,9,0,0,0,0
"2011","E00019730","E00019730","Total",113,7,1,6,4,90,88,2,10,9,0,1,0,2
"2011","E00019732","E00019732","Total",169,17,7,10,0,139,98,41,12,12,0,0,0,1
"2011","E00019733","E00019733","Total",135,6,1,5,0,118,34,84,10,9,0,1,0,1
"2011","E00019736","E00019736","Total",114,24,6,18,1,52,52,0,35,32,0,3,0,2
"2011","E00019737","E00019737","Total",122,22,6,16,0,89,52,37,10,10,0,0,0,1
"2011","E00019728","E00019728","Total",126,7,1,6,0,101,98,3,15,14,0,0,1,3
"2011","E00019758","E00019758","Total",94,0,0,0,1,84,8,76,5,5,0,0,0,4
"2011","E00019763","E00019763","Total",82,3,0,3,1,68,68,0,10,10,0,0,0,0
"2011","E00019764","E00019764","Total",94,14,7,7,0,58,51,7,22,21,0,1,0,0
"2011","E00019765","E00019765","Total",131,42,11,31,0,66,66,0,23,22,0,1,0,0
"2011","E00019724","E00019724","Total",202,24,5,19,9,136,86,50,33,33,0,0,0,0
"2011","E00019739","E00019739","Total",150,28,9,19,0,95,7,88,27,26,0,1,0,0
"2011","E00019740","E00019740","Total",187,56,19,37,1,60,6,54,70,63,1,6,0,0
"2011","E00019743","E00019743","Total",163,43,19,24,0,79,5,74,39,35,0,2,2,2
"2011","E00019725","E00019725","Total",214,24,4,20,36,133,88,45,20,19,0,1,0,1
"2011","E00019727","E00019727","Total",153,20,4,16,0,114,110,4,15,12,0,3,0,4
"2011","E00019729","E00019729","Total",121,12,6,6,0,102,100,2,7,6,0,1,0,0
"2011","E00019731","E00019731","Total",145,17,2,15,2,109,107,2,15,13,0,2,0,2
"2011","E00019734","E00019734","Total",133,28,13,15,0,84,69,15,17,16,0,1,0,4
"2011","E00019738","E00019738","Total",134,10,5,5,3,75,37,38,45,44,0,1,0,1
"2011","E00019741","E00019741","Total",176,12,2,10,0,93,8,85,69,66,1,2,0,2
"2011","E00019742","E00019742","Total",117,13,3,10,0,80,3,77,23,21,0,1,1,1
"2011","E00019745","E00019745","Total",153,5,2,3,2,124,2,122,21,17,0,3,1,1
"2011","E00019746","E00019746","Total",93,3,1,2,1,85,8,77,2,2,0,0,0,2
"2011","E00019744","E00019744","Total",149,50,20,30,0,23,8,15,73,67,1,5,0,3
"2011","E00019747","E00019747","Total",131,13,4,9,0,103,11,92,15,15,0,0,0,0
"2011","E00019748","E00019748","Total",122,39,14,25,0,51,51,0,29,27,0,2,0,3
"2011","E00019749","E00019749","Total",128,18,4,14,1,96,94,2,12,10,1,1,0,1
"2011","E00019750","E00019750","Total",144,24,5,19,3,86,83,3,29,27,1,1,0,2
"2011","E00019751","E00019751","Total",147,24,8,16,2,109,74,35,10,9,0,0,1,2
"2011","E00019726","E00019726","Total",205,12,1,11,1,174,172,2,16,16,0,0,0,2
"2011","E00019735","E00019735","Total",109,3,0,3,0,95,93,2,9,7,0,1,1,2
"2011","E00019756","E00019756","Total",217,18,6,12,0,104,98,6,91,88,1,1,1,4
"2011","E00019757","E00019757","Total",147,27,10,17,0,95,92,3,25,25,0,0,0,0
"2011","E00019760","E00019760","Total",124,4,2,2,0,108,104,4,12,10,0,2,0,0
"2011","E00019723","E00019723","Total",118,14,2,12,1,91,83,8,7,7,0,0,0,5
"2011","E00019759","E00019759","Total",151,19,6,13,2,105,103,2,24,24,0,0,0,1
"2011","E00019761","E00019761","Total",146,19,8,11,0,109,76,33,15,15,0,0,0,3
"2011","E00019762","E00019762","Total",125,34,6,28,0,46,41,5,44,43,0,1,0,1
"2011","E00020176","E00020176","Total",131,39,14,25,1,51,25,26,40,36,0,3,1,0
"2011","E00020186","E00020186","Total",124,24,5,19,0,85,78,7,14,14,0,0,0,1
"2011","E00020194","E00020194","Total",235,19,2,17,0,201,187,14,11,10,0,1,0,4
"2011","E00020197","E00020197","Total",104,16,4,12,0,77,77,0,11,10,0,1,0,0
"2011","E00020201","E00020201","Total",214,29,8,21,38,119,109,10,26,26,0,0,0,2
"2011","E00020177","E00020177","Total",115,13,2,11,1,94,44,50,7,7,0,0,0,0
"2011","E00020190","E00020190","Total",139,22,5,17,1,90,81,9,20,19,0,0,1,6
"2011","E00020192","E00020192","Total",133,60,14,46,11,12,6,6,46,44,0,1,1,4
"2011","E00020198","E00020198","Total",214,40,8,32,6,94,88,6,71,68,0,2,1,3
"2011","E00020474","E00020474","Total",98,13,4,9,1,73,73,0,10,10,0,0,0,1
"2011","E00020476","E00020476","Total",189,42,16,26,1,127,120,7,16,14,0,2,0,3
"2011","E00020477","E00020477","Total",161,35,15,20,1,26,18,8,95,89,1,3,2,4
"2011","E00020480","E00020480","Total",120,42,12,30,1,58,51,7,19,17,0,1,1,0
"2011","E00167684","E00167684","Total",120,27,8,19,0,82,77,5,11,8,0,2,1,0
"2011","E00167685","E00167685","Total",143,2,0,2,1,120,4,116,20,17,2,1,0,0
"2011","E00020056","E00020056","Total",102,10,4,6,1,79,76,3,11,10,0,1,0,1
"2011","E00020083","E00020083","Total",91,10,1,9,0,74,71,3,5,5,0,0,0,2
"2011","E00020179","E00020179","Total",103,35,17,18,0,33,27,6,35,33,1,0,1,0
"2011","E00020183","E00020183","Total",145,30,6,24,7,63,43,20,42,41,0,0,1,3
"2011","E00020185","E00020185","Total",139,54,23,31,1,41,28,13,40,40,0,0,0,3
"2011","E00020200","E00020200","Total",119,37,7,30,18,41,34,7,20,20,0,0,0,3
"2011","E00020209","E00020209","Total",154,32,13,19,6,84,72,12,30,29,0,1,0,2
"2011","E00168012","E00168012","Total",87,10,3,7,0,69,65,4,4,4,0,0,0,4
"2011","E00020055","E00020055","Total",140,60,17,43,0,46,40,6,31,28,0,2,1,3
"2011","E00020076","E00020076","Total",108,12,2,10,2,77,74,3,15,14,1,0,0,2
"2011","E00020078","E00020078","Total",223,52,12,40,5,117,86,31,48,43,0,3,2,1
"2011","E00020082","E00020082","Total",206,71,22,49,4,61,35,26,65,60,0,4,1,5
"2011","E00020084","E00020084","Total",179,54,20,34,1,64,39,25,58,57,0,1,0,2
"2011","E00020141","E00020141","Total",148,28,9,19,1,97,97,0,19,18,0,0,1,3
"2011","E00020153","E00020153","Total",140,27,4,23,1,97,94,3,13,12,0,1,0,2
"2011","E00020154","E00020154","Total",169,38,12,26,2,100,86,14,27,25,0,1,1,2
"2011","E00020155","E00020155","Total",153,17,7,10,0,120,115,5,16,13,0,3,0,0
"2011","E00020156","E00020156","Total",145,51,17,34,1,70,50,20,21,20,0,1,0,2
"2011","E00020142","E00020142","Total",146,60,23,37,1,35,23,12,46,44,0,1,1,4
"2011","E00020143","E00020143","Total",229,75,19,56,3,99,40,59,50,48,0,0,2,2
"2011","E00020157","E00020157","Total",165,41,13,28,1,80,66,14,42,39,0,3,0,1
"2011","E00020160","E00020160","Total",213,45,12,33,14,112,32,80,41,38,0,2,1,1
"2011","E00167757","E00167757","Total",88,27,5,22,26,6,2,4,28,26,0,2,0,1
"2011","E00167765","E00167765","Total",113,22,3,19,4,70,10,60,12,10,0,2,0,5
"2011","E00168010","E00168010","Total",115,52,21,31,0,31,19,12,32,28,0,2,2,0
"2011","E00020158","E00020158","Total",201,24,2,22,4,126,112,14,46,40,0,1,5,1
"2011","E00020161","E00020161","Total",131,15,5,10,1,97,91,6,17,16,0,1,0,1
"2011","E00020163","E00020163","Total",162,40,7,33,0,90,69,21,32,30,0,2,0,0
"2011","E00020167","E00020167","Total",152,22,6,16,0,120,25,95,10,8,0,1,1,0
"2011","E00168009","E00168009","Total",127,21,6,15,5,69,61,8,32,27,0,2,3,0
"2011","E00168024","E00168024","Total",109,12,2,10,11,65,15,50,21,21,0,0,0,0
"2011","E00020144","E00020144","Total",149,47,17,30,3,59,56,3,36,34,0,1,1,4
"2011","E00020145","E00020145","Total",169,61,27,34,2,59,39,20,45,44,0,1,0,2
"2011","E00020165","E00020165","Total",154,71,22,49,0,48,29,19,34,33,0,1,0,1
"2011","E00020166","E00020166","Total",123,25,8,17,0,66,63,3,30,27,1,2,0,2
"2011","E00020168","E00020168","Total",177,90,22,68,0,39,28,11,47,47,0,0,0,1
"2011","E00019687","E00019687","Total",129,57,34,23,4,31,16,15,36,35,0,1,0,1
"2011","E00019694","E00019694","Total",232,69,23,46,12,77,55,22,69,63,0,5,1,5
"2011","E00019695","E00019695","Total",122,76,38,38,0,4,1,3,40,36,0,4,0,2
"2011","E00019698","E00019698","Total",161,82,36,46,0,27,24,3,45,42,0,3,0,7
"2011","E00019703","E00019703","Total",156,26,15,11,0,79,8,71,49,44,0,2,3,2
"2011","E00019685","E00019685","Total",154,60,17,43,0,42,19,23,46,42,1,3,0,6
"2011","E00019686","E00019686","Total",155,59,23,36,1,65,22,43,28,23,0,4,1,2
"2011","E00019689","E00019689","Total",150,59,16,43,1,49,25,24,38,36,0,2,0,3
"2011","E00019700","E00019700","Total",147,78,25,53,1,31,19,12,37,36,0,1,0,0
"2011","E00019701","E00019701","Total",116,56,16,40,0,36,20,16,21,21,0,0,0,3
"2011","E00019688","E00019688","Total",113,15,4,11,2,84,83,1,12,12,0,0,0,0
"2011","E00019696","E00019696","Total",154,58,19,39,0,71,48,23,24,21,0,3,0,1
"2011","E00019697","E00019697","Total",118,56,13,43,0,33,18,15,29,26,0,2,1,0
"2011","E00019699","E00019699","Total",114,44,15,29,1,48,30,18,21,21,0,0,0,0
"2011","E00019702","E00019702","Total",164,48,13,35,0,94,85,9,22,18,0,3,1,0
"2011","E00019704","E00019704","Total",148,20,4,16,3,108,107,1,16,15,0,1,0,1
"2011","E00020379","E00020379","Total",120,52,17,35,0,22,4,18,42,38,0,4,0,4
"2011","E00020380","E00020380","Total",132,62,7,55,6,12,1,11,52,49,0,2,1,0
"2011","E00020381","E00020381","Total",144,63,23,40,2,27,13,14,52,51,0,1,0,0
"2011","E00020382","E00020382","Total",126,82,30,52,0,22,13,9,22,20,0,2,0,0
"2011","E00020385","E00020385","Total",130,75,28,47,0,5,5,0,48,45,1,2,0,2
"2011","E00020377","E00020377","Total",130,73,23,50,0,21,15,6,35,32,0,3,0,1
"2011","E00020384","E00020384","Total",145,74,31,43,0,37,20,17,32,28,0,4,0,2
"2011","E00020388","E00020388","Total",132,46,15,31,2,67,60,7,17,15,0,2,0,0
"2011","E00020390","E00020390","Total",149,76,19,57,2,31,19,12,39,39,0,0,0,1
"2011","E00020408","E00020408","Total",242,81,26,55,14,44,43,1,100,97,0,2,1,3
"2011","E00020458","E00020458","Total",177,73,24,49,2,43,22,21,57,56,0,1,0,2
"2011","E00020483","E00020483","Total",136,78,26,52,0,13,6,7,43,41,0,1,1,2
"2011","E00020485","E00020485","Total",177,85,32,53,2,53,10,43,34,33,0,0,1,3
"2011","E00020490","E00020490","Total",144,67,26,41,3,32,13,19,41,38,0,3,0,1
"2011","E00020491","E00020491","Total",138,55,18,37,0,49,22,27,30,29,0,1,0,4
"2011","E00020460","E00020460","Total",147,37,7,30,1,87,84,3,21,19,0,2,0,1
"2011","E00020469","E00020469","Total",141,51,13,38,2,35,14,21,51,49,0,2,0,2
"2011","E00020486","E00020486","Total",163,34,8,26,0,43,16,27,84,79,0,3,2,2
"2011","E00020497","E00020497","Total",116,34,12,22,2,67,11,56,12,12,0,0,0,1
"2011","E00167682","E00167682","Total",122,52,14,38,10,11,4,7,43,40,1,1,1,6
"2011","E00167990","E00167990","Total",141,3,1,2,57,56,5,51,22,20,0,2,0,3
"2011","E00020457","E00020457","Total",157,84,30,54,8,31,18,13,33,28,0,4,1,1
"2011","E00020484","E00020484","Total",144,75,28,47,0,31,17,14,38,35,0,2,1,0
"2011","E00020493","E00020493","Total",172,69,28,41,0,61,20,41,42,42,0,0,0,0
"2011","E00020494","E00020494","Total",145,44,15,29,0,59,47,12,39,35,0,4,0,3
"2011","E00020495","E00020495","Total",112,30,11,19,0,60,34,26,20,19,0,1,0,2
"2011","E00020496","E00020496","Total",117,71,31,40,1,24,17,7,21,16,0,2,3,0
"2011","E00020461","E00020461","Total",139,77,26,51,0,37,21,16,23,22,0,0,1,2
"2011","E00020462","E00020462","Total",112,49,17,32,0,26,13,13,35,33,0,2,0,2
"2011","E00020464","E00020464","Total",116,74,14,60,0,16,6,10,24,24,0,0,0,2
"2011","E00020470","E00020470","Total",119,54,22,32,0,20,9,11,44,42,0,0,2,1
"2011","E00020471","E00020471","Total",139,64,19,45,1,30,14,16,39,39,0,0,0,5
"2011","E00020473","E00020473","Total",224,23,8,15,37,143,77,66,17,17,0,0,0,4
"2011","E00020475","E00020475","Total",128,73,26,47,0,19,16,3,35,33,0,2,0,1
"2011","E00020478","E00020478","Total",180,36,14,22,1,110,73,37,32,28,0,2,2,1
"2011","E00020479","E00020479","Total",138,41,13,28,2,76,67,9,18,17,0,1,0,1
"2011","E00020481","E00020481","Total",174,85,26,59,0,38,18,20,50,44,0,3,3,1
"2011","E00020164","E00020164","Total",155,42,12,30,0,69,24,45,42,42,0,0,0,2
"2011","E00020169","E00020169","Total",119,22,12,10,0,71,24,47,22,20,0,2,0,4
"2011","E00020170","E00020170","Total",120,62,16,46,0,25,18,7,32,31,0,1,0,1
"2011","E00020171","E00020171","Total",156,67,29,38,0,37,23,14,51,49,0,1,1,1
"2011","E00020173","E00020173","Total",160,42,6,36,4,98,95,3,16,15,0,0,1,0
"2011","E00020174","E00020174","Total",129,72,27,45,0,28,22,6,26,26,0,0,0,3
"2011","E00020140","E00020140","Total",140,47,15,32,2,70,53,17,20,17,0,2,1,1
"2011","E00020146","E00020146","Total",123,16,3,13,3,94,53,41,9,7,0,2,0,1
"2011","E00020148","E00020148","Total",192,32,10,22,6,137,66,71,14,13,0,1,0,3
"2011","E00020172","E00020172","Total",136,33,9,24,0,82,46,36,19,18,0,1,0,2
"2011","E00020175","E00020175","Total",127,14,4,10,0,102,81,21,8,8,0,0,0,3
"2011","E00020210","E00020210","Total",171,59,16,43,10,66,18,48,34,33,0,0,1,2
"2011","E00020234","E00020234","Total",137,55,17,38,1,31,17,14,49,49,0,0,0,1
"2011","E00020236","E00020236","Total",135,49,19,30,0,71,24,47,13,13,0,0,0,2
"2011","E00020238","E00020238","Total",185,42,7,35,0,120,101,19,21,21,0,0,0,2
"2011","E00167976","E00167976","Total",145,89,22,67,2,27,4,23,27,26,0,1,0,0
"2011","E00167978","E00167978","Total",139,23,2,21,36,47,7,40,33,30,0,1,2,0
"2011","E00020463","E00020463","Total",165,26,11,15,0,87,61,26,49,47,0,2,0,3
"2011","E00020465","E00020465","Total",140,35,9,26,0,94,85,9,11,11,0,0,0,0
"2011","E00020466","E00020466","Total",134,34,6,28,1,61,58,3,38,37,0,1,0,0
"2011","E00020468","E00020468","Total",122,35,8,27,0,57,53,4,29,29,0,0,0,1
"2011","E00020472","E00020472","Total",141,39,11,28,2,75,56,19,23,23,0,0,0,2
"2011","E00020488","E00020488","Total",106,31,11,20,0,54,32,22,18,17,0,0,1,3
"2011","E00020459","E00020459","Total",199,27,4,23,0,155,153,2,13,13,0,0,0,4
"2011","E00020482","E00020482","Total",193,25,4,21,44,93,66,27,28,27,0,1,0,3
"2011","E00020487","E00020487","Total",147,64,15,49,1,58,35,23,23,20,0,3,0,1
"2011","E00020489","E00020489","Total",153,54,23,31,14,58,36,22,25,23,0,2,0,2
"2011","E00020492","E00020492","Total",137,25,4,21,0,99,88,11,11,9,0,2,0,2
"2011","E00020391","E00020391","Total",137,41,11,30,1,80,68,12,15,14,0,1,0,0
"2011","E00020395","E00020395","Total",131,10,3,7,0,105,102,3,14,13,0,1,0,2
"2011","E00020398","E00020398","Total",124,14,3,11,0,99,92,7,8,5,0,3,0,3
"2011","E00020400","E00020400","Total",113,7,1,6,0,97,94,3,7,7,0,0,0,2
"2011","E00020404","E00020404","Total",96,10,1,9,2,76,74,2,7,6,0,1,0,1
"2011","E00020401","E00020401","Total",142,35,10,25,0,86,84,2,18,14,0,3,1,3
"2011","E00020405","E00020405","Total",112,22,5,17,0,74,72,2,14,14,0,0,0,2
"2011","E00020410","E00020410","Total",118,23,7,16,0,77,77,0,18,18,0,0,0,0
"2011","E00020411","E00020411","Total",122,23,4,19,0,80,80,0,18,15,0,0,3,1
"2011","E00020412","E00020412","Total",113,27,8,19,0,69,66,3,17,17,0,0,0,0
"2011","E00020375","E00020375","Total",120,38,12,26,1,62,60,2,18,17,0,1,0,1
"2011","E00020376","E00020376","Total",172,74,17,57,3,59,4,55,35,33,2,0,0,1
"2011","E00020406","E00020406","Total",117,72,20,52,0,6,5,1,37,36,0,1,0,2
"2011","E00020409","E00020409","Total",121,39,12,27,2,66,62,4,13,11,0,2,0,1
"2011","E00020413","E00020413","Total",115,62,24,38,0,38,37,1,15,13,0,0,2,0
"2011","E00020394","E00020394","Total",143,23,9,14,13,88,85,3,18,16,0,2,0,1
"2011","E00020399","E00020399","Total",103,6,1,5,0,89,81,8,8,8,0,0,0,0
"2011","E00020403","E00020403","Total",143,40,10,30,2,77,75,2,24,21,0,3,0,0
"2011","E00167514","E00167514","Total",73,37,22,15,0,14,14,0,22,19,1,2,0,0
"2011","E00168020","E00168020","Total",45,12,4,8,0,22,21,1,11,11,0,0,0,0
"2011","E00020383","E00020383","Total",102,36,5,31,0,34,31,3,30,28,0,1,1,2
"2011","E00020386","E00020386","Total",140,67,29,38,0,38,34,4,32,29,1,2,0,3
"2011","E00020387","E00020387","Total",114,102,35,67,0,7,7,0,4,3,0,1,0,1
"2011","E00020389","E00020389","Total",133,81,41,40,0,12,5,7,33,27,1,4,1,7
"2011","E00020396","E00020396","Total",124,108,43,65,1,5,5,0,9,8,0,1,0,1
"2011","E00019898","E00019898","Total",168,43,10,33,0,64,16,48,59,55,0,3,1,2
"2011","E00019900","E00019900","Total",151,45,19,26,0,50,21,29,53,51,0,1,1,3
"2011","E00019901","E00019901","Total",141,57,15,42,3,21,7,14,57,56,0,1,0,3
"2011","E00019904","E00019904","Total",137,79,19,60,0,17,6,11,38,38,0,0,0,3
"2011","E00019906","E00019906","Total",121,71,29,42,0,25,4,21,25,24,0,1,0,0
"2011","E00167687","E00167687","Total",127,75,21,54,0,9,5,4,40,37,0,3,0,3
"2011","E00168021","E00168021","Total",135,11,1,10,2,100,3,97,21,18,2,0,1,1
"2011","E00019908","E00019908","Total",142,61,18,43,0,36,19,17,40,36,0,2,2,5
"2011","E00019911","E00019911","Total",120,49,19,30,1,33,22,11,34,34,0,0,0,3
"2011","E00019912","E00019912","Total",179,113,38,75,7,31,15,16,27,24,0,3,0,1
"2011","E00019914","E00019914","Total",147,69,25,44,3,27,4,23,48,48,0,0,0,0
"2011","E00019915","E00019915","Total",88,24,9,15,1,53,28,25,10,10,0,0,0,0
"2011","E00019917","E00019917","Total",146,87,18,69,1,12,4,8,46,46,0,0,0,0
"2011","E00020212","E00020212","Total",120,61,18,43,0,41,24,17,17,17,0,0,0,1
"2011","E00020217","E00020217","Total",157,62,12,50,0,13,8,5,79,76,0,3,0,3
"2011","E00020220","E00020220","Total",149,99,46,53,0,26,10,16,23,22,0,1,0,1
"2011","E00020221","E00020221","Total",135,64,23,41,2,34,11,23,32,30,0,2,0,3
"2011","E00020226","E00020226","Total",129,65,24,41,0,40,5,35,24,24,0,0,0,0
"2011","E00020216","E00020216","Total",143,72,17,55,0,22,16,6,49,48,0,1,0,0
"2011","E00020239","E00020239","Total",161,54,20,34,4,23,13,10,80,75,0,5,0,0
"2011","E00020240","E00020240","Total",133,51,12,39,3,12,6,6,67,65,0,1,1,0
"2011","E00020241","E00020241","Total",239,116,32,84,6,43,6,37,72,71,0,1,0,2
"2011","E00020243","E00020243","Total",194,82,21,61,3,51,5,46,57,55,0,2,0,1
"2011","E00020247","E00020247","Total",162,2,0,2,0,5,0,5,155,153,0,0,2,0
"2011","E00020392","E00020392","Total",125,68,29,39,0,35,10,25,22,21,0,1,0,0
"2011","E00020393","E00020393","Total",121,59,24,35,0,35,22,13,25,24,0,1,0,2
"2011","E00020397","E00020397","Total",154,76,22,54,2,39,14,25,36,34,0,2,0,1
"2011","E00020402","E00020402","Total",117,64,34,30,0,29,16,13,21,21,0,0,0,3
"2011","E00020407","E00020407","Total",157,65,23,42,0,48,12,36,44,42,1,1,0,0
"2011","E00020147","E00020147","Total",119,80,29,51,1,19,10,9,15,14,0,1,0,4
"2011","E00020149","E00020149","Total",174,92,31,61,0,43,13,30,38,37,0,1,0,1
"2011","E00020150","E00020150","Total",123,80,26,54,1,13,8,5,27,24,0,3,0,2
"2011","E00020151","E00020151","Total",88,53,25,28,0,26,21,5,9,9,0,0,0,0
"2011","E00020152","E00020152","Total",135,82,22,60,0,23,17,6,28,27,0,1,0,2
"2011","E00020211","E00020211","Total",129,75,30,45,0,27,25,2,27,27,0,0,0,0
"2011","E00020213","E00020213","Total",134,70,24,46,3,22,14,8,35,34,0,1,0,4
"2011","E00020214","E00020214","Total",115,67,18,49,0,35,9,26,12,11,0,1,0,1
"2011","E00020215","E00020215","Total",112,72,22,50,0,20,15,5,19,19,0,0,0,1
"2011","E00020218","E00020218","Total",115,82,28,54,0,20,15,5,11,11,0,0,0,2
"2011","E00020219","E00020219","Total",142,59,20,39,0,58,53,5,23,21,0,2,0,2
"2011","E00020246","E00020246","Total",187,108,30,78,3,27,19,8,47,46,1,0,0,2
"2011","E00020222","E00020222","Total",103,86,46,40,1,6,6,0,9,7,0,2,0,1
"2011","E00020224","E00020224","Total",122,80,37,43,1,16,13,3,25,24,0,1,0,0
"2011","E00020227","E00020227","Total",102,39,19,20,1,36,14,22,26,24,0,2,0,0
"2011","E00020229","E00020229","Total",175,104,31,73,0,16,11,5,55,53,0,2,0,0
"2011","E00020233","E00020233","Total",125,74,31,43,0,18,12,6,33,30,0,3,0,0
"2011","E00020235","E00020235","Total",133,50,15,35,4,53,42,11,25,25,0,0,0,1
"2011","E00020242","E00020242","Total",168,53,10,43,0,75,46,29,38,35,0,3,0,2
"2011","E00020244","E00020244","Total",156,22,9,13,2,115,112,3,15,14,0,1,0,2
"2011","E00020245","E00020245","Total",156,18,5,13,0,122,118,4,14,14,0,0,0,2
"2011","E00020248","E00020248","Total",117,51,17,34,1,47,45,2,15,12,0,3,0,3
"2011","E00019888","E00019888","Total",117,32,8,24,0,5,5,0,78,77,0,1,0,2
"2011","E00019902","E00019902","Total",153,76,21,55,0,35,9,26,41,40,0,1,0,1
"2011","E00019903","E00019903","Total",138,93,33,60,0,22,10,12,22,22,0,0,0,1
"2011","E00019905","E00019905","Total",118,82,31,51,0,21,10,11,14,14,0,0,0,1
"2011","E00019913","E00019913","Total",166,89,29,60,0,17,8,9,56,55,0,1,0,4
"2011","E00019907","E00019907","Total",129,85,40,45,0,13,9,4,31,30,0,0,1,0
"2011","E00019909","E00019909","Total",142,91,28,63,0,16,10,6,34,34,0,0,0,1
"2011","E00019910","E00019910","Total",131,75,29,46,1,21,6,15,33,29,0,3,1,1
"2011","E00019916","E00019916","Total",137,83,25,58,0,35,13,22,19,19,0,0,0,0
"2011","E00019920","E00019920","Total",131,68,16,52,0,26,15,11,37,37,0,0,0,0
"2011","E00019886","E00019886","Total",146,91,26,65,2,25,16,9,27,26,0,1,0,1
"2011","E00019889","E00019889","Total",150,91,26,65,0,22,15,7,34,32,0,2,0,3
"2011","E00019890","E00019890","Total",149,106,35,71,1,14,10,4,27,27,0,0,0,1
"2011","E00019891","E00019891","Total",138,62,15,47,0,28,12,16,46,46,0,0,0,2
"2011","E00019918","E00019918","Total",137,74,22,52,0,14,4,10,46,46,0,0,0,3
"2011","E00020504","E00020504","Total",133,67,21,46,2,34,29,5,30,30,0,0,0,0
"2011","E00020506","E00020506","Total",160,81,22,59,0,36,13,23,38,36,0,2,0,5
"2011","E00020508","E00020508","Total",117,47,11,36,1,51,36,15,15,13,1,1,0,3
"2011","E00020509","E00020509","Total",121,52,16,36,0,45,16,29,23,22,0,1,0,1
"2011","E00020511","E00020511","Total",132,47,16,31,2,68,67,1,13,12,0,1,0,2
"2011","E00020512","E00020512","Total",117,62,20,42,4,13,2,11,38,34,1,2,1,0
"2011","E00020521","E00020521","Total",111,74,27,47,1,14,3,11,20,20,0,0,0,2
"2011","E00020522","E00020522","Total",127,112,64,48,0,4,2,2,10,4,5,1,0,1
"2011","E00020526","E00020526","Total",126,73,27,46,1,23,17,6,29,25,1,2,1,0
"2011","E00020527","E00020527","Total",136,111,52,59,0,10,4,6,15,15,0,0,0,0
"2011","E00020498","E00020498","Total",115,105,68,37,0,3,3,0,6,5,1,0,0,1
"2011","E00020499","E00020499","Total",110,86,43,43,0,10,1,9,13,12,0,0,1,1
"2011","E00020501","E00020501","Total",145,94,30,64,0,15,6,9,36,33,3,0,0,0
"2011","E00020503","E00020503","Total",127,109,66,43,0,4,2,2,12,5,7,0,0,2
"2011","E00020505","E00020505","Total",183,78,34,44,0,84,65,19,21,21,0,0,0,0
"2011","E00020507","E00020507","Total",165,87,28,59,0,48,48,0,29,28,0,1,0,1
"2011","E00020516","E00020516","Total",142,88,45,43,0,1,1,0,52,50,0,1,1,1
"2011","E00020517","E00020517","Total",169,104,29,75,0,33,29,4,29,27,0,2,0,3
"2011","E00020519","E00020519","Total",120,94,46,48,0,10,6,4,12,10,2,0,0,4
"2011","E00020510","E00020510","Total",127,76,28,48,0,9,6,3,41,39,1,1,0,1
"2011","E00020513","E00020513","Total",143,109,48,61,0,8,6,2,25,21,2,1,1,1
"2011","E00020514","E00020514","Total",151,90,39,51,0,13,10,3,47,45,0,2,0,1
"2011","E00020515","E00020515","Total",140,88,38,50,0,10,8,2,40,40,0,0,0,2
"2011","E00020520","E00020520","Total",175,86,31,55,2,49,45,4,34,28,0,4,2,4
"2011","E00020518","E00020518","Total",154,125,57,68,0,8,6,2,19,17,0,0,2,2
"2011","E00020523","E00020523","Total",156,93,57,36,0,26,24,2,35,33,0,2,0,2
"2011","E00020524","E00020524","Total",181,138,63,75,0,17,5,12,26,26,0,0,0,0
"2011","E00020529","E00020529","Total",140,112,61,51,0,7,4,3,19,16,0,3,0,2
"2011","E00020500","E00020500","Total",124,40,20,20,0,36,4,32,45,44,0,0,1,3
"2011","E00020502","E00020502","Total",122,110,56,54,0,2,2,0,7,7,0,0,0,3
"2011","E00020525","E00020525","Total",115,101,48,53,0,5,5,0,9,9,0,0,0,0
"2011","E00020528","E00020528","Total",139,132,76,56,0,2,2,0,4,3,0,1,0,1
"2011","E00020530","E00020530","Total",157,102,58,44,0,13,3,10,40,37,1,1,1,2
"2011","E00019849","E00019849","Total",143,89,23,66,1,25,4,21,28,25,0,2,1,0
"2011","E00019850","E00019850","Total",153,115,48,67,1,4,1,3,33,31,0,2,0,0
"2011","E00019851","E00019851","Total",162,57,20,37,6,39,21,18,60,57,0,2,1,0
"2011","E00019866","E00019866","Total",148,88,32,56,0,21,5,16,39,38,0,1,0,0
"2011","E00167762","E00167762","Total",131,46,12,34,1,24,23,1,59,57,0,1,1,1
"2011","E00167996","E00167996","Total",134,67,17,50,0,20,7,13,45,44,0,0,1,2
"2011","E00019864","E00019864","Total",148,25,8,17,0,104,4,100,19,18,0,1,0,0
"2011","E00019865","E00019865","Total",174,51,19,32,0,80,7,73,40,36,0,0,4,3
"2011","E00019867","E00019867","Total",196,85,29,56,1,59,9,50,49,47,0,1,1,2
"2011","E00019869","E00019869","Total",165,43,19,24,8,97,93,4,16,16,0,0,0,1
"2011","E00019870","E00019870","Total",115,29,9,20,0,64,59,5,22,22,0,0,0,0
"2011","E00019887","E00019887","Total",140,77,20,57,2,24,10,14,37,37,0,0,0,0
"2011","E00019893","E00019893","Total",158,101,32,69,0,15,5,10,42,38,1,2,1,0
"2011","E00019919","E00019919","Total",141,57,19,38,1,35,11,24,48,47,0,1,0,0
"2011","E00019921","E00019921","Total",112,68,23,45,0,22,10,12,22,21,0,1,0,0
"2011","E00019922","E00019922","Total",163,101,29,72,1,37,19,18,23,22,0,1,0,1
"2011","E00019892","E00019892","Total",148,72,27,45,0,21,7,14,51,50,0,1,0,4
"2011","E00019894","E00019894","Total",147,105,36,69,0,15,6,9,24,22,0,2,0,3
"2011","E00019895","E00019895","Total",123,32,16,16,1,73,72,1,15,13,0,2,0,2
"2011","E00019896","E00019896","Total",138,91,33,58,0,27,11,16,20,18,0,2,0,0
"2011","E00019897","E00019897","Total",143,87,26,61,2,12,7,5,42,39,0,3,0,0
"2011","E00020223","E00020223","Total",130,103,47,56,1,1,1,0,22,22,0,0,0,3
"2011","E00020225","E00020225","Total",131,67,22,45,2,14,9,5,43,41,2,0,0,5
"2011","E00020228","E00020228","Total",143,95,30,65,0,7,4,3,38,38,0,0,0,3
"2011","E00020230","E00020230","Total",123,81,24,57,1,12,3,9,28,26,0,2,0,1
"2011","E00020231","E00020231","Total",125,79,24,55,0,12,8,4,34,32,0,2,0,0
"2011","E00020232","E00020232","Total",128,84,16,68,1,10,6,4,32,30,0,2,0,1
"2011","E00019852","E00019852","Total",111,57,18,39,0,35,35,0,17,17,0,0,0,2
"2011","E00019853","E00019853","Total",114,95,60,35,0,5,2,3,12,12,0,0,0,2
"2011","E00019854","E00019854","Total",137,110,53,57,0,0,0,0,27,26,0,1,0,0
"2011","E00019872","E00019872","Total",213,90,23,67,21,56,56,0,43,41,0,2,0,3
"2011","E00019878","E00019878","Total",155,110,51,59,0,25,23,2,17,16,0,1,0,3
"2011","E00019855","E00019855","Total",133,26,7,19,2,80,78,2,23,22,0,1,0,2
"2011","E00019856","E00019856","Total",108,76,39,37,1,11,3,8,16,16,0,0,0,4
"2011","E00019857","E00019857","Total",119,87,54,33,0,12,3,9,20,19,0,1,0,0
"2011","E00019876","E00019876","Total",117,54,24,30,0,26,25,1,33,28,4,1,0,4
"2011","E00019879","E00019879","Total",131,97,54,43,6,16,14,2,11,10,1,0,0,1
"2011","E00019885","E00019885","Total",118,82,47,35,0,0,0,0,32,25,5,0,2,4
"2011","E00019880","E00019880","Total",123,32,7,25,2,71,68,3,16,14,1,1,0,2
"2011","E00019881","E00019881","Total",96,31,13,18,0,46,45,1,17,17,0,0,0,2
"2011","E00019882","E00019882","Total",164,31,11,20,2,107,105,2,21,16,0,4,1,3
"2011","E00019883","E00019883","Total",108,17,5,12,1,78,77,1,12,11,0,1,0,0
"2011","E00019884","E00019884","Total",121,23,7,16,0,88,88,0,8,7,0,1,0,2
"2011","E00019858","E00019858","Total",133,86,41,45,0,18,16,2,29,26,1,1,1,0
"2011","E00019859","E00019859","Total",116,71,39,32,2,2,2,0,41,41,0,0,0,0
"2011","E00019860","E00019860","Total",128,74,17,57,0,7,4,3,46,46,0,0,0,1
"2011","E00019861","E00019861","Total",94,58,27,31,0,2,2,0,34,29,2,3,0,0
"2011","E00019862","E00019862","Total",143,59,17,42,1,51,39,12,30,29,1,0,0,2
"2011","E00019863","E00019863","Total",128,76,25,51,15,7,4,3,29,27,0,2,0,1
"2011","E00019871","E00019871","Total",124,82,40,42,1,21,18,3,20,20,0,0,0,0
"2011","E00019873","E00019873","Total",105,77,34,43,1,4,3,1,16,14,1,1,0,7
"2011","E00019874","E00019874","Total",109,37,13,24,0,47,44,3,23,22,0,1,0,2
"2011","E00019875","E00019875","Total",111,65,38,27,0,15,4,11,27,25,0,1,1,4
"2011","E00019877","E00019877","Total",122,102,65,37,1,6,3,3,12,12,0,0,0,1
"2011","E00019796","E00019796","Total",117,16,11,5,0,70,60,10,27,24,0,0,3,4
"2011","E00019803","E00019803","Total",111,21,3,18,0,67,40,27,22,17,0,4,1,1
"2011","E00019807","E00019807","Total",112,56,27,29,1,2,1,1,52,50,0,2,0,1
"2011","E00167482","E00167482","Total",46,8,3,5,0,13,2,11,20,17,0,1,2,5
"2011","E00167503","E00167503","Total",72,2,1,1,0,59,8,51,10,8,0,1,1,1
"2011","E00019767","E00019767","Total",121,18,6,12,4,85,56,29,11,11,0,0,0,3
"2011","E00019769","E00019769","Total",126,22,9,13,0,76,69,7,24,22,0,1,1,4
"2011","E00019770","E00019770","Total",101,25,11,14,0,59,58,1,17,15,0,2,0,0
"2011","E00019801","E00019801","Total",107,9,0,9,0,59,35,24,39,36,0,3,0,0
"2011","E00019806","E00019806","Total",196,55,22,33,14,58,44,14,64,61,0,2,1,5
"2011","E00019766","E00019766","Total",123,28,6,22,0,73,63,10,19,16,0,2,1,3
"2011","E00019768","E00019768","Total",118,67,37,30,0,12,7,5,31,31,0,0,0,8
"2011","E00019772","E00019772","Total",121,30,7,23,0,72,39,33,15,11,1,2,1,4
"2011","E00167760","E00167760","Total",85,25,7,18,0,6,1,5,50,50,0,0,0,4
"2011","E00167998","E00167998","Total",90,14,5,9,9,54,11,43,8,7,0,0,1,5
"2011","E00019787","E00019787","Total",123,27,11,16,0,69,50,19,24,19,0,4,1,3
"2011","E00019788","E00019788","Total",129,38,16,22,0,71,56,15,20,19,0,1,0,0
"2011","E00019790","E00019790","Total",125,21,6,15,0,64,35,29,40,31,0,4,5,0
"2011","E00019793","E00019793","Total",153,32,9,23,0,34,31,3,80,77,0,3,0,7
"2011","E00165809","E00165809","Total",114,11,5,6,0,82,17,65,20,17,1,2,0,1
"2011","E00019800","E00019800","Total",133,62,24,38,1,37,16,21,31,31,0,0,0,2
"2011","E00019802","E00019802","Total",102,10,2,8,0,72,41,31,19,17,0,2,0,1
"2011","E00019804","E00019804","Total",111,18,4,14,0,69,66,3,24,21,0,3,0,0
"2011","E00019805","E00019805","Total",115,50,18,32,2,18,18,0,39,36,0,3,0,6
"2011","E00165808","E00165808","Total",116,23,3,20,0,81,38,43,10,9,0,1,0,2
"2011","E00021260","E00021260","Total",143,40,21,19,0,75,25,50,25,24,0,1,0,3
"2011","E00021273","E00021273","Total",125,31,14,17,2,82,29,53,8,7,0,1,0,2
"2011","E00021274","E00021274","Total",192,23,9,14,1,143,25,118,23,22,0,0,1,2
"2011","E00021279","E00021279","Total",153,17,3,14,1,118,29,89,13,11,0,2,0,4
"2011","E00021280","E00021280","Total",151,33,17,16,2,53,27,26,61,59,0,1,1,2
"2011","E00167202","E00167202","Total",108,11,6,5,0,89,18,71,7,7,0,0,0,1
"2011","E00167246","E00167246","Total",97,14,8,6,5,69,5,64,9,8,0,1,0,0
"2011","E00167247","E00167247","Total",79,42,10,32,0,8,2,6,29,26,0,3,0,0
"2011","E00021266","E00021266","Total",119,39,13,26,0,43,13,30,37,36,0,1,0,0
"2011","E00021267","E00021267","Total",145,21,9,12,0,96,10,86,27,26,0,1,0,1
"2011","E00021268","E00021268","Total",106,18,6,12,1,61,14,47,26,24,0,2,0,0
"2011","E00021271","E00021271","Total",189,22,12,10,2,158,10,148,6,4,0,2,0,1
"2011","E00021275","E00021275","Total",116,18,7,11,0,90,33,57,8,8,0,0,0,0
"2011","E00167197","E00167197","Total",122,13,3,10,2,75,7,68,31,25,0,0,6,1
"2011","E00167201","E00167201","Total",141,8,2,6,0,122,12,110,11,10,0,1,0,0
"2011","E00021272","E00021272","Total",89,13,5,8,1,51,12,39,22,22,0,0,0,2
"2011","E00021277","E00021277","Total",101,6,1,5,0,88,8,80,5,5,0,0,0,2
"2011","E00021278","E00021278","Total",82,8,1,7,0,54,12,42,20,19,0,1,0,0
"2011","E00021282","E00021282","Total",181,50,11,39,9,72,30,42,50,46,0,2,2,0
"2011","E00167198","E00167198","Total",183,39,21,18,20,89,16,73,34,34,0,0,0,1
"2011","E00167199","E00167199","Total",64,12,0,12,0,6,2,4,46,44,0,2,0,0
"2011","E00167200","E00167200","Total",106,13,2,11,0,9,2,7,84,84,0,0,0,0
"2011","E00021262","E00021262","Total",119,20,5,15,3,75,71,4,20,20,0,0,0,1
"2011","E00021281","E00021281","Total",204,49,20,29,16,64,33,31,74,71,0,2,1,1
"2011","E00021286","E00021286","Total",106,47,19,28,1,18,8,10,40,40,0,0,0,0
"2011","E00021289","E00021289","Total",127,9,5,4,2,108,103,5,8,8,0,0,0,0
"2011","E00021290","E00021290","Total",120,30,12,18,1,69,63,6,18,17,0,1,0,2
"2011","E00021145","E00021145","Total",104,19,6,13,0,64,8,56,20,19,1,0,0,1
"2011","E00021170","E00021170","Total",162,21,6,15,0,107,103,4,34,27,2,4,1,0
"2011","E00021171","E00021171","Total",241,34,7,27,0,130,82,48,74,72,0,2,0,3
"2011","E00021176","E00021176","Total",151,36,11,25,10,72,52,20,32,31,0,1,0,1
"2011","E00167172","E00167172","Total",104,34,11,23,4,13,1,12,51,48,0,3,0,2
"2011","E00167242","E00167242","Total",88,11,1,10,26,27,2,25,24,22,0,1,1,0
"2011","E00167244","E00167244","Total",114,21,13,8,2,9,2,7,82,82,0,0,0,0
"2011","E00021141","E00021141","Total",117,4,3,1,4,96,14,82,13,10,1,0,2,0
"2011","E00021148","E00021148","Total",119,22,8,14,2,61,40,21,31,27,2,2,0,3
"2011","E00021150","E00021150","Total",116,27,10,17,0,72,69,3,17,17,0,0,0,0
"2011","E00021156","E00021156","Total",133,14,7,7,1,88,51,37,29,27,0,2,0,1
"2011","E00021162","E00021162","Total",121,23,9,14,1,61,57,4,35,34,0,1,0,1
"2011","E00021149","E00021149","Total",126,25,9,16,1,81,22,59,18,15,0,2,1,1
"2011","E00021151","E00021151","Total",113,4,1,3,0,89,19,70,20,20,0,0,0,0
"2011","E00021157","E00021157","Total",106,12,5,7,2,71,35,36,21,20,0,1,0,0
"2011","E00021158","E00021158","Total",107,9,2,7,0,88,41,47,9,9,0,0,0,1
"2011","E00021165","E00021165","Total",122,19,5,14,1,79,65,14,21,21,0,0,0,2
"2011","E00021143","E00021143","Total",138,27,6,21,0,88,83,5,22,22,0,0,0,1
"2011","E00021147","E00021147","Total",83,17,11,6,0,44,4,40,20,19,0,0,1,2
"2011","E00021172","E00021172","Total",125,16,9,7,3,84,8,76,21,19,0,0,2,1
"2011","E00021173","E00021173","Total",146,44,12,32,0,71,63,8,30,27,0,2,1,1
"2011","E00021175","E00021175","Total",127,39,16,23,4,37,35,2,42,38,2,2,0,5
"2011","E00021297","E00021297","Total",156,71,31,40,2,47,10,37,32,32,0,0,0,4
"2011","E00021298","E00021298","Total",173,81,28,53,20,25,1,24,44,42,0,2,0,3
"2011","E00021318","E00021318","Total",142,31,12,19,1,50,39,11,59,56,0,3,0,1
"2011","E00021320","E00021320","Total",120,42,14,28,4,55,35,20,17,16,0,1,0,2
"2011","E00021327","E00021327","Total",178,43,14,29,9,87,3,84,37,30,1,5,1,2
"2011","E00021304","E00021304","Total",119,27,13,14,1,50,10,40,39,39,0,0,0,2
"2011","E00021319","E00021319","Total",138,29,11,18,1,62,14,48,46,46,0,0,0,0
"2011","E00021321","E00021321","Total",114,43,20,23,0,37,5,32,34,31,0,2,1,0
"2011","E00021322","E00021322","Total",116,22,11,11,1,65,13,52,27,23,0,4,0,1
"2011","E00021324","E00021324","Total",166,63,23,40,1,55,5,50,44,44,0,0,0,3
"2011","E00021325","E00021325","Total",150,40,18,22,2,78,14,64,28,26,0,2,0,2
"2011","E00021300","E00021300","Total",181,97,44,53,2,19,5,14,62,56,0,6,0,1
"2011","E00021305","E00021305","Total",100,66,40,26,0,9,1,8,25,23,0,1,1,0
"2011","E00021307","E00021307","Total",183,66,24,42,2,26,4,22,88,84,0,3,1,1
"2011","E00021308","E00021308","Total",139,42,26,16,1,46,29,17,49,49,0,0,0,1
"2011","E00021294","E00021294","Total",201,24,10,14,0,162,24,138,13,13,0,0,0,2
"2011","E00021309","E00021309","Total",105,43,9,34,0,4,0,4,58,56,0,2,0,0
"2011","E00021310","E00021310","Total",112,51,29,22,0,37,9,28,24,23,0,1,0,0
"2011","E00021311","E00021311","Total",119,28,15,13,0,70,6,64,21,19,1,1,0,0
"2011","E00021315","E00021315","Total",112,0,0,0,0,110,16,94,2,2,0,0,0,0
"2011","E00021316","E00021316","Total",102,33,15,18,0,48,8,40,19,19,0,0,0,2
"2011","E00021295","E00021295","Total",145,52,18,34,4,30,10,20,50,47,0,3,0,9
"2011","E00021296","E00021296","Total",160,45,11,34,0,61,2,59,52,49,0,3,0,2
"2011","E00021312","E00021312","Total",123,34,15,19,2,53,13,40,33,30,0,2,1,1
"2011","E00021313","E00021313","Total",204,69,23,46,0,49,22,27,83,76,0,6,1,3
"2011","E00021314","E00021314","Total",148,83,32,51,0,31,2,29,33,33,0,0,0,1
"2011","E00021317","E00021317","Total",123,82,34,48,0,14,3,11,27,27,0,0,0,0
"2011","E00021263","E00021263","Total",175,85,32,53,17,44,13,31,25,24,1,0,0,4
"2011","E00021285","E00021285","Total",77,18,3,15,33,6,3,3,20,18,0,2,0,0
"2011","E00021287","E00021287","Total",160,64,11,53,0,3,1,2,93,90,0,3,0,0
"2011","E00021288","E00021288","Total",133,69,14,55,0,3,1,2,60,57,0,3,0,1
"2011","E00021291","E00021291","Total",239,99,26,73,0,3,1,2,134,129,0,4,1,3
"2011","E00167091","E00167091","Total",144,35,4,31,14,26,1,25,66,60,1,5,0,3
"2011","E00167186","E00167186","Total",121,40,9,31,2,10,0,10,69,67,0,2,0,0
"2011","E00167195","E00167195","Total",98,33,8,25,3,19,0,19,40,38,0,1,1,3
"2011","E00021299","E00021299","Total",165,56,20,36,12,44,27,17,52,49,0,1,2,1
"2011","E00021303","E00021303","Total",126,21,7,14,0,73,64,9,32,31,0,0,1,0
"2011","E00021306","E00021306","Total",126,61,28,33,1,26,12,14,35,33,0,1,1,3
"2011","E00021326","E00021326","Total",134,31,9,22,1,78,72,6,24,21,0,3,0,0
"2011","E00021301","E00021301","Total",175,32,8,24,1,107,60,47,31,29,1,1,0,4
"2011","E00021302","E00021302","Total",185,41,17,24,7,79,44,35,54,52,0,2,0,4
"2011","E00021323","E00021323","Total",138,14,3,11,1,93,54,39,28,25,0,2,1,2
"2011","E00021328","E00021328","Total",131,18,5,13,1,72,63,9,37,37,0,0,0,3
"2011","E00167088","E00167088","Total",112,38,5,33,1,6,2,4,64,62,0,2,0,3
"2011","E00167089","E00167089","Total",92,10,4,6,1,30,0,30,48,46,0,2,0,3
"2011","E00167090","E00167090","Total",100,2,0,2,8,75,5,70,12,12,0,0,0,3
"2011","E00167184","E00167184","Total",93,10,3,7,11,48,14,34,22,21,0,1,0,2
"2011","E00167185","E00167185","Total",105,2,0,2,1,91,8,83,10,10,0,0,0,1
"2011","E00167188","E00167188","Total",141,41,12,29,1,3,2,1,96,95,0,1,0,0
"2011","E00167092","E00167092","Total",122,26,8,18,22,36,7,29,37,36,0,1,0,1
"2011","E00167189","E00167189","Total",120,27,3,24,1,36,6,30,53,53,0,0,0,3
"2011","E00167190","E00167190","Total",97,23,8,15,1,26,5,21,46,42,0,4,0,1
"2011","E00167193","E00167193","Total",102,7,2,5,0,87,6,81,8,6,0,2,0,0
"2011","E00167194","E00167194","Total",125,17,5,12,29,49,4,45,27,25,0,2,0,3
"2011","E00167196","E00167196","Total",79,6,3,3,0,71,8,63,1,1,0,0,0,1
"2011","E00021261","E00021261","Total",128,26,2,24,1,58,5,53,42,39,0,2,1,1
"2011","E00021292","E00021292","Total",113,27,15,12,0,58,50,8,26,26,0,0,0,2
"2011","E00167187","E00167187","Total",122,43,14,29,0,22,19,3,56,54,0,1,1,1
"2011","E00167191","E00167191","Total",123,40,3,37,0,11,4,7,72,70,0,1,1,0
"2011","E00167192","E00167192","Total",104,28,3,25,1,16,3,13,59,57,0,2,0,0
"2011","E00167263","E00167263","Total",102,30,8,22,2,1,0,1,69,67,0,2,0,0
"2011","E00021146","E00021146","Total",143,40,13,27,1,16,2,14,85,82,0,1,2,1
"2011","E00021153","E00021153","Total",149,21,3,18,0,7,3,4,119,117,1,1,0,2
"2011","E00021154","E00021154","Total",121,12,5,7,7,84,62,22,16,16,0,0,0,2
"2011","E00021155","E00021155","Total",172,55,15,40,1,8,0,8,108,102,0,4,2,0
"2011","E00021169","E00021169","Total",189,55,19,36,13,63,23,40,56,50,0,2,4,2
"2011","E00021174","E00021174","Total",128,76,35,41,0,1,1,0,50,49,0,1,0,1
"2011","E00021177","E00021177","Total",134,22,8,14,0,91,39,52,21,20,0,1,0,0
"2011","E00167243","E00167243","Total",133,32,10,22,1,12,4,8,87,83,0,4,0,1
"2011","E00167245","E00167245","Total",129,35,9,26,1,51,9,42,41,38,0,3,0,1
"2011","E00021160","E00021160","Total",112,23,12,11,0,59,53,6,29,28,0,1,0,1
"2011","E00021161","E00021161","Total",154,49,23,26,0,70,25,45,31,29,0,2,0,4
"2011","E00021166","E00021166","Total",126,23,9,14,0,57,30,27,46,45,0,1,0,0
"2011","E00021167","E00021167","Total",128,48,22,26,0,36,17,19,43,38,0,5,0,1
"2011","E00021168","E00021168","Total",169,55,12,43,1,4,2,2,107,101,1,4,1,2
"2011","E00021152","E00021152","Total",138,27,6,21,0,95,57,38,15,15,0,0,0,1
"2011","E00021159","E00021159","Total",246,65,18,47,0,121,49,72,56,47,2,5,2,4
"2011","E00021163","E00021163","Total",119,27,14,13,1,67,22,45,23,19,0,2,2,1
"2011","E00021164","E00021164","Total",128,20,12,8,0,99,31,68,7,6,0,0,1,2
"2011","E00021699","E00021699","Total",172,32,12,20,1,101,32,69,34,30,0,2,2,4
"2011","E00021703","E00021703","Total",123,34,14,20,2,55,43,12,31,30,0,0,1,1
"2011","E00021728","E00021728","Total",114,23,9,14,1,62,58,4,25,24,0,1,0,3
"2011","E00021729","E00021729","Total",72,16,4,12,1,40,38,2,15,13,0,2,0,0
"2011","E00021730","E00021730","Total",163,39,14,25,1,95,93,2,27,25,0,0,2,1
"2011","E00021698","E00021698","Total",159,82,38,44,0,29,4,25,45,39,0,6,0,3
"2011","E00021724","E00021724","Total",120,76,38,38,0,4,2,2,39,36,0,2,1,1
"2011","E00021725","E00021725","Total",116,57,28,29,0,29,3,26,30,28,0,0,2,0
"2011","E00021732","E00021732","Total",98,38,10,28,0,27,25,2,33,29,0,2,2,0
"2011","E00021700","E00021700","Total",222,71,20,51,2,82,65,17,65,62,1,2,0,2
"2011","E00021708","E00021708","Total",130,38,13,25,1,63,56,7,27,23,0,4,0,1
"2011","E00021710","E00021710","Total",116,30,11,19,0,64,60,4,21,20,0,1,0,1
"2011","E00021712","E00021712","Total",150,38,14,24,0,45,37,8,66,65,0,0,1,1
"2011","E00021714","E00021714","Total",100,20,7,13,1,70,48,22,9,9,0,0,0,0
"2011","E00021697","E00021697","Total",143,23,7,16,10,76,74,2,34,32,0,2,0,0
"2011","E00021722","E00021722","Total",158,6,2,4,0,112,10,102,37,35,0,0,2,3
"2011","E00021723","E00021723","Total",110,36,12,24,1,37,18,19,35,30,1,4,0,1
"2011","E00021726","E00021726","Total",108,17,6,11,0,79,76,3,12,12,0,0,0,0
"2011","E00021727","E00021727","Total",111,8,3,5,0,95,22,73,7,5,1,1,0,1
"2011","E00021458","E00021458","Total",148,55,17,38,4,27,16,11,60,58,0,2,0,2
"2011","E00021459","E00021459","Total",139,55,16,39,2,24,19,5,58,55,0,3,0,0
"2011","E00021460","E00021460","Total",166,58,21,37,1,41,36,5,66,65,0,1,0,0
"2011","E00021461","E00021461","Total",120,35,11,24,2,56,52,4,27,24,0,3,0,0
"2011","E00021464","E00021464","Total",128,29,5,24,0,58,30,28,41,40,0,1,0,0
"2011","E00021468","E00021468","Total",111,19,6,13,11,51,47,4,29,26,0,2,1,1
"2011","E00021462","E00021462","Total",137,30,16,14,0,76,76,0,31,30,1,0,0,0
"2011","E00021463","E00021463","Total",130,43,17,26,0,61,59,2,23,22,0,1,0,3
"2011","E00021465","E00021465","Total",128,31,10,21,2,65,60,5,26,25,0,1,0,4
"2011","E00167206","E00167206","Total",125,25,12,13,1,75,71,4,23,23,0,0,0,1
"2011","E00167207","E00167207","Total",116,38,16,22,16,34,11,23,28,26,0,2,0,0
"2011","E00021442","E00021442","Total",130,13,6,7,1,101,3,98,13,13,0,0,0,2
"2011","E00021443","E00021443","Total",116,18,2,16,0,72,11,61,25,22,0,0,3,1
"2011","E00021469","E00021469","Total",149,30,16,14,2,74,69,5,39,39,0,0,0,4
"2011","E00021471","E00021471","Total",134,27,9,18,2,86,60,26,16,15,0,1,0,3
"2011","E00021441","E00021441","Total",129,61,27,34,0,47,1,46,20,15,0,4,1,1
"2011","E00021449","E00021449","Total",138,37,12,25,4,50,28,22,44,42,0,2,0,3
"2011","E00021450","E00021450","Total",71,35,17,18,1,17,0,17,17,17,0,0,0,1
"2011","E00021453","E00021453","Total",129,26,13,13,1,67,42,25,31,29,0,2,0,4
"2011","E00021454","E00021454","Total",116,13,2,11,0,84,21,63,19,18,0,1,0,0
"2011","E00021349","E00021349","Total",136,21,4,17,0,90,35,55,23,21,0,1,1,2
"2011","E00021351","E00021351","Total",134,16,6,10,0,96,35,61,21,20,0,1,0,1
"2011","E00021352","E00021352","Total",116,15,1,14,0,88,8,80,13,13,0,0,0,0
"2011","E00021353","E00021353","Total",127,8,0,8,0,89,30,59,25,22,0,1,2,5
"2011","E00021350","E00021350","Total",110,18,3,15,4,55,12,43,30,30,0,0,0,3
"2011","E00021354","E00021354","Total",142,18,5,13,9,91,9,82,22,20,0,1,1,2
"2011","E00021357","E00021357","Total",118,25,3,22,0,80,37,43,12,10,0,0,2,1
"2011","E00021360","E00021360","Total",127,12,3,9,1,73,33,40,41,39,0,1,1,0
"2011","E00021331","E00021331","Total",90,6,2,4,0,64,15,49,19,15,0,1,3,1
"2011","E00021355","E00021355","Total",161,65,29,36,1,24,8,16,71,62,0,9,0,0
"2011","E00021361","E00021361","Total",131,6,4,2,9,103,13,90,10,9,0,1,0,3
"2011","E00167264","E00167264","Total",124,24,7,17,29,50,6,44,20,17,0,2,1,1
"2011","E00021338","E00021338","Total",134,20,9,11,1,84,33,51,27,23,1,1,2,2
"2011","E00021340","E00021340","Total",211,21,4,17,0,61,14,47,124,124,0,0,0,5
"2011","E00167084","E00167084","Total",113,10,4,6,24,29,3,26,49,49,0,0,0,1
"2011","E00167213","E00167213","Total",111,16,4,12,0,74,28,46,14,12,0,0,2,7
"2011","E00167214","E00167214","Total",129,10,3,7,1,60,15,45,57,56,0,1,0,1
"2011","E00167215","E00167215","Total",149,28,8,20,3,63,11,52,51,49,0,1,1,4
"2011","E00167217","E00167217","Total",90,14,4,10,0,59,21,38,16,16,0,0,0,1
"2011","E00167218","E00167218","Total",121,36,6,30,4,56,8,48,24,23,0,0,1,1
"2011","E00021334","E00021334","Total",155,39,8,31,0,95,68,27,20,15,0,4,1,1
"2011","E00021335","E00021335","Total",180,22,12,10,7,125,21,104,22,22,0,0,0,4
"2011","E00021337","E00021337","Total",88,11,1,10,8,61,6,55,7,7,0,0,0,1
"2011","E00021359","E00021359","Total",110,28,8,20,1,60,20,40,21,21,0,0,0,0
"2011","E00021706","E00021706","Total",111,24,9,15,1,51,50,1,31,31,0,0,0,4
"2011","E00021707","E00021707","Total",143,23,4,19,0,79,62,17,40,39,0,0,1,1
"2011","E00021709","E00021709","Total",111,16,4,12,0,67,63,4,28,27,0,1,0,0
"2011","E00021713","E00021713","Total",98,11,4,7,0,61,57,4,23,23,0,0,0,3
"2011","E00021716","E00021716","Total",165,20,11,9,0,128,123,5,16,13,0,1,2,1
"2011","E00021702","E00021702","Total",124,18,12,6,0,85,79,6,18,18,0,0,0,3
"2011","E00021704","E00021704","Total",157,27,9,18,1,73,58,15,54,53,0,1,0,2
"2011","E00021705","E00021705","Total",175,61,26,35,6,59,50,9,49,43,0,1,5,0
"2011","E00021711","E00021711","Total",200,44,14,30,0,45,36,9,109,107,1,1,0,2
"2011","E00021731","E00021731","Total",156,37,9,28,5,87,78,9,25,23,0,2,0,2
"2011","E00021715","E00021715","Total",135,19,7,12,0,85,52,33,29,28,0,1,0,2
"2011","E00021717","E00021717","Total",109,17,7,10,0,69,62,7,22,22,0,0,0,1
"2011","E00021718","E00021718","Total",155,47,11,36,1,53,46,7,53,52,0,1,0,1
"2011","E00021719","E00021719","Total",56,17,6,11,0,28,25,3,11,10,0,1,0,0
"2011","E00021695","E00021695","Total",154,55,19,36,1,29,16,13,68,64,0,4,0,1
"2011","E00021696","E00021696","Total",186,58,13,45,8,63,8,55,56,50,0,4,2,1
"2011","E00021701","E00021701","Total",184,71,21,50,3,43,31,12,65,58,0,7,0,2
"2011","E00167093","E00167093","Total",97,22,7,15,5,15,1,14,55,52,1,2,0,0
"2011","E00167176","E00167176","Total",182,27,14,13,1,74,5,69,77,74,0,3,0,3
"2011","E00167177","E00167177","Total",129,24,9,15,1,3,1,2,101,97,0,2,2,0
"2011","E00167178","E00167178","Total",132,25,6,19,4,49,5,44,53,50,0,3,0,1
"2011","E00167179","E00167179","Total",129,8,3,5,1,7,3,4,113,112,0,0,1,0
"2011","E00021445","E00021445","Total",116,13,3,10,1,80,73,7,21,17,0,0,4,1
"2011","E00021467","E00021467","Total",121,21,9,12,0,69,64,5,26,17,0,0,9,5
"2011","E00021473","E00021473","Total",95,23,8,15,2,43,40,3,27,17,0,0,10,0
"2011","E00167251","E00167251","Total",111,4,2,2,0,22,1,21,85,19,0,0,66,0
"2011","E00167254","E00167254","Total",107,22,12,10,0,39,31,8,45,34,0,4,7,1
"2011","E00021444","E00021444","Total",117,24,13,11,0,59,11,48,32,20,0,0,12,2
"2011","E00021466","E00021466","Total",139,28,15,13,0,71,62,9,40,21,0,0,19,0
"2011","E00021470","E00021470","Total",117,29,12,17,4,56,50,6,27,22,1,2,2,1
"2011","E00021475","E00021475","Total",122,32,11,21,1,42,36,6,45,43,1,0,1,2
"2011","E00021439","E00021439","Total",90,14,9,5,0,53,50,3,22,22,0,0,0,1
"2011","E00021440","E00021440","Total",128,48,22,26,0,40,38,2,37,32,0,4,1,3
"2011","E00021446","E00021446","Total",117,17,6,11,0,84,83,1,16,16,0,0,0,0
"2011","E00021474","E00021474","Total",122,27,12,15,1,63,62,1,30,29,0,0,1,1
"2011","E00167204","E00167204","Total",121,65,8,57,0,6,1,5,50,47,0,3,0,0
"2011","E00167205","E00167205","Total",123,21,6,15,2,83,65,18,17,13,0,1,3,0
"2011","E00167208","E00167208","Total",131,67,12,55,1,6,4,2,54,53,0,1,0,3
"2011","E00167209","E00167209","Total",168,3,0,3,44,101,7,94,20,17,0,0,3,0
"2011","E00167210","E00167210","Total",73,37,6,31,0,4,4,0,31,28,0,3,0,1
"2011","E00021447","E00021447","Total",123,61,15,46,3,9,8,1,50,47,0,2,1,0
"2011","E00021448","E00021448","Total",139,30,11,19,0,95,76,19,13,12,0,1,0,1
"2011","E00021451","E00021451","Total",147,23,12,11,0,102,92,10,21,19,0,2,0,1
"2011","E00021452","E00021452","Total",117,32,13,19,7,53,49,4,24,22,0,1,1,1
"2011","E00021455","E00021455","Total",148,20,7,13,0,115,111,4,13,12,0,1,0,0
"2011","E00021185","E00021185","Total",131,28,10,18,1,74,5,69,27,27,0,0,0,1
"2011","E00021188","E00021188","Total",120,9,1,8,0,87,8,79,22,19,0,2,1,2
"2011","E00021208","E00021208","Total",108,20,5,15,2,65,51,14,20,19,0,1,0,1
"2011","E00021214","E00021214","Total",156,38,15,23,1,67,55,12,47,39,0,1,7,3
"2011","E00021187","E00021187","Total",97,14,10,4,0,58,50,8,22,20,0,1,1,3
"2011","E00021195","E00021195","Total",108,20,6,14,1,62,60,2,25,25,0,0,0,0
"2011","E00021199","E00021199","Total",111,4,2,2,0,104,15,89,3,2,0,0,1,0
"2011","E00021206","E00021206","Total",78,10,2,8,0,54,48,6,12,12,0,0,0,2
"2011","E00021209","E00021209","Total",72,10,1,9,1,46,42,4,15,14,0,1,0,0
"2011","E00021184","E00021184","Total",69,12,3,9,11,21,19,2,25,25,0,0,0,0
"2011","E00021197","E00021197","Total",215,73,29,44,2,60,35,25,77,72,0,1,4,3
"2011","E00021200","E00021200","Total",107,18,6,12,1,51,48,3,36,34,1,1,0,1
"2011","E00021203","E00021203","Total",104,17,10,7,0,61,47,14,25,24,0,0,1,1
"2011","E00021217","E00021217","Total",225,36,16,20,2,91,44,47,94,83,0,0,11,2
"2011","E00021196","E00021196","Total",114,10,3,7,1,93,49,44,9,8,0,1,0,1
"2011","E00021198","E00021198","Total",92,31,15,16,0,40,26,14,19,19,0,0,0,2
"2011","E00021201","E00021201","Total",107,28,10,18,1,48,41,7,29,27,0,2,0,1
"2011","E00021202","E00021202","Total",92,21,6,15,0,50,42,8,18,17,0,1,0,3
"2011","E00021205","E00021205","Total",100,17,5,12,0,56,51,5,25,25,0,0,0,2
"2011","E00021210","E00021210","Total",78,14,3,11,1,43,38,5,18,17,0,0,1,2
"2011","E00021211","E00021211","Total",135,21,5,16,0,53,51,2,58,58,0,0,0,3
"2011","E00021212","E00021212","Total",75,12,1,11,1,44,36,8,18,17,0,0,1,0
"2011","E00021332","E00021332","Total",134,16,2,14,1,99,44,55,17,15,0,1,1,1
"2011","E00021333","E00021333","Total",126,27,8,19,1,71,31,40,26,24,1,1,0,1
"2011","E00021336","E00021336","Total",88,17,3,14,0,60,26,34,7,7,0,0,0,4
"2011","E00021339","E00021339","Total",125,32,18,14,6,44,37,7,41,38,0,3,0,2
"2011","E00021342","E00021342","Total",101,17,6,11,0,74,27,47,10,10,0,0,0,0
"2011","E00021329","E00021329","Total",187,17,8,9,3,129,75,54,34,33,0,0,1,4
"2011","E00021344","E00021344","Total",152,16,9,7,4,106,48,58,26,24,0,2,0,0
"2011","E00021345","E00021345","Total",115,18,5,13,0,68,29,39,29,27,0,1,1,0
"2011","E00021346","E00021346","Total",116,16,3,13,10,67,26,41,23,21,0,1,1,0
"2011","E00021330","E00021330","Total",122,18,7,11,1,68,50,18,32,30,0,1,1,3
"2011","E00021347","E00021347","Total",149,12,3,9,2,110,54,56,25,23,0,1,1,0
"2011","E00167082","E00167082","Total",138,29,6,23,12,15,3,12,80,73,0,7,0,2
"2011","E00167083","E00167083","Total",122,14,3,11,7,47,7,40,52,51,0,1,0,2
"2011","E00167211","E00167211","Total",138,29,8,21,1,41,23,18,62,61,0,0,1,5
"2011","E00167212","E00167212","Total",116,19,3,16,3,79,29,50,13,11,0,0,2,2
"2011","E00167216","E00167216","Total",113,13,5,8,2,68,23,45,28,27,0,1,0,2
"2011","E00021477","E00021477","Total",166,43,14,29,1,49,7,42,62,58,2,2,0,11
"2011","E00021480","E00021480","Total",144,49,11,38,0,15,3,12,80,76,0,4,0,0
"2011","E00021499","E00021499","Total",124,36,6,30,0,42,5,37,44,38,0,6,0,2
"2011","E00021500","E00021500","Total",139,35,8,27,0,56,2,54,47,46,0,1,0,1
"2011","E00021502","E00021502","Total",134,4,1,3,0,119,10,109,9,9,0,0,0,2
"2011","E00021501","E00021501","Total",131,8,4,4,0,86,28,58,37,36,0,0,1,0
"2011","E00021503","E00021503","Total",129,17,4,13,0,95,30,65,15,12,0,2,1,2
"2011","E00021504","E00021504","Total",164,11,3,8,0,102,24,78,49,49,0,0,0,2
"2011","E00021505","E00021505","Total",95,17,6,11,0,64,11,53,13,13,0,0,0,1
"2011","E00021507","E00021507","Total",169,21,6,15,0,83,18,65,64,63,0,1,0,1
"2011","E00021180","E00021180","Total",168,26,11,15,1,87,50,37,51,48,0,3,0,3
"2011","E00021194","E00021194","Total",176,22,13,9,8,95,57,38,50,49,0,0,1,1
"2011","E00021213","E00021213","Total",132,18,3,15,0,77,59,18,36,33,0,2,1,1
"2011","E00167171","E00167171","Total",70,12,3,9,0,32,28,4,26,26,0,0,0,0
"2011","E00167173","E00167173","Total",142,9,3,6,5,118,15,103,6,6,0,0,0,4
"2011","E00021186","E00021186","Total",156,27,9,18,0,87,78,9,39,37,0,1,1,3
"2011","E00021189","E00021189","Total",122,32,13,19,0,60,55,5,28,26,0,1,1,2
"2011","E00021192","E00021192","Total",113,18,10,8,1,62,59,3,30,28,0,0,2,2
"2011","E00021216","E00021216","Total",163,6,1,5,2,124,36,88,28,27,0,1,0,3
"2011","E00021179","E00021179","Total",140,47,15,32,1,10,7,3,80,75,0,4,1,2
"2011","E00021190","E00021190","Total",161,42,18,24,1,41,40,1,75,73,0,2,0,2
"2011","E00021191","E00021191","Total",124,47,15,32,2,36,35,1,39,30,0,9,0,0
"2011","E00021193","E00021193","Total",182,66,19,47,0,5,5,0,108,96,0,8,4,3
"2011","E00021215","E00021215","Total",181,65,26,39,2,9,8,1,104,98,0,4,2,1
"2011","E00021181","E00021181","Total",107,25,6,19,0,36,14,22,44,42,0,2,0,2
"2011","E00021182","E00021182","Total",169,44,19,25,0,18,6,12,105,105,0,0,0,2
"2011","E00021183","E00021183","Total",135,66,18,48,4,12,1,11,52,51,0,1,0,1
"2011","E00021204","E00021204","Total",145,27,5,22,1,87,11,76,29,27,0,1,1,1
"2011","E00021207","E00021207","Total",164,52,12,40,1,33,3,30,77,76,0,1,0,1
"2011","E00021478","E00021478","Total",130,39,20,19,0,48,9,39,41,38,0,2,1,2
"2011","E00021481","E00021481","Total",134,22,11,11,0,68,22,46,44,40,0,3,1,0
"2011","E00021506","E00021506","Total",142,23,8,15,1,91,28,63,26,26,0,0,0,1
"2011","E00021508","E00021508","Total",136,30,11,19,0,59,24,35,46,45,0,0,1,1
"2011","E00021509","E00021509","Total",184,28,14,14,1,111,37,74,44,43,0,1,0,0
"2011","E00021476","E00021476","Total",122,25,5,20,0,61,22,39,34,32,0,1,1,2
"2011","E00021479","E00021479","Total",151,36,12,24,1,19,3,16,93,90,0,2,1,2
"2011","E00021482","E00021482","Total",127,46,13,33,1,32,8,24,47,43,0,2,2,1
"2011","E00021483","E00021483","Total",231,73,13,60,5,48,11,37,104,95,0,8,1,1
"2011","E00021484","E00021484","Total",114,53,15,38,2,7,2,5,51,49,0,2,0,1
"2011","E00021485","E00021485","Total",122,5,1,4,1,99,9,90,16,16,0,0,0,1
"2011","E00021486","E00021486","Total",121,25,13,12,0,62,20,42,34,31,0,2,1,0
"2011","E00021487","E00021487","Total",71,7,2,5,0,58,19,39,3,1,0,1,1,3
"2011","E00021489","E00021489","Total",119,18,4,14,0,74,22,52,26,25,0,1,0,1
"2011","E00021490","E00021490","Total",115,16,4,12,0,72,22,50,23,19,0,2,2,4
"2011","E00021488","E00021488","Total",157,31,7,24,7,80,31,49,38,38,0,0,0,1
"2011","E00021491","E00021491","Total",87,11,2,9,1,67,24,43,8,8,0,0,0,0
"2011","E00021492","E00021492","Total",136,15,4,11,1,93,46,47,25,24,0,0,1,2
"2011","E00021493","E00021493","Total",126,12,4,8,0,96,47,49,18,17,0,0,1,0
"2011","E00021497","E00021497","Total",133,17,2,15,0,93,42,51,22,21,0,0,1,1
"2011","E00021494","E00021494","Total",176,36,13,23,0,113,23,90,23,22,0,1,0,4
"2011","E00021495","E00021495","Total",184,25,8,17,0,125,43,82,33,32,0,1,0,1
"2011","E00021496","E00021496","Total",107,12,4,8,1,75,23,52,19,18,0,0,1,0
"2011","E00021498","E00021498","Total",127,13,3,10,0,98,37,61,15,14,0,0,1,1
"2011","E00021672","E00021672","Total",142,30,17,13,2,58,24,34,50,49,0,1,0,2
"2011","E00021680","E00021680","Total",194,82,45,37,1,43,5,38,62,57,0,2,3,6
"2011","E00021687","E00021687","Total",189,48,17,31,2,38,25,13,99,94,0,4,1,2
"2011","E00021694","E00021694","Total",162,39,11,28,1,53,12,41,66,60,0,2,4,3
"2011","E00021676","E00021676","Total",168,44,14,30,5,6,2,4,112,106,1,5,0,1
"2011","E00021681","E00021681","Total",147,55,26,29,1,10,1,9,81,80,0,1,0,0
"2011","E00021686","E00021686","Total",182,55,22,33,3,34,8,26,86,78,0,3,5,4
"2011","E00021689","E00021689","Total",162,43,11,32,1,15,1,14,100,99,0,1,0,3
"2011","E00021692","E00021692","Total",156,49,24,25,0,32,2,30,72,69,0,1,2,3
"2011","E00021693","E00021693","Total",199,40,13,27,0,69,16,53,88,86,0,2,0,2
"2011","E00021677","E00021677","Total",120,27,10,17,1,60,14,46,31,29,0,1,1,1
"2011","E00021678","E00021678","Total",166,85,31,54,0,34,16,18,44,42,0,2,0,3
"2011","E00021679","E00021679","Total",58,26,5,21,1,17,9,8,14,12,0,2,0,0
"2011","E00021682","E00021682","Total",160,51,18,33,0,66,63,3,41,41,0,0,0,2
"2011","E00021675","E00021675","Total",162,32,14,18,0,106,94,12,23,22,0,0,1,1
"2011","E00021683","E00021683","Total",156,36,10,26,0,71,46,25,47,45,0,1,1,2
"2011","E00021685","E00021685","Total",220,67,21,46,7,64,32,32,80,74,0,4,2,2
"2011","E00167078","E00167078","Total",120,20,10,10,0,18,15,3,81,78,0,1,2,1
"2011","E00167095","E00167095","Total",109,18,4,14,4,55,20,35,32,31,0,1,0,0
"2011","E00167169","E00167169","Total",135,5,3,2,16,80,8,72,34,31,0,0,3,0
"2011","E00021673","E00021673","Total",139,2,0,2,2,106,4,102,27,26,0,0,1,2
"2011","E00021674","E00021674","Total",155,45,13,32,1,28,10,18,79,76,0,3,0,2
"2011","E00021688","E00021688","Total",142,38,15,23,1,53,23,30,48,46,0,1,1,2
"2011","E00021690","E00021690","Total",218,42,15,27,1,54,15,39,121,108,1,2,10,0
"2011","E00021691","E00021691","Total",139,23,8,15,0,74,17,57,41,32,2,1,6,1
"2011","E00021562","E00021562","Total",140,55,15,40,0,31,28,3,49,47,0,2,0,5
"2011","E00021572","E00021572","Total",143,34,16,18,3,56,15,41,50,48,0,2,0,0
"2011","E00021574","E00021574","Total",93,29,9,20,0,32,22,10,30,29,0,1,0,2
"2011","E00021577","E00021577","Total",128,8,5,3,0,108,12,96,7,6,0,0,1,5
"2011","E00167241","E00167241","Total",117,16,4,12,2,69,64,5,25,25,0,0,0,5
"2011","E00167260","E00167260","Total",135,12,2,10,0,100,10,90,20,18,0,1,1,3
"2011","E00021586","E00021586","Total",130,33,8,25,0,63,28,35,33,28,0,5,0,1
"2011","E00021588","E00021588","Total",148,24,5,19,0,103,25,78,16,16,0,0,0,5
"2011","E00021590","E00021590","Total",137,36,21,15,0,80,15,65,20,20,0,0,0,1
"2011","E00021593","E00021593","Total",140,14,3,11,3,102,14,88,18,16,1,1,0,3
"2011","E00167252","E00167252","Total",142,22,3,19,19,64,25,39,36,33,2,1,0,1
"2011","E00167261","E00167261","Total",157,67,23,44,5,28,4,24,56,46,1,9,0,1
"2011","E00021564","E00021564","Total",123,31,17,14,1,59,7,52,28,24,0,2,2,4
"2011","E00021566","E00021566","Total",156,42,21,21,1,46,16,30,65,63,0,2,0,2
"2011","E00021583","E00021583","Total",150,24,8,16,0,95,67,28,29,21,0,2,6,2
"2011","E00021592","E00021592","Total",112,41,15,26,4,52,27,25,15,15,0,0,0,0
"2011","E00021594","E00021594","Total",129,34,20,14,2,71,62,9,21,20,0,0,1,1
"2011","E00021561","E00021561","Total",144,39,19,20,1,14,4,10,89,83,0,4,2,1
"2011","E00021567","E00021567","Total",143,61,33,28,2,27,23,4,52,47,0,3,2,1
"2011","E00021569","E00021569","Total",142,33,16,17,0,40,2,38,64,57,0,0,7,5
"2011","E00167265","E00167265","Total",146,39,15,24,0,74,71,3,32,29,0,2,1,1
"2011","E00021753","E00021753","Total",115,21,11,10,0,80,45,35,14,13,0,1,0,0
"2011","E00021754","E00021754","Total",87,21,9,12,0,45,44,1,21,20,0,0,1,0
"2011","E00021756","E00021756","Total",102,30,3,27,2,36,22,14,33,27,0,2,4,1
"2011","E00021757","E00021757","Total",96,17,5,12,0,65,64,1,13,11,0,1,1,1
"2011","E00021761","E00021761","Total",102,19,8,11,3,22,2,20,57,51,3,0,3,1
"2011","E00021737","E00021737","Total",104,34,6,28,2,29,17,12,36,34,0,1,1,3
"2011","E00021758","E00021758","Total",134,22,6,16,0,66,33,33,44,40,0,3,1,2
"2011","E00021763","E00021763","Total",133,45,18,27,0,57,45,12,29,28,0,1,0,2
"2011","E00021764","E00021764","Total",109,36,14,22,1,26,10,16,45,45,0,0,0,1
"2011","E00021736","E00021736","Total",135,36,16,20,2,69,67,2,26,25,0,0,1,2
"2011","E00021755","E00021755","Total",125,53,11,42,0,39,23,16,32,30,0,2,0,1
"2011","E00021759","E00021759","Total",110,27,7,20,0,60,53,7,20,19,0,1,0,3
"2011","E00021760","E00021760","Total",115,23,6,17,0,72,66,6,19,19,0,0,0,1
"2011","E00021739","E00021739","Total",126,12,5,7,0,6,4,2,108,105,0,3,0,0
"2011","E00021740","E00021740","Total",168,33,13,20,23,87,75,12,24,24,0,0,0,1
"2011","E00021745","E00021745","Total",98,15,7,8,0,62,57,5,21,19,0,2,0,0
"2011","E00021762","E00021762","Total",105,22,7,15,0,38,36,2,43,40,0,1,2,2
"2011","E00021767","E00021767","Total",126,38,15,23,0,49,41,8,36,36,0,0,0,3
"2011","E00021369","E00021369","Total",60,8,2,6,0,51,17,34,1,1,0,0,0,0
"2011","E00021370","E00021370","Total",172,36,8,28,4,105,25,80,26,25,0,0,1,1
"2011","E00021371","E00021371","Total",46,4,1,3,0,39,9,30,2,2,0,0,0,1
"2011","E00021391","E00021391","Total",155,12,4,8,0,113,47,66,28,25,0,1,2,2
"2011","E00021364","E00021364","Total",161,55,28,27,1,71,22,49,32,30,1,0,1,2
"2011","E00021372","E00021372","Total",148,38,19,19,8,69,38,31,32,32,0,0,0,1
"2011","E00021384","E00021384","Total",122,81,18,63,1,1,1,0,36,31,1,4,0,3
"2011","E00021385","E00021385","Total",155,45,18,27,37,30,13,17,42,40,0,2,0,1
"2011","E00021392","E00021392","Total",161,87,39,48,26,16,10,6,30,30,0,0,0,2
"2011","E00021381","E00021381","Total",141,13,6,7,0,95,42,53,31,29,0,0,2,2
"2011","E00021382","E00021382","Total",124,12,5,7,0,96,28,68,14,11,0,0,3,2
"2011","E00021383","E00021383","Total",176,16,4,12,0,129,48,81,28,21,0,0,7,3
"2011","E00021365","E00021365","Total",139,34,12,22,0,63,25,38,40,36,0,3,1,2
"2011","E00021386","E00021386","Total",120,26,10,16,2,78,28,50,13,13,0,0,0,1
"2011","E00021388","E00021388","Total",141,12,6,6,0,102,33,69,26,26,0,0,0,1
"2011","E00021393","E00021393","Total",147,16,10,6,0,103,37,66,28,23,0,1,4,0
"2011","E00167128","E00167128","Total",95,5,2,3,21,58,12,46,10,10,0,0,0,1
"2011","E00167234","E00167234","Total",116,20,5,15,4,72,23,49,18,16,0,0,2,2
"2011","E00167253","E00167253","Total",139,5,0,5,21,101,6,95,12,11,0,1,0,0
"2011","E00167255","E00167255","Total",119,12,3,9,25,69,2,67,9,8,0,0,1,4
"2011","E00167256","E00167256","Total",126,2,0,2,49,65,1,64,10,9,0,0,1,0
"2011","E00167257","E00167257","Total",166,13,2,11,73,65,7,58,15,13,0,2,0,0
"2011","E00167258","E00167258","Total",95,4,1,3,0,87,7,80,2,2,0,0,0,2
"2011","E00167259","E00167259","Total",75,3,0,3,7,50,6,44,14,14,0,0,0,1
"2011","E00167266","E00167266","Total",164,31,9,22,1,87,42,45,41,39,0,2,0,4
"2011","E00021579","E00021579","Total",106,33,12,21,0,58,44,14,14,14,0,0,0,1
"2011","E00021580","E00021580","Total",124,19,7,12,1,81,60,21,23,20,0,3,0,0
"2011","E00021585","E00021585","Total",149,24,9,15,4,90,47,43,28,27,0,1,0,3
"2011","E00167235","E00167235","Total",141,24,7,17,2,88,62,26,24,22,0,1,1,3
"2011","E00167240","E00167240","Total",138,4,1,3,0,126,18,108,5,4,0,0,1,3
"2011","E00021559","E00021559","Total",157,63,20,43,1,72,50,22,21,21,0,0,0,0
"2011","E00021563","E00021563","Total",124,36,13,23,1,60,21,39,27,24,0,2,1,0
"2011","E00021565","E00021565","Total",89,15,9,6,0,57,43,14,17,16,0,0,1,0
"2011","E00021582","E00021582","Total",98,22,10,12,3,58,17,41,13,13,0,0,0,2
"2011","E00167105","E00167105","Total",132,16,3,13,14,88,13,75,7,5,0,1,1,7
"2011","E00167238","E00167238","Total",137,17,7,10,15,94,45,49,9,7,0,1,1,2
"2011","E00167239","E00167239","Total",80,2,1,1,33,35,3,32,10,9,0,0,1,0
"2011","E00021560","E00021560","Total",157,26,5,21,9,97,44,53,22,20,0,2,0,3
"2011","E00021584","E00021584","Total",113,22,5,17,5,74,25,49,11,10,0,0,1,1
"2011","E00021587","E00021587","Total",128,27,13,14,2,69,62,7,30,30,0,0,0,0
"2011","E00021591","E00021591","Total",127,5,3,2,0,114,96,18,7,5,0,0,2,1
"2011","E00021368","E00021368","Total",140,17,9,8,0,103,29,74,18,15,0,1,2,2
"2011","E00021374","E00021374","Total",126,20,11,9,1,88,29,59,16,14,0,1,1,1
"2011","E00021376","E00021376","Total",129,20,4,16,0,79,36,43,28,27,0,0,1,2
"2011","E00021377","E00021377","Total",219,51,17,34,6,93,34,59,66,61,2,2,1,3
"2011","E00021367","E00021367","Total",133,30,10,20,1,75,16,59,26,20,0,4,2,1
"2011","E00021375","E00021375","Total",135,19,9,10,0,96,23,73,17,17,0,0,0,3
"2011","E00021379","E00021379","Total",130,35,25,10,2,62,24,38,30,29,0,1,0,1
"2011","E00021380","E00021380","Total",117,9,3,6,1,69,21,48,38,36,1,1,0,0
"2011","E00021397","E00021397","Total",171,28,12,16,1,120,29,91,20,20,0,0,0,2
"2011","E00021363","E00021363","Total",141,23,8,15,1,85,33,52,30,29,0,0,1,2
"2011","E00021366","E00021366","Total",141,26,15,11,1,86,35,51,26,25,0,0,1,2
"2011","E00021378","E00021378","Total",177,28,11,17,0,70,22,48,79,78,0,1,0,0
"2011","E00167136","E00167136","Total",57,10,4,6,0,28,7,21,19,19,0,0,0,0
"2011","E00167161","E00167161","Total",99,14,6,8,2,64,17,47,19,19,0,0,0,0
"2011","E00167231","E00167231","Total",99,13,1,12,4,30,8,22,52,51,0,0,1,0
"2011","E00021387","E00021387","Total",225,33,8,25,24,121,39,82,44,39,0,4,1,3
"2011","E00021394","E00021394","Total",137,12,6,6,0,105,35,70,20,18,0,0,2,0
"2011","E00021395","E00021395","Total",119,2,0,2,2,92,27,65,21,20,0,0,1,2
"2011","E00021396","E00021396","Total",147,19,13,6,2,107,51,56,19,16,0,1,2,0
"2011","E00167228","E00167228","Total",115,12,2,10,12,71,11,60,19,17,0,1,1,1
"2011","E00167229","E00167229","Total",123,17,4,13,1,87,27,60,15,15,0,0,0,3
"2011","E00021735","E00021735","Total",138,19,7,12,0,72,21,51,46,44,1,0,1,1
"2011","E00021748","E00021748","Total",200,47,24,23,2,50,45,5,99,97,0,2,0,2
"2011","E00021750","E00021750","Total",119,30,16,14,0,48,44,4,39,39,0,0,0,2
"2011","E00021752","E00021752","Total",138,29,15,14,1,66,62,4,41,41,0,0,0,1
"2011","E00021733","E00021733","Total",250,49,18,31,2,132,10,122,67,51,8,3,5,0
"2011","E00021734","E00021734","Total",208,32,11,21,20,121,53,68,32,29,0,2,1,3
"2011","E00021738","E00021738","Total",112,8,4,4,1,85,5,80,18,16,1,0,1,0
"2011","E00021743","E00021743","Total",141,6,3,3,0,65,15,50,67,66,0,0,1,3
"2011","E00021741","E00021741","Total",124,30,11,19,0,2,0,2,91,88,0,2,1,1
"2011","E00021742","E00021742","Total",211,15,12,3,1,41,16,25,151,150,0,0,1,3
"2011","E00021766","E00021766","Total",107,17,8,9,0,60,6,54,28,27,1,0,0,2
"2011","E00167094","E00167094","Total",130,35,14,21,1,25,2,23,66,65,0,1,0,3
"2011","E00167166","E00167166","Total",182,5,1,4,10,17,2,15,150,146,1,1,2,0
"2011","E00167167","E00167167","Total",131,23,13,10,1,2,0,2,105,102,0,2,1,0
"2011","E00167168","E00167168","Total",148,57,14,43,2,21,2,19,66,65,0,1,0,2
"2011","E00021746","E00021746","Total",143,32,6,26,9,1,0,1,98,96,0,2,0,3
"2011","E00167096","E00167096","Total",66,24,2,22,0,2,1,1,40,39,0,1,0,0
"2011","E00167097","E00167097","Total",133,22,9,13,33,27,13,14,48,47,1,0,0,3
"2011","E00167102","E00167102","Total",130,5,0,5,6,55,24,31,62,62,0,0,0,2
"2011","E00167203","E00167203","Total",129,32,4,28,0,52,7,45,45,40,0,3,2,0
"2011","E00021744","E00021744","Total",244,40,9,31,0,42,12,30,157,156,0,0,1,5
"2011","E00167098","E00167098","Total",76,5,1,4,2,5,1,4,64,64,0,0,0,0
"2011","E00167099","E00167099","Total",73,22,14,8,0,3,1,2,48,45,0,2,1,0
"2011","E00167100","E00167100","Total",226,37,15,22,0,2,0,2,186,181,0,3,2,1
"2011","E00167101","E00167101","Total",148,64,23,41,0,2,0,2,79,77,0,1,1,3
"2011","E00021641","E00021641","Total",135,16,4,12,8,66,12,54,44,42,0,2,0,1
"2011","E00021646","E00021646","Total",155,34,12,22,17,77,31,46,26,24,0,1,1,1
"2011","E00021661","E00021661","Total",207,30,16,14,0,97,43,54,76,69,0,1,6,4
"2011","E00021663","E00021663","Total",138,8,3,5,2,125,29,96,2,2,0,0,0,1
"2011","E00021640","E00021640","Total",149,40,24,16,1,83,24,59,24,21,0,2,1,1
"2011","E00021643","E00021643","Total",91,32,11,21,0,41,29,12,14,12,0,2,0,4
"2011","E00021644","E00021644","Total",138,25,12,13,0,77,16,61,36,33,0,1,2,0
"2011","E00021654","E00021654","Total",144,1,0,1,0,126,8,118,13,13,0,0,0,4
"2011","E00021637","E00021637","Total",174,19,5,14,27,89,26,63,37,34,0,2,1,2
"2011","E00021639","E00021639","Total",93,14,5,9,0,57,27,30,21,20,0,1,0,1
"2011","E00021659","E00021659","Total",136,15,7,8,12,68,5,63,39,38,0,1,0,2
"2011","E00021660","E00021660","Total",117,22,10,12,21,48,45,3,24,24,0,0,0,2
"2011","E00021669","E00021669","Total",133,23,6,17,2,83,50,33,23,23,0,0,0,2
"2011","E00021662","E00021662","Total",179,18,5,13,2,117,23,94,39,38,0,0,1,3
"2011","E00021665","E00021665","Total",149,40,17,23,0,75,67,8,33,28,0,1,4,1
"2011","E00021668","E00021668","Total",248,62,11,51,3,121,43,78,59,58,0,1,0,3
"2011","E00021670","E00021670","Total",123,23,5,18,2,71,23,48,25,25,0,0,0,2
"2011","E00021430","E00021430","Total",125,23,5,18,2,83,80,3,16,16,0,0,0,1
"2011","E00021431","E00021431","Total",125,34,15,19,0,67,61,6,24,23,0,1,0,0
"2011","E00021432","E00021432","Total",159,34,16,18,0,102,95,7,23,22,0,0,1,0
"2011","E00021433","E00021433","Total",243,71,14,57,0,103,68,35,68,67,0,1,0,1
"2011","E00021434","E00021434","Total",127,37,14,23,0,67,64,3,23,23,0,0,0,0
"2011","E00021404","E00021404","Total",143,61,19,42,0,3,3,0,78,73,1,3,1,1
"2011","E00021409","E00021409","Total",142,70,20,50,0,1,0,1,68,64,0,4,0,3
"2011","E00021418","E00021418","Total",118,63,20,43,1,4,4,0,50,44,0,5,1,0
"2011","E00021424","E00021424","Total",105,55,21,34,0,3,2,1,47,44,0,3,0,0
"2011","E00167086","E00167086","Total",140,43,15,28,2,39,27,12,56,55,0,1,0,0
"2011","E00167087","E00167087","Total",144,41,6,35,5,9,4,5,89,89,0,0,0,0
"2011","E00167154","E00167154","Total",110,41,16,25,0,3,0,3,65,63,0,1,1,1
"2011","E00167155","E00167155","Total",144,39,11,28,3,11,0,11,89,83,2,2,2,2
"2011","E00021408","E00021408","Total",171,57,13,44,14,20,7,13,78,78,0,0,0,2
"2011","E00021413","E00021413","Total",141,21,4,17,12,85,49,36,20,19,0,0,1,3
"2011","E00021421","E00021421","Total",195,26,8,18,7,124,53,71,38,34,0,1,3,0
"2011","E00021423","E00021423","Total",140,22,6,16,0,81,70,11,36,33,0,3,0,1
"2011","E00021399","E00021399","Total",175,87,49,38,0,33,31,2,48,45,1,1,1,7
"2011","E00021411","E00021411","Total",153,42,16,26,0,89,85,4,20,18,1,1,0,2
"2011","E00021420","E00021420","Total",128,47,19,28,1,55,36,19,23,23,0,0,0,2
"2011","E00021425","E00021425","Total",133,67,29,38,1,1,0,1,60,60,0,0,0,4
"2011","E00021427","E00021427","Total",124,52,20,32,1,1,1,0,68,63,1,4,0,2
"2011","E00021428","E00021428","Total",140,19,7,12,0,91,38,53,28,26,0,1,1,2
"2011","E00021429","E00021429","Total",60,12,3,9,11,24,3,21,13,12,0,0,1,0
"2011","E00021437","E00021437","Total",118,17,8,9,2,76,32,44,23,21,0,0,2,0
"2011","E00167085","E00167085","Total",126,30,12,18,0,43,18,25,52,49,0,2,1,1
"2011","E00167156","E00167156","Total",120,11,4,7,0,71,36,35,36,35,0,1,0,2
"2011","E00167219","E00167219","Total",95,4,0,4,1,78,24,54,11,10,0,0,1,1
"2011","E00167227","E00167227","Total",134,37,5,32,2,46,18,28,49,47,0,1,1,0
"2011","E00167230","E00167230","Total",118,24,3,21,10,9,5,4,75,75,0,0,0,0
"2011","E00167232","E00167232","Total",109,30,6,24,10,13,4,9,54,49,0,5,0,2
"2011","E00167233","E00167233","Total",87,13,6,7,29,37,8,29,8,8,0,0,0,0
"2011","E00021402","E00021402","Total",119,22,5,17,0,68,26,42,27,26,0,0,1,2
"2011","E00021405","E00021405","Total",132,57,32,25,0,38,17,21,37,33,1,2,1,0
"2011","E00021406","E00021406","Total",146,20,8,12,1,96,45,51,27,25,1,1,0,2
"2011","E00021407","E00021407","Total",193,22,8,14,2,147,60,87,19,18,0,1,0,3
"2011","E00021412","E00021412","Total",136,27,15,12,1,96,69,27,10,10,0,0,0,2
"2011","E00021438","E00021438","Total",103,27,14,13,1,54,22,32,19,17,0,1,1,2
"2011","E00021398","E00021398","Total",175,37,6,31,3,89,48,41,46,42,0,2,2,0
"2011","E00021414","E00021414","Total",107,27,4,23,0,56,52,4,23,23,0,0,0,1
"2011","E00021416","E00021416","Total",123,32,13,19,0,61,57,4,28,25,0,2,1,2
"2011","E00021417","E00021417","Total",119,26,10,16,0,61,58,3,30,29,0,1,0,2
"2011","E00021422","E00021422","Total",87,6,2,4,0,61,19,42,15,12,0,1,2,5
"2011","E00021400","E00021400","Total",137,34,16,18,0,42,28,14,59,57,0,1,1,2
"2011","E00021410","E00021410","Total",112,32,5,27,0,48,33,15,30,28,0,1,1,2
"2011","E00021415","E00021415","Total",125,26,9,17,2,75,67,8,22,21,0,1,0,0
"2011","E00021419","E00021419","Total",135,10,5,5,0,80,73,7,44,42,0,1,1,1
"2011","E00021426","E00021426","Total",109,12,7,5,0,73,29,44,21,19,0,2,0,3
"2011","E00021649","E00021649","Total",127,32,10,22,0,67,63,4,26,24,0,2,0,2
"2011","E00021650","E00021650","Total",105,36,7,29,0,29,4,25,37,34,0,3,0,3
"2011","E00021655","E00021655","Total",80,17,6,11,0,44,40,4,18,16,0,0,2,1
"2011","E00021671","E00021671","Total",101,32,8,24,1,49,42,7,16,15,0,1,0,3
"2011","E00021653","E00021653","Total",175,28,8,20,2,105,89,16,38,37,0,1,0,2
"2011","E00021667","E00021667","Total",142,31,4,27,1,70,62,8,36,34,0,2,0,4
"2011","E00167222","E00167222","Total",89,22,5,17,2,34,31,3,29,29,0,0,0,2
"2011","E00167225","E00167225","Total",101,4,1,3,13,74,8,66,10,9,0,0,1,0
"2011","E00167226","E00167226","Total",130,19,5,14,55,28,1,27,28,27,0,1,0,0
"2011","E00021642","E00021642","Total",127,33,15,18,0,61,47,14,31,30,0,1,0,2
"2011","E00021648","E00021648","Total",102,41,12,29,11,2,0,2,46,41,0,5,0,2
"2011","E00021652","E00021652","Total",148,73,24,49,1,3,3,0,67,63,1,3,0,4
"2011","E00021656","E00021656","Total",159,48,25,23,2,48,16,32,54,49,0,1,4,7
"2011","E00167221","E00167221","Total",157,31,9,22,2,86,65,21,34,34,0,0,0,4
"2011","E00167223","E00167223","Total",133,4,2,2,25,99,4,95,5,5,0,0,0,0
"2011","E00167224","E00167224","Total",141,3,1,2,12,112,8,104,13,13,0,0,0,1
"2011","E00021658","E00021658","Total",93,54,19,35,0,2,0,2,36,33,0,2,1,1
"2011","E00167103","E00167103","Total",126,35,8,27,0,1,1,0,88,85,0,3,0,2
"2011","E00167106","E00167106","Total",161,71,22,49,6,12,0,12,69,66,0,3,0,3
"2011","E00167107","E00167107","Total",120,24,4,20,6,36,3,33,53,52,0,0,1,1
"2011","E00167236","E00167236","Total",94,13,3,10,0,1,1,0,80,77,0,1,2,0
"2011","E00167237","E00167237","Total",102,45,13,32,0,2,0,2,55,55,0,0,0,0
"2011","E00021651","E00021651","Total",139,57,22,35,0,3,0,3,76,75,0,1,0,3
"2011","E00021657","E00021657","Total",112,54,17,37,0,3,2,1,52,49,0,2,1,3
"2011","E00021666","E00021666","Total",221,41,12,29,0,88,21,67,88,83,2,3,0,4
"2011","E00167104","E00167104","Total",121,58,18,40,1,3,0,3,59,57,0,2,0,0
"2011","E00021598","E00021598","Total",115,59,25,34,1,3,1,2,50,46,2,2,0,2
"2011","E00021599","E00021599","Total",162,82,27,55,5,8,1,7,65,60,1,4,0,2
"2011","E00021600","E00021600","Total",164,89,39,50,3,6,2,4,62,60,0,1,1,4
"2011","E00021602","E00021602","Total",124,46,16,30,0,22,19,3,54,53,0,1,0,2
"2011","E00021622","E00021622","Total",134,60,22,38,0,4,2,2,68,67,0,1,0,2
"2011","E00021632","E00021632","Total",119,61,24,37,0,5,5,0,52,50,0,2,0,1
"2011","E00021595","E00021595","Total",134,35,15,20,0,72,43,29,26,24,0,2,0,1
"2011","E00021617","E00021617","Total",109,46,21,25,0,1,1,0,58,54,0,4,0,4
"2011","E00021620","E00021620","Total",125,28,11,17,10,47,20,27,39,37,0,2,0,1
"2011","E00021623","E00021623","Total",91,1,0,1,0,79,12,67,11,9,0,0,2,0
"2011","E00021624","E00021624","Total",171,67,31,36,33,6,2,4,64,63,0,1,0,1
"2011","E00021625","E00021625","Total",247,115,38,77,1,16,2,14,113,107,1,5,0,2
"2011","E00021616","E00021616","Total",122,25,6,19,1,61,17,44,33,32,0,0,1,2
"2011","E00021618","E00021618","Total",95,6,2,4,1,70,24,46,17,15,0,1,1,1
"2011","E00021619","E00021619","Total",162,43,23,20,0,81,23,58,32,28,0,0,4,6
"2011","E00021621","E00021621","Total",121,17,9,8,0,79,11,68,24,22,0,1,1,1
"2011","E00021597","E00021597","Total",121,39,8,31,0,63,56,7,17,17,0,0,0,2
"2011","E00021607","E00021607","Total",119,22,8,14,0,79,76,3,16,14,0,2,0,2
"2011","E00021627","E00021627","Total",201,52,14,38,5,27,15,12,116,108,0,8,0,1
"2011","E00021630","E00021630","Total",129,39,15,24,0,59,54,5,28,27,0,1,0,3
"2011","E00021636","E00021636","Total",114,20,10,10,4,65,34,31,24,23,0,1,0,1
"2011","E00021604","E00021604","Total",154,46,13,33,1,65,63,2,39,36,0,3,0,3
"2011","E00021606","E00021606","Total",175,91,53,38,1,7,6,1,74,71,1,2,0,2
"2011","E00021610","E00021610","Total",152,59,17,42,1,50,48,2,39,37,0,1,1,3
"2011","E00021612","E00021612","Total",139,74,32,42,0,2,0,2,63,60,1,1,1,0
"2011","E00021613","E00021613","Total",125,61,26,35,0,1,0,1,58,58,0,0,0,5
"2011","E00021614","E00021614","Total",160,79,24,55,0,0,0,0,80,77,1,1,1,1
"2011","E00021615","E00021615","Total",146,59,18,41,26,2,2,0,58,56,0,1,1,1
"2011","E00021605","E00021605","Total",157,80,40,40,0,17,16,1,57,53,0,4,0,3
"2011","E00021608","E00021608","Total",116,50,25,25,0,30,10,20,36,35,1,0,0,0
"2011","E00021611","E00021611","Total",155,47,13,34,1,47,7,40,59,56,0,3,0,1
"2011","E00021626","E00021626","Total",212,82,50,32,1,28,25,3,99,96,1,1,1,2
"2011","E00021628","E00021628","Total",108,46,26,20,0,11,1,10,48,22,20,2,4,3
"2011","E00021635","E00021635","Total",117,46,18,28,0,6,6,0,64,61,0,3,0,1
"2011","E00167174","E00167174","Total",134,68,28,40,1,4,4,0,59,58,0,0,1,2
"2011","E00167175","E00167175","Total",134,87,57,30,1,0,0,0,44,39,0,4,1,2
"2011","E00021596","E00021596","Total",164,78,41,37,2,46,45,1,38,34,0,4,0,0
"2011","E00021601","E00021601","Total",118,72,35,37,1,1,1,0,42,40,0,0,2,2
"2011","E00021603","E00021603","Total",108,53,13,40,1,2,2,0,50,49,0,1,0,2
"2011","E00021629","E00021629","Total",125,48,18,30,0,19,1,18,53,52,0,1,0,5
"2011","E00021631","E00021631","Total",144,70,21,49,1,1,1,0,71,66,0,5,0,1
"2011","E00021633","E00021633","Total",114,69,34,35,1,1,0,1,41,40,0,1,0,2
"2011","E00021634","E00021634","Total",136,65,13,52,1,19,8,11,51,50,0,1,0,0
"2011","E00021224","E00021224","Total",168,59,28,31,1,42,13,29,64,60,0,3,1,2
"2011","E00021245","E00021245","Total",113,40,17,23,1,46,10,36,25,25,0,0,0,1
"2011","E00021251","E00021251","Total",114,34,15,19,0,49,9,40,28,27,0,0,1,3
"2011","E00167108","E00167108","Total",165,43,19,24,10,76,10,66,34,31,0,2,1,2
"2011","E00167109","E00167109","Total",124,28,11,17,0,27,4,23,67,64,1,2,0,2
"2011","E00167110","E00167110","Total",124,36,14,22,0,29,10,19,55,54,1,0,0,4
"2011","E00167111","E00167111","Total",149,22,9,13,3,2,0,2,122,120,0,0,2,0
"2011","E00167153","E00167153","Total",129,14,8,6,1,67,13,54,42,40,1,1,0,5
"2011","E00167170","E00167170","Total",82,39,13,26,0,3,2,1,39,39,0,0,0,1
"2011","E00021235","E00021235","Total",105,13,2,11,0,86,83,3,5,5,0,0,0,1
"2011","E00021236","E00021236","Total",132,25,6,19,1,64,57,7,40,39,0,0,1,2
"2011","E00167143","E00167143","Total",114,22,15,7,3,58,49,9,31,30,0,1,0,0
"2011","E00167144","E00167144","Total",120,13,8,5,1,92,79,13,14,12,0,1,1,0
"2011","E00167150","E00167150","Total",209,37,6,31,15,38,4,34,118,114,0,2,2,1
"2011","E00167180","E00167180","Total",120,9,3,6,31,65,8,57,14,12,0,1,1,1
"2011","E00167181","E00167181","Total",51,10,2,8,2,15,10,5,24,24,0,0,0,0
"2011","E00021223","E00021223","Total",195,56,9,47,0,30,0,30,107,100,2,3,2,2
"2011","E00021240","E00021240","Total",162,54,14,40,0,21,3,18,83,81,0,2,0,4
"2011","E00021241","E00021241","Total",116,63,15,48,0,5,2,3,47,46,0,0,1,1
"2011","E00021243","E00021243","Total",147,16,1,15,0,80,32,48,50,48,0,1,1,1
"2011","E00021246","E00021246","Total",182,30,12,18,33,84,22,62,30,29,0,0,1,5
"2011","E00167120","E00167120","Total",139,14,4,10,11,48,12,36,62,59,1,2,0,4
"2011","E00167139","E00167139","Total",212,28,13,15,1,8,2,6,175,172,1,2,0,0
"2011","E00167146","E00167146","Total",161,55,12,43,1,8,4,4,94,87,0,6,1,3
"2011","E00167148","E00167148","Total",119,18,8,10,0,1,0,1,99,98,0,1,0,1
"2011","E00167123","E00167123","Total",116,11,3,8,15,79,5,74,10,10,0,0,0,1
"2011","E00167124","E00167124","Total",137,15,2,13,41,63,4,59,18,15,0,2,1,0
"2011","E00167125","E00167125","Total",92,29,7,22,1,8,0,8,53,52,0,1,0,1
"2011","E00167141","E00167141","Total",169,64,16,48,0,4,0,4,101,101,0,0,0,0
"2011","E00167126","E00167126","Total",177,50,12,38,0,7,3,4,118,115,0,2,1,2
"2011","E00167127","E00167127","Total",122,43,15,28,0,8,4,4,68,64,1,2,1,3
"2011","E00167138","E00167138","Total",134,19,5,14,8,37,1,36,68,68,0,0,0,2
"2011","E00167140","E00167140","Total",131,9,3,6,8,34,8,26,78,76,0,2,0,2
"2011","E00167137","E00167137","Total",135,31,12,19,3,4,1,3,96,95,0,0,1,1
"2011","E00167147","E00167147","Total",109,4,2,2,6,66,3,63,32,30,0,1,1,1
"2011","E00167149","E00167149","Total",82,12,0,12,6,16,0,16,47,45,0,2,0,1
"2011","E00167151","E00167151","Total",239,42,17,25,3,7,1,6,184,180,0,4,0,3
"2011","E00021238","E00021238","Total",181,71,30,41,0,5,0,5,102,101,0,1,0,3
"2011","E00021239","E00021239","Total",147,53,23,30,0,2,0,2,88,84,0,3,1,4
"2011","E00167142","E00167142","Total",216,92,34,58,3,6,3,3,114,111,0,2,1,1
"2011","E00167145","E00167145","Total",103,22,7,15,0,7,0,7,71,65,0,1,5,3
"2011","E00021244","E00021244","Total",148,10,2,8,1,128,19,109,8,7,0,1,0,1
"2011","E00021247","E00021247","Total",115,16,5,11,2,75,25,50,22,20,0,1,1,0
"2011","E00021248","E00021248","Total",136,14,5,9,0,102,26,76,20,18,0,0,2,0
"2011","E00021249","E00021249","Total",122,5,3,2,2,107,9,98,6,6,0,0,0,2
"2011","E00021253","E00021253","Total",144,19,3,16,0,90,31,59,33,30,0,2,1,2
"2011","E00021225","E00021225","Total",152,23,8,15,0,81,9,72,46,44,1,0,1,2
"2011","E00021252","E00021252","Total",126,52,24,28,0,1,0,1,69,66,0,3,0,4
"2011","E00021254","E00021254","Total",109,43,8,35,0,3,0,3,62,59,0,2,1,1
"2011","E00021255","E00021255","Total",109,58,12,46,2,3,0,3,46,45,0,0,1,0
"2011","E00021256","E00021256","Total",107,39,8,31,1,2,0,2,65,63,0,2,0,0
"2011","E00021258","E00021258","Total",134,32,13,19,1,80,21,59,21,20,0,0,1,0
"2011","E00021219","E00021219","Total",107,50,22,28,1,40,9,31,16,14,0,1,1,0
"2011","E00021220","E00021220","Total",181,67,13,54,2,25,2,23,86,80,0,6,0,1
"2011","E00021227","E00021227","Total",118,51,23,28,1,31,6,25,35,35,0,0,0,0
"2011","E00021228","E00021228","Total",135,57,28,29,1,43,17,26,30,29,0,1,0,4
"2011","E00021229","E00021229","Total",116,15,2,13,0,72,17,55,18,17,0,1,0,11
"2011","E00021231","E00021231","Total",122,21,9,12,0,82,7,75,18,15,0,2,1,1
"2011","E00021218","E00021218","Total",201,92,29,63,1,25,8,17,78,77,0,1,0,5
"2011","E00021230","E00021230","Total",128,65,29,36,0,27,5,22,34,32,0,1,1,2
"2011","E00021257","E00021257","Total",102,51,19,32,9,5,0,5,36,35,0,1,0,1
"2011","E00021259","E00021259","Total",134,38,15,23,1,54,24,30,39,37,0,2,0,2
"2011","E00167081","E00167081","Total",120,58,20,38,0,3,0,3,55,54,0,1,0,4
"2011","E00167262","E00167262","Total",46,24,7,17,0,2,0,2,20,20,0,0,0,0
"2011","E00021522","E00021522","Total",136,13,2,11,1,103,11,92,18,17,0,1,0,1
"2011","E00021524","E00021524","Total",194,35,11,24,1,81,7,74,75,72,0,3,0,2
"2011","E00021531","E00021531","Total",186,41,15,26,0,105,37,68,37,34,0,2,1,3
"2011","E00021532","E00021532","Total",138,62,24,38,0,1,0,1,73,71,0,2,0,2
"2011","E00021519","E00021519","Total",200,73,19,54,5,20,9,11,101,98,0,3,0,1
"2011","E00021521","E00021521","Total",98,42,15,27,1,43,13,30,12,10,1,1,0,0
"2011","E00021528","E00021528","Total",94,39,17,22,2,38,13,25,14,14,0,0,0,1
"2011","E00021535","E00021535","Total",115,46,16,30,13,14,3,11,37,35,0,0,2,5
"2011","E00167079","E00167079","Total",116,14,2,12,1,8,0,8,91,91,0,0,0,2
"2011","E00167080","E00167080","Total",145,43,19,24,11,56,5,51,33,33,0,0,0,2
"2011","E00021533","E00021533","Total",141,70,19,51,1,1,0,1,64,62,0,2,0,5
"2011","E00021534","E00021534","Total",127,50,18,32,1,1,0,1,74,72,0,1,1,1
"2011","E00021536","E00021536","Total",118,53,9,44,0,2,1,1,63,63,0,0,0,0
"2011","E00021537","E00021537","Total",163,76,25,51,0,4,0,4,80,77,0,3,0,3
"2011","E00021538","E00021538","Total",309,136,48,88,2,1,1,0,168,163,0,4,1,2
"2011","E00021539","E00021539","Total",138,46,9,37,0,3,2,1,85,83,0,0,2,4
"2011","E00021517","E00021517","Total",136,33,9,24,1,36,3,33,65,62,0,2,1,1
"2011","E00021520","E00021520","Total",97,35,7,28,1,6,3,3,53,53,0,0,0,2
"2011","E00021525","E00021525","Total",134,44,13,31,0,10,3,7,78,76,1,1,0,2
"2011","E00021527","E00021527","Total",145,51,18,33,0,3,2,1,91,89,0,2,0,0
"2011","E00021556","E00021556","Total",147,57,19,38,0,2,1,1,87,82,0,5,0,1
"2011","E00021557","E00021557","Total",172,63,17,46,0,2,0,2,106,105,0,1,0,1
"2011","E00167118","E00167118","Total",137,41,9,32,0,3,1,2,90,87,0,2,1,3
"2011","E00167119","E00167119","Total",137,49,13,36,2,27,13,14,56,53,1,1,1,3
"2011","E00167134","E00167134","Total",137,74,20,54,0,2,0,2,59,55,0,3,1,2
"2011","E00167162","E00167162","Total",189,38,5,33,0,12,8,4,137,136,0,1,0,2
"2011","E00021516","E00021516","Total",106,26,8,18,0,49,1,48,28,28,0,0,0,3
"2011","E00021518","E00021518","Total",151,29,8,21,0,33,0,33,84,83,0,0,1,5
"2011","E00021526","E00021526","Total",169,60,13,47,0,4,0,4,101,100,0,1,0,4
"2011","E00021529","E00021529","Total",116,11,3,8,1,86,3,83,16,16,0,0,0,2
"2011","E00167163","E00167163","Total",119,36,16,20,14,1,0,1,67,63,0,3,1,1
"2011","E00021552","E00021552","Total",99,28,11,17,0,49,14,35,22,21,0,1,0,0
"2011","E00021553","E00021553","Total",119,11,4,7,0,89,12,77,16,14,0,1,1,3
"2011","E00021554","E00021554","Total",127,35,12,23,16,19,3,16,56,54,0,0,2,1
"2011","E00021555","E00021555","Total",145,18,5,13,0,85,21,64,40,40,0,0,0,2
"2011","E00167133","E00167133","Total",82,25,8,17,0,29,10,19,27,26,0,1,0,1
"2011","E00167135","E00167135","Total",130,52,16,36,1,4,1,3,70,69,0,1,0,3
"2011","E00167183","E00167183","Total",67,38,18,20,0,2,0,2,26,25,0,0,1,1
"2011","E00167112","E00167112","Total",403,86,21,65,1,76,21,55,228,216,8,2,2,12
"2011","E00167117","E00167117","Total",50,21,4,17,1,5,3,2,18,18,0,0,0,5
"2011","E00167131","E00167131","Total",63,3,1,2,0,48,2,46,9,8,0,0,1,3
"2011","E00167164","E00167164","Total",56,8,1,7,12,24,6,18,12,12,0,0,0,0
"2011","E00021547","E00021547","Total",115,29,11,18,0,62,17,45,21,18,0,3,0,3
"2011","E00167114","E00167114","Total",140,26,14,12,0,82,12,70,31,28,0,3,0,1
"2011","E00167132","E00167132","Total",289,37,12,25,14,4,1,3,232,226,0,6,0,2
"2011","E00167115","E00167115","Total",386,56,25,31,17,88,22,66,218,211,3,2,2,7
"2011","E00167130","E00167130","Total",466,148,32,116,25,129,14,115,156,152,0,2,2,8
"2011","E00021550","E00021550","Total",150,18,8,10,2,112,20,92,16,14,0,0,2,2
"2011","E00167116","E00167116","Total",112,26,17,9,0,69,9,60,14,13,0,1,0,3
"2011","E00167129","E00167129","Total",321,50,11,39,5,74,10,64,189,181,1,6,1,3
"2011","E00021510","E00021510","Total",121,46,25,21,0,2,1,1,72,71,0,1,0,1
"2011","E00021511","E00021511","Total",109,37,16,21,0,2,0,2,70,66,2,1,1,0
"2011","E00021541","E00021541","Total",139,38,14,24,0,13,0,13,85,83,0,2,0,3
"2011","E00021542","E00021542","Total",106,40,14,26,1,1,0,1,56,36,18,1,1,8
"2011","E00021543","E00021543","Total",142,57,24,33,0,2,0,2,82,80,0,1,1,1
"2011","E00167158","E00167158","Total",162,40,13,27,0,4,0,4,117,116,0,0,1,1
"2011","E00167159","E00167159","Total",119,51,24,27,0,2,0,2,65,64,0,0,1,1
"2011","E00167113","E00167113","Total",165,14,4,10,28,87,16,71,34,31,1,0,2,2
"2011","E00167121","E00167121","Total",139,40,16,24,0,9,1,8,89,84,4,1,0,1
"2011","E00167122","E00167122","Total",125,32,20,12,0,16,2,14,76,74,1,0,1,1
"2011","E00167152","E00167152","Total",117,25,15,10,5,3,0,3,84,83,0,1,0,0
"2011","E00021544","E00021544","Total",83,47,14,33,0,3,0,3,33,31,0,1,1,0
"2011","E00021546","E00021546","Total",102,42,15,27,0,0,0,0,58,57,1,0,0,2
"2011","E00021549","E00021549","Total",128,26,11,15,2,70,13,57,28,28,0,0,0,2
"2011","E00167157","E00167157","Total",190,46,14,32,0,1,0,1,141,137,0,4,0,2
"2011","E00167165","E00167165","Total",133,48,16,32,3,1,1,0,79,77,1,1,0,2
"2011","E00167220","E00167220","Total",135,39,16,23,6,3,0,3,86,84,0,0,2,1
"2011","E00167160","E00167160","Total",118,19,8,11,5,55,4,51,37,36,0,1,0,2
"2011","E00167182","E00167182","Total",66,8,1,7,8,40,3,37,9,8,0,0,1,1
"2011","E00167248","E00167248","Total",256,42,9,33,30,14,8,6,166,165,0,1,0,4
"2011","E00167249","E00167249","Total",234,38,16,22,4,10,1,9,178,177,0,0,1,4
"2011","E00167250","E00167250","Total",102,4,2,2,2,80,9,71,13,13,0,0,0,3
"2011","E00022952","E00022952","Total",120,80,39,41,2,3,2,1,33,31,1,1,0,2
"2011","E00022958","E00022958","Total",131,37,12,25,1,36,36,0,53,51,0,2,0,4
"2011","E00022959","E00022959","Total",130,27,9,18,0,56,49,7,47,44,0,2,1,0
"2011","E00022992","E00022992","Total",233,102,39,63,17,6,5,1,101,95,0,6,0,7
"2011","E00022995","E00022995","Total",124,54,16,38,1,19,2,17,49,46,1,2,0,1
"2011","E00022998","E00022998","Total",125,77,33,44,0,7,7,0,40,36,1,3,0,1
"2011","E00022999","E00022999","Total",96,65,42,23,0,5,4,1,26,23,0,3,0,0
"2011","E00022977","E00022977","Total",150,84,48,36,0,3,0,3,60,57,0,2,1,3
"2011","E00022978","E00022978","Total",148,67,36,31,0,13,7,6,65,63,0,1,1,3
"2011","E00022979","E00022979","Total",121,23,9,14,1,63,9,54,33,33,0,0,0,1
"2011","E00022983","E00022983","Total",140,83,42,41,1,6,4,2,47,45,0,2,0,3
"2011","E00022984","E00022984","Total",138,69,37,32,0,4,3,1,62,60,0,1,1,3
"2011","E00022987","E00022987","Total",124,65,31,34,0,3,2,1,54,52,0,1,1,2
"2011","E00023052","E00023052","Total",122,85,45,40,0,2,1,1,30,27,0,2,1,5
"2011","E00023055","E00023055","Total",150,95,56,39,2,2,1,1,47,45,0,2,0,4
"2011","E00023057","E00023057","Total",139,70,27,43,0,23,22,1,44,43,0,1,0,2
"2011","E00023060","E00023060","Total",153,86,49,37,1,14,13,1,48,42,0,6,0,4
"2011","E00023068","E00023068","Total",131,60,21,39,0,35,35,0,36,33,0,3,0,0
"2011","E00170942","E00170942","Total",126,74,54,20,0,1,1,0,43,34,0,5,4,8
"2011","E00171061","E00171061","Total",155,82,47,35,2,1,1,0,66,61,0,3,2,4
"2011","E00023047","E00023047","Total",127,75,39,36,1,17,17,0,34,34,0,0,0,0
"2011","E00023053","E00023053","Total",128,78,53,25,1,2,2,0,46,43,0,2,1,1
"2011","E00023054","E00023054","Total",168,97,62,35,23,1,1,0,41,40,0,1,0,6
"2011","E00023056","E00023056","Total",149,35,15,20,0,71,70,1,40,40,0,0,0,3
"2011","E00023059","E00023059","Total",141,84,40,44,0,8,7,1,47,46,1,0,0,2
"2011","E00023061","E00023061","Total",163,76,40,36,0,35,35,0,48,43,0,5,0,4
"2011","E00022954","E00022954","Total",93,31,11,20,1,38,32,6,22,21,0,0,1,1
"2011","E00022974","E00022974","Total",187,82,50,32,2,29,14,15,70,65,0,4,1,4
"2011","E00022990","E00022990","Total",105,25,10,15,1,63,43,20,15,14,0,1,0,1
"2011","E00022991","E00022991","Total",118,15,6,9,1,88,72,16,14,13,0,0,1,0
"2011","E00022996","E00022996","Total",126,17,1,16,0,92,78,14,17,17,0,0,0,0
"2011","E00022997","E00022997","Total",125,31,8,23,1,64,56,8,28,26,0,2,0,1
"2011","E00022953","E00022953","Total",123,23,6,17,2,45,43,2,51,48,0,1,2,2
"2011","E00022955","E00022955","Total",127,32,2,30,0,60,58,2,35,27,1,6,1,0
"2011","E00022957","E00022957","Total",146,16,10,6,0,88,86,2,39,35,0,2,2,3
"2011","E00023000","E00023000","Total",165,33,9,24,1,82,80,2,45,44,0,1,0,4
"2011","E00170960","E00170960","Total",122,27,10,17,2,76,72,4,17,17,0,0,0,0
"2011","E00171063","E00171063","Total",196,45,16,29,41,18,7,11,92,89,0,3,0,0
"2011","E00022956","E00022956","Total",130,53,16,37,0,30,3,27,47,46,0,1,0,0
"2011","E00022960","E00022960","Total",136,43,8,35,1,17,4,13,74,70,0,4,0,1
"2011","E00022962","E00022962","Total",135,43,20,23,0,65,2,63,27,24,0,2,1,0
"2011","E00022963","E00022963","Total",129,66,18,48,1,30,19,11,32,32,0,0,0,0
"2011","E00022964","E00022964","Total",152,45,11,34,1,70,2,68,35,33,0,2,0,1
"2011","E00022966","E00022966","Total",138,49,30,19,1,42,28,14,44,42,0,2,0,2
"2011","E00022976","E00022976","Total",158,30,16,14,30,80,72,8,17,17,0,0,0,1
"2011","E00022980","E00022980","Total",119,20,7,13,0,79,65,14,17,16,0,1,0,3
"2011","E00022985","E00022985","Total",116,17,3,14,2,88,72,16,8,7,0,1,0,1
"2011","E00022988","E00022988","Total",104,12,5,7,1,75,64,11,16,16,0,0,0,0
"2011","E00022993","E00022993","Total",113,16,4,12,0,82,60,22,13,13,0,0,0,2
"2011","E00171046","E00171046","Total",119,31,7,24,1,61,60,1,25,25,0,0,0,1
"2011","E00171066","E00171066","Total",87,7,3,4,35,37,22,15,8,8,0,0,0,0
"2011","E00171068","E00171068","Total",166,45,16,29,2,4,0,4,113,110,0,3,0,2
"2011","E00170943","E00170943","Total",139,45,19,26,3,17,13,4,72,67,0,5,0,2
"2011","E00171043","E00171043","Total",139,50,23,27,0,6,5,1,80,79,0,0,1,3
"2011","E00171044","E00171044","Total",117,35,10,25,5,5,5,0,71,70,0,0,1,1
"2011","E00171047","E00171047","Total",156,44,16,28,65,13,7,6,34,31,0,3,0,0
"2011","E00171080","E00171080","Total",78,32,25,7,0,3,3,0,43,38,1,4,0,0
"2011","E00022975","E00022975","Total",127,43,14,29,0,18,1,17,64,58,1,5,0,2
"2011","E00022982","E00022982","Total",123,23,2,21,0,71,71,0,27,27,0,0,0,2
"2011","E00022989","E00022989","Total",140,11,4,7,1,123,122,1,5,5,0,0,0,0
"2011","E00022994","E00022994","Total",115,46,22,24,0,12,12,0,54,51,0,2,1,3
"2011","E00170946","E00170946","Total",107,21,8,13,2,21,7,14,60,57,0,1,2,3
"2011","E00022972","E00022972","Total",132,23,12,11,1,78,51,27,28,26,0,2,0,2
"2011","E00022981","E00022981","Total",119,32,7,25,1,54,50,4,31,29,0,2,0,1
"2011","E00170968","E00170968","Total",142,43,29,14,1,13,10,3,83,79,1,2,1,2
"2011","E00171041","E00171041","Total",226,47,15,32,85,9,1,8,80,78,0,2,0,5
"2011","E00022812","E00022812","Total",155,47,20,27,1,84,66,18,21,17,0,4,0,2
"2011","E00022844","E00022844","Total",100,14,6,8,0,63,55,8,23,22,0,0,1,0
"2011","E00022846","E00022846","Total",92,18,3,15,0,67,63,4,7,7,0,0,0,0
"2011","E00022847","E00022847","Total",94,16,7,9,2,62,56,6,14,13,0,1,0,0
"2011","E00022848","E00022848","Total",128,18,9,9,0,100,90,10,10,10,0,0,0,0
"2011","E00022852","E00022852","Total",86,28,14,14,0,40,34,6,15,15,0,0,0,3
"2011","E00022855","E00022855","Total",145,24,4,20,1,98,97,1,21,20,0,0,1,1
"2011","E00022845","E00022845","Total",106,52,24,28,1,9,7,2,44,42,0,2,0,0
"2011","E00022849","E00022849","Total",198,59,19,40,6,104,103,1,25,23,0,1,1,4
"2011","E00022850","E00022850","Total",112,56,31,25,1,25,4,21,28,26,0,2,0,2
"2011","E00022851","E00022851","Total",130,54,20,34,0,57,54,3,19,16,0,1,2,0
"2011","E00022853","E00022853","Total",186,56,19,37,1,64,55,9,64,63,0,0,1,1
"2011","E00022854","E00022854","Total",139,52,15,37,1,63,62,1,23,19,0,4,0,0
"2011","E00022856","E00022856","Total",131,47,16,31,3,64,63,1,15,13,0,2,0,2
"2011","E00023044","E00023044","Total",127,50,19,31,1,36,31,5,38,30,0,8,0,2
"2011","E00023048","E00023048","Total",151,52,24,28,0,51,10,41,48,45,0,3,0,0
"2011","E00023065","E00023065","Total",143,49,25,24,1,45,39,6,47,46,1,0,0,1
"2011","E00023066","E00023066","Total",194,95,49,46,12,29,26,3,55,54,0,1,0,3
"2011","E00023074","E00023074","Total",176,67,34,33,2,15,10,5,89,87,0,2,0,3
"2011","E00023076","E00023076","Total",116,56,28,28,0,12,6,6,45,45,0,0,0,3
"2011","E00023058","E00023058","Total",146,11,3,8,1,105,105,0,27,25,0,1,1,2
"2011","E00023062","E00023062","Total",123,17,6,11,0,87,85,2,18,18,0,0,0,1
"2011","E00023064","E00023064","Total",141,26,9,17,0,95,95,0,18,17,0,1,0,2
"2011","E00023069","E00023069","Total",155,22,12,10,1,114,114,0,17,17,0,0,0,1
"2011","E00023070","E00023070","Total",138,18,9,9,0,104,102,2,14,13,0,1,0,2
"2011","E00023073","E00023073","Total",143,92,51,41,0,24,4,20,24,24,0,0,0,3
"2011","E00023075","E00023075","Total",116,87,44,43,0,9,0,9,17,15,0,2,0,3
"2011","E00023081","E00023081","Total",108,44,14,30,1,39,9,30,23,23,0,0,0,1
"2011","E00023083","E00023083","Total",121,43,15,28,0,58,3,55,20,17,0,3,0,0
"2011","E00023086","E00023086","Total",111,20,4,16,1,65,4,61,25,24,0,1,0,0
"2011","E00023089","E00023089","Total",145,53,18,35,0,37,3,34,54,52,0,2,0,1
"2011","E00023045","E00023045","Total",165,56,12,44,1,27,24,3,76,71,0,3,2,5
"2011","E00023079","E00023079","Total",122,59,22,37,0,17,6,11,46,40,2,3,1,0
"2011","E00023080","E00023080","Total",124,52,15,37,0,10,9,1,62,57,0,5,0,0
"2011","E00023082","E00023082","Total",145,60,17,43,0,21,14,7,63,59,1,3,0,1
"2011","E00023087","E00023087","Total",120,35,16,19,6,52,50,2,27,25,0,1,1,0
"2011","E00023088","E00023088","Total",108,46,17,29,1,19,14,5,39,35,0,4,0,3
"2011","E00023091","E00023091","Total",108,28,7,21,1,3,0,3,76,70,1,4,1,0
"2011","E00023063","E00023063","Total",140,59,23,36,2,18,16,2,58,56,0,2,0,3
"2011","E00023067","E00023067","Total",160,71,30,41,4,23,18,5,61,59,0,1,1,1
"2011","E00023071","E00023071","Total",137,42,21,21,1,43,41,2,50,44,1,4,1,1
"2011","E00023072","E00023072","Total",168,87,51,36,8,44,1,43,28,26,0,2,0,1
"2011","E00023077","E00023077","Total",140,69,34,35,3,0,0,0,65,60,0,5,0,3
"2011","E00023084","E00023084","Total",147,54,14,40,0,36,27,9,55,54,0,0,1,2
"2011","E00023046","E00023046","Total",93,25,9,16,1,45,43,2,19,19,0,0,0,3
"2011","E00023078","E00023078","Total",142,72,31,41,2,2,0,2,66,62,1,3,0,0
"2011","E00170945","E00170945","Total",122,30,15,15,4,61,33,28,25,23,0,1,1,2
"2011","E00171079","E00171079","Total",99,20,10,10,45,10,2,8,23,23,0,0,0,1
"2011","E00170949","E00170949","Total",134,70,24,46,0,3,1,2,58,56,0,1,1,3
"2011","E00171071","E00171071","Total",118,73,36,37,0,4,2,2,39,34,0,5,0,2
"2011","E00171082","E00171082","Total",183,75,37,38,7,5,3,2,95,91,1,2,1,1
"2011","E00171083","E00171083","Total",117,68,24,44,0,3,0,3,44,40,0,3,1,2
"2011","E00171085","E00171085","Total",111,56,25,31,0,0,0,0,54,53,0,1,0,1
"2011","E00023085","E00023085","Total",131,23,4,19,0,93,60,33,14,14,0,0,0,1
"2011","E00171069","E00171069","Total",131,49,27,22,2,2,1,1,76,76,0,0,0,2
"2011","E00171072","E00171072","Total",113,59,13,46,1,2,1,1,50,48,0,2,0,1
"2011","E00171074","E00171074","Total",133,46,16,30,17,4,0,4,64,63,0,1,0,2
"2011","E00171075","E00171075","Total",128,40,15,25,19,4,2,2,65,64,0,1,0,0
"2011","E00022961","E00022961","Total",134,17,7,10,0,86,3,83,30,29,0,1,0,1
"2011","E00022965","E00022965","Total",137,49,12,37,0,39,1,38,48,47,0,1,0,1
"2011","E00022967","E00022967","Total",139,52,17,35,0,44,3,41,43,40,0,2,1,0
"2011","E00022968","E00022968","Total",143,41,11,30,0,29,1,28,72,67,0,5,0,1
"2011","E00022969","E00022969","Total",128,73,26,47,0,12,1,11,43,40,0,3,0,0
"2011","E00022970","E00022970","Total",134,44,17,27,3,41,9,32,43,42,0,1,0,3
"2011","E00023092","E00023092","Total",127,43,21,22,1,57,33,24,23,21,0,2,0,3
"2011","E00023112","E00023112","Total",130,58,20,38,0,39,2,37,32,28,1,2,1,1
"2011","E00023113","E00023113","Total",128,49,19,30,1,55,8,47,23,22,0,1,0,0
"2011","E00023114","E00023114","Total",131,47,20,27,0,64,2,62,20,20,0,0,0,0
"2011","E00023117","E00023117","Total",147,43,13,30,1,62,52,10,40,39,0,1,0,1
"2011","E00023118","E00023118","Total",144,35,20,15,1,84,81,3,22,20,0,1,1,2
"2011","E00023124","E00023124","Total",141,29,10,19,2,90,55,35,19,18,0,1,0,1
"2011","E00023127","E00023127","Total",139,49,16,33,2,60,36,24,24,23,1,0,0,4
"2011","E00023128","E00023128","Total",134,57,23,34,0,14,2,12,62,60,0,1,1,1
"2011","E00023130","E00023130","Total",122,32,9,23,1,44,23,21,44,42,0,2,0,1
"2011","E00023131","E00023131","Total",156,51,16,35,1,22,10,12,81,80,1,0,0,1
"2011","E00023134","E00023134","Total",119,57,14,43,1,33,14,19,28,27,1,0,0,0
"2011","E00023093","E00023093","Total",136,32,17,15,0,78,1,77,23,21,0,1,1,3
"2011","E00023115","E00023115","Total",141,41,13,28,1,81,3,78,17,16,0,1,0,1
"2011","E00023119","E00023119","Total",142,34,1,33,0,76,1,75,31,26,5,0,0,1
"2011","E00023120","E00023120","Total",121,32,9,23,0,65,2,63,22,20,0,1,1,2
"2011","E00023121","E00023121","Total",130,50,23,27,0,62,2,60,17,16,0,0,1,1
"2011","E00023123","E00023123","Total",125,57,14,43,2,40,6,34,24,20,0,3,1,2
"2011","E00023191","E00023191","Total",134,93,39,54,0,7,6,1,33,31,0,2,0,1
"2011","E00023218","E00023218","Total",99,73,37,36,0,3,1,2,23,22,0,1,0,0
"2011","E00023220","E00023220","Total",118,98,46,52,0,1,0,1,17,17,0,0,0,2
"2011","E00023222","E00023222","Total",123,83,32,51,0,1,1,0,39,38,0,1,0,0
"2011","E00023232","E00023232","Total",119,109,53,56,0,1,1,0,4,4,0,0,0,5
"2011","E00023209","E00023209","Total",124,35,18,17,0,55,52,3,32,31,0,1,0,2
"2011","E00023210","E00023210","Total",120,38,16,22,0,50,47,3,31,28,0,3,0,1
"2011","E00023211","E00023211","Total",124,102,65,37,0,3,2,1,19,19,0,0,0,0
"2011","E00023213","E00023213","Total",142,110,64,46,2,8,4,4,20,19,0,1,0,2
"2011","E00023216","E00023216","Total",136,83,36,47,0,12,11,1,41,37,3,1,0,0
"2011","E00023219","E00023219","Total",139,86,45,41,1,28,5,23,23,20,0,3,0,1
"2011","E00023212","E00023212","Total",114,49,16,33,1,4,2,2,59,56,0,2,1,1
"2011","E00023214","E00023214","Total",112,67,33,34,0,3,1,2,41,40,0,1,0,1
"2011","E00023215","E00023215","Total",143,58,30,28,0,4,0,4,77,74,1,1,1,4
"2011","E00023217","E00023217","Total",121,71,28,43,0,3,3,0,47,44,1,2,0,0
"2011","E00023221","E00023221","Total",141,75,25,50,0,4,2,2,61,56,1,4,0,1
"2011","E00023228","E00023228","Total",123,75,28,47,0,5,5,0,43,42,1,0,0,0
"2011","E00023190","E00023190","Total",137,104,55,49,1,2,2,0,28,25,1,2,0,2
"2011","E00023192","E00023192","Total",121,69,34,35,0,8,6,2,39,34,4,1,0,5
"2011","E00023197","E00023197","Total",142,73,38,35,0,11,8,3,55,53,0,2,0,3
"2011","E00023227","E00023227","Total",107,81,43,38,1,2,1,1,22,18,0,4,0,1
"2011","E00023231","E00023231","Total",102,72,29,43,0,2,2,0,28,28,0,0,0,0
"2011","E00023233","E00023233","Total",109,64,29,35,0,1,1,0,43,42,1,0,0,1
"2011","E00023189","E00023189","Total",158,88,52,36,0,7,3,4,62,57,1,3,1,1
"2011","E00023223","E00023223","Total",122,53,22,31,0,23,21,2,45,44,0,1,0,1
"2011","E00023224","E00023224","Total",140,56,27,29,0,42,28,14,42,37,0,5,0,0
"2011","E00023225","E00023225","Total",108,73,37,36,0,12,12,0,20,19,0,1,0,3
"2011","E00023226","E00023226","Total",130,49,27,22,0,35,7,28,45,39,0,4,2,1
"2011","E00023229","E00023229","Total",127,54,27,27,0,38,9,29,33,31,0,2,0,2
"2011","E00022824","E00022824","Total",131,8,4,4,0,106,105,1,13,12,0,1,0,4
"2011","E00022826","E00022826","Total",129,8,2,6,0,102,101,1,19,16,0,2,1,0
"2011","E00022827","E00022827","Total",144,24,11,13,2,95,86,9,21,21,0,0,0,2
"2011","E00022830","E00022830","Total",162,32,12,20,1,95,93,2,33,33,0,0,0,1
"2011","E00022833","E00022833","Total",165,26,7,19,9,118,117,1,12,11,1,0,0,0
"2011","E00022831","E00022831","Total",113,25,10,15,0,64,64,0,23,22,0,1,0,1
"2011","E00022834","E00022834","Total",148,20,8,12,1,105,102,3,20,19,1,0,0,2
"2011","E00022835","E00022835","Total",115,36,12,24,1,49,45,4,29,29,0,0,0,0
"2011","E00022836","E00022836","Total",139,30,16,14,0,81,74,7,26,25,0,0,1,2
"2011","E00022838","E00022838","Total",133,25,9,16,0,89,87,2,17,17,0,0,0,2
"2011","E00022840","E00022840","Total",151,38,11,27,0,89,55,34,24,24,0,0,0,0
"2011","E00022839","E00022839","Total",152,34,12,22,1,82,82,0,33,33,0,0,0,2
"2011","E00022841","E00022841","Total",133,35,19,16,2,71,65,6,25,25,0,0,0,0
"2011","E00022842","E00022842","Total",199,85,33,52,23,38,35,3,52,52,0,0,0,1
"2011","E00022843","E00022843","Total",156,38,14,24,0,86,82,4,32,30,0,2,0,0
"2011","E00170948","E00170948","Total",131,16,3,13,0,94,49,45,19,18,0,1,0,2
"2011","E00171077","E00171077","Total",138,40,5,35,55,6,3,3,37,34,0,3,0,0
"2011","E00022815","E00022815","Total",154,52,20,32,1,75,72,3,24,23,0,1,0,2
"2011","E00022816","E00022816","Total",92,26,9,17,0,53,53,0,13,12,0,1,0,0
"2011","E00022817","E00022817","Total",147,37,9,28,0,78,74,4,30,26,0,4,0,2
"2011","E00022818","E00022818","Total",128,9,4,5,4,103,62,41,12,12,0,0,0,0
"2011","E00022820","E00022820","Total",114,18,14,4,0,80,28,52,15,14,0,0,1,1
"2011","E00022822","E00022822","Total",127,33,12,21,0,72,62,10,22,21,0,0,1,0
"2011","E00022813","E00022813","Total",188,68,28,40,1,34,23,11,85,84,0,1,0,0
"2011","E00022814","E00022814","Total",152,97,43,54,0,16,3,13,37,36,0,1,0,2
"2011","E00022819","E00022819","Total",155,86,32,54,0,14,2,12,51,47,0,4,0,4
"2011","E00022857","E00022857","Total",180,88,30,58,0,36,31,5,53,50,1,2,0,3
"2011","E00022858","E00022858","Total",150,93,36,57,2,15,9,6,35,35,0,0,0,5
"2011","E00022821","E00022821","Total",206,48,17,31,0,80,74,6,78,75,2,1,0,0
"2011","E00022823","E00022823","Total",153,25,10,15,0,111,107,4,17,17,0,0,0,0
"2011","E00022825","E00022825","Total",153,43,13,30,2,59,59,0,47,46,0,1,0,2
"2011","E00022828","E00022828","Total",172,48,9,39,2,60,57,3,60,57,0,3,0,2
"2011","E00022829","E00022829","Total",95,29,10,19,0,16,15,1,50,49,0,1,0,0
"2011","E00022832","E00022832","Total",149,56,18,38,1,5,3,2,80,71,0,9,0,7
"2011","E00022914","E00022914","Total",216,100,35,65,1,13,4,9,100,96,0,4,0,2
"2011","E00022916","E00022916","Total",138,54,17,37,2,9,3,6,71,68,0,3,0,2
"2011","E00022919","E00022919","Total",142,54,15,39,1,15,3,12,69,64,1,4,0,3
"2011","E00022921","E00022921","Total",114,45,15,30,2,11,3,8,56,53,0,3,0,0
"2011","E00022922","E00022922","Total",148,56,18,38,1,19,1,18,71,70,0,1,0,1
"2011","E00022924","E00022924","Total",155,36,10,26,0,3,2,1,113,108,3,0,2,3
"2011","E00023116","E00023116","Total",131,58,27,31,0,53,5,48,20,19,0,1,0,0
"2011","E00023122","E00023122","Total",145,76,29,47,0,26,0,26,43,40,2,1,0,0
"2011","E00023125","E00023125","Total",136,82,44,38,0,16,7,9,37,33,1,3,0,1
"2011","E00023126","E00023126","Total",148,88,34,54,1,31,1,30,27,26,0,1,0,1
"2011","E00023129","E00023129","Total",176,51,19,32,1,13,11,2,110,109,0,1,0,1
"2011","E00023132","E00023132","Total",122,48,13,35,1,8,4,4,64,62,0,1,1,1
"2011","E00023096","E00023096","Total",219,58,23,35,1,41,25,16,117,114,0,3,0,2
"2011","E00023098","E00023098","Total",114,69,30,39,0,8,2,6,36,35,0,1,0,1
"2011","E00023100","E00023100","Total",130,69,23,46,0,7,3,4,52,50,0,2,0,2
"2011","E00023107","E00023107","Total",126,68,28,40,0,4,0,4,53,51,0,2,0,1
"2011","E00023110","E00023110","Total",128,74,16,58,0,8,3,5,41,38,0,2,1,5
"2011","E00023133","E00023133","Total",141,69,22,47,2,6,5,1,64,61,0,3,0,0
"2011","E00022920","E00022920","Total",113,66,22,44,1,9,1,8,37,37,0,0,0,0
"2011","E00022925","E00022925","Total",109,61,19,42,0,3,1,2,45,43,0,2,0,0
"2011","E00022928","E00022928","Total",161,116,50,66,0,5,0,5,40,38,0,2,0,0
"2011","E00022929","E00022929","Total",133,79,40,39,0,15,0,15,39,38,0,1,0,0
"2011","E00022932","E00022932","Total",137,100,40,60,1,4,1,3,31,29,0,2,0,1
"2011","E00022931","E00022931","Total",148,103,37,66,0,5,1,4,37,35,0,1,1,3
"2011","E00022933","E00022933","Total",156,112,45,67,0,11,1,10,32,31,0,1,0,1
"2011","E00022936","E00022936","Total",140,110,47,63,1,4,0,4,25,24,0,1,0,0
"2011","E00022938","E00022938","Total",146,81,38,43,0,10,2,8,55,54,0,1,0,0
"2011","E00023094","E00023094","Total",141,76,33,43,1,19,1,18,44,43,0,1,0,1
"2011","E00023101","E00023101","Total",164,85,29,56,0,14,3,11,65,60,0,5,0,0
"2011","E00023106","E00023106","Total",138,56,19,37,0,21,5,16,60,58,0,2,0,1
"2011","E00023108","E00023108","Total",119,54,18,36,2,5,3,2,57,57,0,0,0,1
"2011","E00023111","E00023111","Total",153,72,27,45,0,10,1,9,71,66,1,4,0,0
"2011","E00023138","E00023138","Total",133,51,10,41,0,25,3,22,57,52,0,5,0,0
"2011","E00023097","E00023097","Total",126,72,29,43,1,17,7,10,35,34,0,1,0,1
"2011","E00023103","E00023103","Total",113,71,28,43,0,13,1,12,29,28,0,1,0,0
"2011","E00023104","E00023104","Total",126,79,31,48,0,10,3,7,36,35,0,1,0,1
"2011","E00023109","E00023109","Total",127,66,29,37,1,10,1,9,48,47,0,1,0,2
"2011","E00023136","E00023136","Total",133,70,31,39,1,14,1,13,47,44,0,3,0,1
"2011","E00023137","E00023137","Total",110,68,26,42,0,11,2,9,31,29,0,2,0,0
"2011","E00023095","E00023095","Total",167,98,27,71,1,7,1,6,60,59,0,1,0,1
"2011","E00023099","E00023099","Total",127,66,25,41,0,4,2,2,57,55,0,2,0,0
"2011","E00023102","E00023102","Total",107,72,31,41,0,10,3,7,25,22,0,3,0,0
"2011","E00023105","E00023105","Total",116,69,25,44,2,7,3,4,38,37,0,1,0,0
"2011","E00023135","E00023135","Total",189,79,23,56,1,9,1,8,97,96,0,1,0,3
"2011","E00022681","E00022681","Total",99,29,14,15,0,49,43,6,21,18,0,3,0,0
"2011","E00022686","E00022686","Total",117,61,21,40,0,4,1,3,52,49,0,3,0,0
"2011","E00022687","E00022687","Total",103,9,2,7,0,62,3,59,28,23,1,4,0,4
"2011","E00022692","E00022692","Total",145,55,21,34,0,13,8,5,76,76,0,0,0,1
"2011","E00022710","E00022710","Total",181,85,32,53,6,1,1,0,88,83,2,3,0,1
"2011","E00022715","E00022715","Total",147,58,15,43,1,9,6,3,78,72,0,6,0,1
"2011","E00171051","E00171051","Total",112,49,17,32,0,1,1,0,61,55,0,3,3,1
"2011","E00171052","E00171052","Total",109,51,23,28,1,1,0,1,55,54,0,1,0,1
"2011","E00171058","E00171058","Total",109,55,22,33,1,1,0,1,49,43,0,5,1,3
"2011","E00022680","E00022680","Total",108,50,17,33,0,5,5,0,52,50,1,0,1,1
"2011","E00022688","E00022688","Total",108,58,22,36,0,4,2,2,46,45,0,0,1,0
"2011","E00022693","E00022693","Total",112,56,15,41,0,3,1,2,52,50,1,1,0,1
"2011","E00022696","E00022696","Total",126,80,28,52,0,10,2,8,36,34,1,1,0,0
"2011","E00022698","E00022698","Total",123,68,22,46,0,1,0,1,54,53,0,1,0,0
"2011","E00022723","E00022723","Total",135,67,26,41,1,5,1,4,61,59,0,2,0,1
"2011","E00023193","E00023193","Total",144,67,30,37,0,8,8,0,68,66,0,2,0,1
"2011","E00023198","E00023198","Total",150,60,20,40,3,2,1,1,82,77,1,2,2,3
"2011","E00023200","E00023200","Total",113,64,33,31,2,8,2,6,38,35,0,3,0,1
"2011","E00023201","E00023201","Total",160,90,34,56,0,12,3,9,55,53,1,1,0,3
"2011","E00023206","E00023206","Total",139,82,26,56,0,3,3,0,54,51,2,1,0,0
"2011","E00023196","E00023196","Total",160,52,16,36,0,9,1,8,96,94,0,2,0,3
"2011","E00023199","E00023199","Total",143,85,46,39,2,18,16,2,38,36,0,2,0,0
"2011","E00023202","E00023202","Total",151,82,32,50,0,3,0,3,66,64,1,1,0,0
"2011","E00023203","E00023203","Total",132,67,28,39,0,6,3,3,58,57,1,0,0,1
"2011","E00023205","E00023205","Total",154,49,21,28,1,7,4,3,94,85,5,4,0,3
"2011","E00170900","E00170900","Total",128,35,12,23,2,15,0,15,73,66,0,5,2,3
"2011","E00171086","E00171086","Total",128,43,16,27,21,0,0,0,62,59,0,3,0,2
"2011","E00023230","E00023230","Total",226,134,75,59,1,5,3,2,81,80,0,0,1,5
"2011","E00170901","E00170901","Total",127,51,26,25,4,1,0,1,69,68,0,1,0,2
"2011","E00170902","E00170902","Total",156,35,10,25,70,6,2,4,44,43,0,1,0,1
"2011","E00171054","E00171054","Total",139,81,24,57,3,1,0,1,54,50,0,2,2,0
"2011","E00171060","E00171060","Total",118,71,33,38,0,3,3,0,44,43,0,1,0,0
"2011","E00023204","E00023204","Total",146,78,33,45,0,3,1,2,62,58,0,4,0,3
"2011","E00023207","E00023207","Total",181,118,46,72,1,6,3,3,56,54,0,1,1,0
"2011","E00023208","E00023208","Total",148,84,30,54,0,4,3,1,56,50,0,6,0,4
"2011","E00022626","E00022626","Total",145,81,42,39,2,5,4,1,54,51,0,3,0,3
"2011","E00022631","E00022631","Total",175,81,51,30,0,4,3,1,87,84,0,3,0,3
"2011","E00022667","E00022667","Total",229,108,54,54,1,14,4,10,104,100,0,4,0,2
"2011","E00022668","E00022668","Total",147,48,25,23,1,44,26,18,52,49,0,3,0,2
"2011","E00022669","E00022669","Total",130,44,27,17,1,4,3,1,78,75,2,1,0,3
"2011","E00022674","E00022674","Total",129,56,36,20,4,9,8,1,59,54,0,5,0,1
"2011","E00023370","E00023370","Total",125,102,66,36,0,1,0,1,21,21,0,0,0,1
"2011","E00023371","E00023371","Total",131,112,62,50,0,1,1,0,17,17,0,0,0,1
"2011","E00023373","E00023373","Total",126,94,59,35,0,17,14,3,15,15,0,0,0,0
"2011","E00023378","E00023378","Total",137,109,65,44,0,5,5,0,22,20,0,2,0,1
"2011","E00023375","E00023375","Total",117,53,34,19,0,6,4,2,58,22,23,2,11,0
"2011","E00023395","E00023395","Total",125,52,20,32,0,6,6,0,67,63,0,4,0,0
"2011","E00023397","E00023397","Total",111,54,34,20,3,21,21,0,31,30,1,0,0,2
"2011","E00023398","E00023398","Total",139,61,32,29,0,12,12,0,64,62,0,2,0,2
"2011","E00023400","E00023400","Total",151,74,38,36,2,13,12,1,61,60,0,1,0,1
"2011","E00023409","E00023409","Total",140,93,53,40,0,10,10,0,37,34,2,1,0,0
"2011","E00023368","E00023368","Total",135,90,50,40,1,3,2,1,39,35,0,4,0,2
"2011","E00023401","E00023401","Total",133,70,29,41,1,6,1,5,55,52,0,3,0,1
"2011","E00023403","E00023403","Total",144,87,45,42,0,14,3,11,41,40,0,1,0,2
"2011","E00023404","E00023404","Total",129,66,30,36,0,2,1,1,59,57,0,1,1,2
"2011","E00023405","E00023405","Total",153,66,23,43,12,4,1,3,68,62,0,6,0,3
"2011","E00023410","E00023410","Total",103,88,58,30,0,0,0,0,13,13,0,0,0,2
"2011","E00023396","E00023396","Total",133,90,41,49,0,19,17,2,23,21,0,0,2,1
"2011","E00023399","E00023399","Total",149,59,20,39,0,62,39,23,25,24,0,1,0,3
"2011","E00023402","E00023402","Total",143,65,33,32,0,54,52,2,22,22,0,0,0,2
"2011","E00023406","E00023406","Total",135,88,35,53,1,25,24,1,20,18,0,1,1,1
"2011","E00023407","E00023407","Total",146,76,37,39,0,36,18,18,32,29,0,3,0,2
"2011","E00023408","E00023408","Total",112,60,35,25,0,31,29,2,21,19,0,1,1,0
"2011","E00022679","E00022679","Total",164,66,21,45,0,32,2,30,64,59,0,5,0,2
"2011","E00022712","E00022712","Total",156,49,8,41,0,55,12,43,52,51,0,1,0,0
"2011","E00022713","E00022713","Total",137,76,37,39,0,26,5,21,33,32,0,1,0,2
"2011","E00022714","E00022714","Total",189,76,14,62,0,18,7,11,92,91,0,1,0,3
"2011","E00022718","E00022718","Total",143,69,25,44,0,24,6,18,46,43,0,3,0,4
"2011","E00022722","E00022722","Total",197,93,46,47,1,37,30,7,63,59,1,3,0,3
"2011","E00022685","E00022685","Total",151,75,24,51,1,21,1,20,51,47,1,3,0,3
"2011","E00022690","E00022690","Total",132,64,28,36,2,20,4,16,44,42,0,2,0,2
"2011","E00022694","E00022694","Total",132,51,11,40,1,20,1,19,60,58,0,2,0,0
"2011","E00022717","E00022717","Total",118,61,17,44,7,7,1,6,41,37,0,4,0,2
"2011","E00022720","E00022720","Total",249,96,18,78,39,23,5,18,90,88,0,2,0,1
"2011","E00022721","E00022721","Total",135,59,21,38,3,32,0,32,39,36,0,3,0,2
"2011","E00022684","E00022684","Total",137,92,37,55,1,5,0,5,37,34,0,3,0,2
"2011","E00022689","E00022689","Total",129,71,21,50,0,25,8,17,32,31,0,1,0,1
"2011","E00022691","E00022691","Total",146,67,24,43,0,20,13,7,57,57,0,0,0,2
"2011","E00022695","E00022695","Total",140,59,18,41,0,28,2,26,52,48,0,2,2,1
"2011","E00022709","E00022709","Total",108,89,38,51,0,3,0,3,16,15,0,1,0,0
"2011","E00022719","E00022719","Total",139,89,37,52,1,7,1,6,40,36,1,3,0,2
"2011","E00022678","E00022678","Total",149,81,31,50,20,1,0,1,46,43,0,3,0,1
"2011","E00022711","E00022711","Total",193,64,18,46,2,51,9,42,76,71,0,5,0,0
"2011","E00022716","E00022716","Total",109,16,8,8,0,85,10,75,7,7,0,0,0,1
"2011","E00170951","E00170951","Total",70,31,10,21,1,11,4,7,27,25,0,1,1,0
"2011","E00170953","E00170953","Total",96,41,15,26,2,7,2,5,46,44,0,2,0,0
"2011","E00171049","E00171049","Total",122,52,16,36,10,16,4,12,43,41,0,2,0,1
"2011","E00022910","E00022910","Total",184,76,26,50,0,15,4,11,93,84,2,5,2,0
"2011","E00022911","E00022911","Total",150,36,16,20,1,49,2,47,62,62,0,0,0,2
"2011","E00022912","E00022912","Total",128,26,9,17,1,54,4,50,47,45,0,2,0,0
"2011","E00022918","E00022918","Total",156,3,0,3,1,138,9,129,14,13,0,0,1,0
"2011","E00171055","E00171055","Total",154,55,12,43,5,35,3,32,57,53,0,2,2,2
"2011","E00171057","E00171057","Total",112,2,0,2,0,97,3,94,12,10,0,0,2,1
"2011","E00023008","E00023008","Total",143,20,9,11,1,95,91,4,27,26,0,1,0,0
"2011","E00023009","E00023009","Total",176,24,13,11,0,123,119,4,24,23,0,1,0,5
"2011","E00170903","E00170903","Total",64,15,10,5,1,41,38,3,7,6,0,0,1,0
"2011","E00170904","E00170904","Total",75,8,1,7,3,44,42,2,18,17,0,1,0,2
"2011","E00023004","E00023004","Total",152,14,5,9,0,126,110,16,10,10,0,0,0,2
"2011","E00023038","E00023038","Total",141,28,12,16,0,83,79,4,28,26,0,1,1,2
"2011","E00023039","E00023039","Total",151,12,7,5,0,111,107,4,25,25,0,0,0,3
"2011","E00023040","E00023040","Total",163,22,11,11,0,122,122,0,18,18,0,0,0,1
"2011","E00023041","E00023041","Total",120,22,9,13,2,36,33,3,58,57,0,1,0,2
"2011","E00023032","E00023032","Total",138,73,57,16,1,32,32,0,25,25,0,0,0,7
"2011","E00023033","E00023033","Total",159,31,15,16,0,100,98,2,25,23,0,2,0,3
"2011","E00023034","E00023034","Total",153,22,12,10,2,108,74,34,19,18,0,0,1,2
"2011","E00023035","E00023035","Total",121,27,11,16,0,72,69,3,18,16,0,2,0,4
"2011","E00023036","E00023036","Total",120,29,15,14,0,59,57,2,32,31,1,0,0,0
"2011","E00023002","E00023002","Total",110,40,21,19,0,53,51,2,16,16,0,0,0,1
"2011","E00023003","E00023003","Total",94,74,48,26,0,1,1,0,14,13,1,0,0,5
"2011","E00023037","E00023037","Total",101,27,12,15,1,39,36,3,32,30,0,2,0,2
"2011","E00023042","E00023042","Total",151,23,8,15,2,94,92,2,31,28,0,3,0,1
"2011","E00023043","E00023043","Total",136,40,16,24,1,67,67,0,28,28,0,0,0,0
"2011","E00022630","E00022630","Total",129,55,24,31,1,12,1,11,61,59,0,2,0,0
"2011","E00022634","E00022634","Total",160,51,26,25,12,15,14,1,78,73,0,5,0,4
"2011","E00022642","E00022642","Total",123,53,40,13,0,27,23,4,43,41,0,2,0,0
"2011","E00022644","E00022644","Total",137,70,42,28,2,3,2,1,61,58,0,2,1,1
"2011","E00022649","E00022649","Total",124,54,31,23,0,24,2,22,43,42,1,0,0,3
"2011","E00022653","E00022653","Total",134,61,22,39,2,18,17,1,49,46,0,2,1,4
"2011","E00022629","E00022629","Total",137,56,25,31,1,39,27,12,41,40,0,1,0,0
"2011","E00022636","E00022636","Total",137,87,56,31,0,8,7,1,41,40,0,1,0,1
"2011","E00022639","E00022639","Total",155,40,13,27,0,78,75,3,37,37,0,0,0,0
"2011","E00022672","E00022672","Total",132,68,37,31,0,42,20,22,21,19,0,2,0,1
"2011","E00022675","E00022675","Total",151,57,24,33,11,26,22,4,57,52,0,4,1,0
"2011","E00022632","E00022632","Total",112,31,13,18,1,40,40,0,39,36,0,3,0,1
"2011","E00022645","E00022645","Total",132,58,27,31,0,2,1,1,71,65,0,6,0,1
"2011","E00022648","E00022648","Total",121,47,23,24,0,2,1,1,69,48,14,2,5,3
"2011","E00022651","E00022651","Total",123,78,35,43,0,6,6,0,37,34,1,1,1,2
"2011","E00022652","E00022652","Total",111,23,13,10,0,62,59,3,26,23,0,3,0,0
"2011","E00022654","E00022654","Total",139,80,21,59,0,13,7,6,43,41,0,1,1,3
"2011","E00022657","E00022657","Total",158,96,46,50,2,2,2,0,53,50,0,3,0,5
"2011","E00022658","E00022658","Total",134,75,46,29,0,4,3,1,54,52,0,2,0,1
"2011","E00022660","E00022660","Total",134,75,35,40,0,8,8,0,50,43,5,0,2,1
"2011","E00022661","E00022661","Total",151,63,27,36,0,29,6,23,57,53,0,3,1,2
"2011","E00022665","E00022665","Total",142,82,42,40,1,1,0,1,56,53,1,2,0,2
"2011","E00022666","E00022666","Total",119,70,39,31,2,3,2,1,41,39,0,2,0,3
"2011","E00022627","E00022627","Total",140,70,46,24,0,7,6,1,59,52,0,6,1,4
"2011","E00022633","E00022633","Total",128,44,24,20,2,0,0,0,81,80,0,1,0,1
"2011","E00022638","E00022638","Total",121,59,32,27,0,18,18,0,41,39,0,2,0,3
"2011","E00022670","E00022670","Total",102,22,11,11,2,14,7,7,62,50,1,3,8,2
"2011","E00022671","E00022671","Total",127,27,16,11,1,28,16,12,69,66,1,2,0,2
"2011","E00022676","E00022676","Total",124,46,21,25,3,28,1,27,47,41,0,6,0,0
"2011","E00022677","E00022677","Total",220,93,47,46,5,3,2,1,115,106,1,8,0,4
"2011","E00022915","E00022915","Total",117,41,13,28,1,20,3,17,53,50,0,3,0,2
"2011","E00022917","E00022917","Total",138,88,36,52,0,7,1,6,43,41,0,1,1,0
"2011","E00022923","E00022923","Total",124,56,23,33,0,21,0,21,46,45,0,1,0,1
"2011","E00022926","E00022926","Total",142,57,26,31,0,48,33,15,34,31,0,3,0,3
"2011","E00022927","E00022927","Total",139,62,28,34,0,7,2,5,66,63,0,3,0,4
"2011","E00022935","E00022935","Total",106,57,21,36,0,15,2,13,34,34,0,0,0,0
"2011","E00022939","E00022939","Total",139,75,42,33,0,14,5,9,48,46,0,2,0,2
"2011","E00022940","E00022940","Total",116,71,36,35,0,11,4,7,33,30,0,2,1,1
"2011","E00022944","E00022944","Total",122,86,31,55,0,5,3,2,30,30,0,0,0,1
"2011","E00022945","E00022945","Total",128,71,34,37,1,18,9,9,38,37,0,0,1,0
"2011","E00022946","E00022946","Total",145,65,25,40,2,17,11,6,58,54,0,3,1,3
"2011","E00022937","E00022937","Total",134,101,35,66,0,6,1,5,27,25,0,2,0,0
"2011","E00022942","E00022942","Total",154,80,26,54,0,14,7,7,60,55,0,5,0,0
"2011","E00022947","E00022947","Total",114,56,26,30,0,24,9,15,34,33,0,0,1,0
"2011","E00022948","E00022948","Total",135,90,40,50,2,19,6,13,21,17,0,3,1,3
"2011","E00022949","E00022949","Total",138,80,27,53,0,8,7,1,49,48,1,0,0,1
"2011","E00022907","E00022907","Total",112,54,28,26,0,25,7,18,33,31,0,2,0,0
"2011","E00022909","E00022909","Total",107,66,30,36,0,11,5,6,30,30,0,0,0,0
"2011","E00022950","E00022950","Total",145,116,41,75,0,4,1,3,25,22,0,3,0,0
"2011","E00022951","E00022951","Total",139,100,37,63,3,7,1,6,28,28,0,0,0,1
"2011","E00023278","E00023278","Total",134,84,20,64,0,2,1,1,48,47,0,1,0,0
"2011","E00023280","E00023280","Total",133,65,31,34,0,35,2,33,29,29,0,0,0,4
"2011","E00023286","E00023286","Total",142,117,62,55,0,10,5,5,15,15,0,0,0,0
"2011","E00023294","E00023294","Total",127,76,41,35,0,29,5,24,16,15,0,1,0,6
"2011","E00023011","E00023011","Total",198,135,79,56,0,4,3,1,56,52,1,2,1,3
"2011","E00023014","E00023014","Total",121,28,11,17,1,48,30,18,44,43,0,1,0,0
"2011","E00023017","E00023017","Total",113,81,44,37,1,3,3,0,25,24,0,0,1,3
"2011","E00023021","E00023021","Total",126,33,15,18,0,69,68,1,24,23,0,0,1,0
"2011","E00023026","E00023026","Total",148,24,9,15,1,89,87,2,34,33,0,1,0,0
"2011","E00023369","E00023369","Total",119,81,39,42,1,24,21,3,12,10,0,2,0,1
"2011","E00023372","E00023372","Total",130,70,31,39,21,24,17,7,13,13,0,0,0,2
"2011","E00023374","E00023374","Total",135,83,35,48,1,20,20,0,28,27,0,0,1,3
"2011","E00023376","E00023376","Total",110,24,10,14,2,55,54,1,28,25,0,2,1,1
"2011","E00023377","E00023377","Total",125,22,6,16,0,39,33,6,63,27,0,2,34,1
"2011","E00023411","E00023411","Total",142,85,47,38,0,39,37,2,18,18,0,0,0,0
"2011","E00023384","E00023384","Total",136,77,49,28,0,4,3,1,51,50,0,1,0,4
"2011","E00023386","E00023386","Total",131,79,43,36,1,1,1,0,46,43,0,3,0,4
"2011","E00023387","E00023387","Total",155,21,8,13,2,101,76,25,28,27,0,1,0,3
"2011","E00023388","E00023388","Total",170,41,14,27,1,90,86,4,36,35,0,1,0,2
"2011","E00023390","E00023390","Total",121,51,21,30,0,37,36,1,33,31,0,0,2,0
"2011","E00023392","E00023392","Total",138,43,11,32,0,57,56,1,36,35,0,1,0,2
"2011","E00023379","E00023379","Total",131,85,40,45,0,25,22,3,19,18,0,0,1,2
"2011","E00023380","E00023380","Total",121,63,22,41,0,38,37,1,20,18,0,2,0,0
"2011","E00023381","E00023381","Total",132,85,40,45,0,22,21,1,23,21,0,2,0,2
"2011","E00023394","E00023394","Total",164,52,25,27,1,85,84,1,25,25,0,0,0,1
"2011","E00170907","E00170907","Total",91,72,46,26,0,9,7,2,10,9,0,1,0,0
"2011","E00170908","E00170908","Total",131,22,9,13,64,25,5,20,19,19,0,0,0,1
"2011","E00170909","E00170909","Total",100,81,34,47,1,1,0,1,17,17,0,0,0,0
"2011","E00023382","E00023382","Total",142,33,9,24,1,81,81,0,25,24,0,1,0,2
"2011","E00023383","E00023383","Total",149,22,5,17,5,96,93,3,22,22,0,0,0,4
"2011","E00023385","E00023385","Total",148,65,29,36,1,45,43,2,36,35,0,1,0,1
"2011","E00023389","E00023389","Total",141,19,6,13,0,97,88,9,25,25,0,0,0,0
"2011","E00023391","E00023391","Total",142,60,15,45,1,42,39,3,39,39,0,0,0,0
"2011","E00023393","E00023393","Total",122,73,45,28,2,22,22,0,25,21,1,3,0,0
"2011","E00022487","E00022487","Total",140,91,55,36,2,2,0,2,45,43,1,1,0,0
"2011","E00022508","E00022508","Total",156,119,48,71,0,6,0,6,29,27,0,2,0,2
"2011","E00022509","E00022509","Total",125,97,57,40,0,3,1,2,24,22,0,2,0,1
"2011","E00022513","E00022513","Total",68,40,29,11,0,20,18,2,7,7,0,0,0,1
"2011","E00022516","E00022516","Total",118,97,53,44,0,0,0,0,21,19,0,2,0,0
"2011","E00022507","E00022507","Total",125,98,45,53,0,7,0,7,19,17,0,2,0,1
"2011","E00022510","E00022510","Total",153,94,43,51,0,18,1,17,38,35,0,1,2,3
"2011","E00022511","E00022511","Total",135,103,50,53,0,5,3,2,24,21,0,2,1,3
"2011","E00022514","E00022514","Total",125,108,51,57,0,10,6,4,6,6,0,0,0,1
"2011","E00022491","E00022491","Total",135,92,42,50,0,7,1,6,33,31,0,2,0,3
"2011","E00022518","E00022518","Total",102,70,40,30,0,14,7,7,17,17,0,0,0,1
"2011","E00022524","E00022524","Total",133,55,30,25,0,22,10,12,54,52,0,2,0,2
"2011","E00022525","E00022525","Total",125,74,38,36,0,21,5,16,29,29,0,0,0,1
"2011","E00022527","E00022527","Total",118,73,30,43,0,17,4,13,27,26,0,1,0,1
"2011","E00022861","E00022861","Total",63,54,30,24,0,3,0,3,6,6,0,0,0,0
"2011","E00022898","E00022898","Total",162,73,27,46,0,20,5,15,65,60,2,3,0,4
"2011","E00022899","E00022899","Total",41,3,3,0,0,33,0,33,5,4,1,0,0,0
"2011","E00022900","E00022900","Total",101,67,29,38,0,2,1,1,29,26,0,3,0,3
"2011","E00022901","E00022901","Total",114,57,21,36,0,25,5,20,31,31,0,0,0,1
"2011","E00022902","E00022902","Total",89,6,5,1,0,68,63,5,10,9,0,0,1,5
"2011","E00022908","E00022908","Total",108,86,39,47,0,6,4,2,13,13,0,0,0,3
"2011","E00022930","E00022930","Total",115,78,33,45,0,4,2,2,33,31,0,2,0,0
"2011","E00022934","E00022934","Total",125,109,48,61,0,5,3,2,9,9,0,0,0,2
"2011","E00022941","E00022941","Total",124,99,39,60,0,1,1,0,22,22,0,0,0,2
"2011","E00022943","E00022943","Total",115,78,33,45,0,8,2,6,29,24,1,4,0,0
"2011","E00022581","E00022581","Total",154,37,11,26,2,63,31,32,51,49,0,1,1,1
"2011","E00022612","E00022612","Total",164,31,11,20,24,68,4,64,41,37,0,1,3,0
"2011","E00022613","E00022613","Total",143,64,11,53,1,17,1,16,59,58,0,1,0,2
"2011","E00022614","E00022614","Total",132,77,23,54,1,34,6,28,20,19,0,1,0,0
"2011","E00022615","E00022615","Total",169,72,24,48,2,23,2,21,70,68,0,1,1,2
"2011","E00022699","E00022699","Total",147,81,18,63,7,11,10,1,47,42,0,5,0,1
"2011","E00022700","E00022700","Total",134,62,15,47,6,5,4,1,60,58,1,1,0,1
"2011","E00022704","E00022704","Total",112,47,15,32,0,46,44,2,17,14,0,3,0,2
"2011","E00022706","E00022706","Total",145,66,21,45,5,29,28,1,44,42,1,1,0,1
"2011","E00022707","E00022707","Total",142,73,29,44,0,35,35,0,32,31,0,1,0,2
"2011","E00022708","E00022708","Total",153,66,17,49,0,51,50,1,34,32,0,2,0,2
"2011","E00023149","E00023149","Total",130,10,2,8,0,111,110,1,7,7,0,0,0,2
"2011","E00023151","E00023151","Total",84,11,4,7,0,63,58,5,10,7,0,0,3,0
"2011","E00023152","E00023152","Total",164,19,7,12,1,128,126,2,16,15,0,1,0,0
"2011","E00023153","E00023153","Total",153,14,8,6,0,127,122,5,12,12,0,0,0,0
"2011","E00170917","E00170917","Total",123,42,10,32,23,2,1,1,56,50,0,6,0,0
"2011","E00170918","E00170918","Total",124,22,5,17,12,3,2,1,86,84,0,2,0,1
"2011","E00170919","E00170919","Total",115,43,10,33,2,19,2,17,49,48,0,1,0,2
"2011","E00023139","E00023139","Total",230,89,33,56,0,83,33,50,57,52,1,1,3,1
"2011","E00023155","E00023155","Total",109,55,24,31,0,20,12,8,32,31,0,0,1,2
"2011","E00023156","E00023156","Total",112,50,17,33,1,17,16,1,44,42,0,2,0,0
"2011","E00023157","E00023157","Total",114,52,24,28,0,19,9,10,43,42,0,0,1,0
"2011","E00023158","E00023158","Total",167,76,28,48,13,17,15,2,58,54,1,3,0,3
"2011","E00170920","E00170920","Total",117,55,16,39,0,34,25,9,27,27,0,0,0,1
"2011","E00170921","E00170921","Total",157,70,13,57,45,2,2,0,40,38,0,2,0,0
"2011","E00022616","E00022616","Total",123,61,17,44,1,26,21,5,35,35,0,0,0,0
"2011","E00022618","E00022618","Total",111,69,21,48,0,10,10,0,32,31,0,1,0,0
"2011","E00022619","E00022619","Total",168,73,19,54,0,24,2,22,70,68,0,1,1,1
"2011","E00022620","E00022620","Total",129,81,20,61,0,8,1,7,38,36,0,2,0,2
"2011","E00022621","E00022621","Total",134,79,25,54,1,3,0,3,51,51,0,0,0,0
"2011","E00170914","E00170914","Total",64,27,5,22,0,15,1,14,22,19,0,3,0,0
"2011","E00170915","E00170915","Total",74,27,5,22,1,17,0,17,27,24,0,3,0,2
"2011","E00022697","E00022697","Total",117,72,28,44,0,14,0,14,31,29,0,2,0,0
"2011","E00022701","E00022701","Total",117,64,22,42,1,15,2,13,36,36,0,0,0,1
"2011","E00022702","E00022702","Total",119,60,21,39,0,19,2,17,37,36,0,1,0,3
"2011","E00022703","E00022703","Total",133,70,33,37,0,30,8,22,31,28,0,3,0,2
"2011","E00022705","E00022705","Total",132,75,26,49,0,21,2,19,36,35,0,1,0,0
"2011","E00023284","E00023284","Total",129,65,8,57,1,22,0,22,39,38,0,1,0,2
"2011","E00023313","E00023313","Total",95,49,20,29,0,25,3,22,18,17,0,1,0,3
"2011","E00023315","E00023315","Total",95,59,32,27,1,21,2,19,13,13,0,0,0,1
"2011","E00023317","E00023317","Total",111,46,11,35,0,26,1,25,38,37,0,1,0,1
"2011","E00023318","E00023318","Total",128,68,26,42,0,23,1,22,34,31,1,2,0,3
"2011","E00023319","E00023319","Total",144,89,22,67,0,10,4,6,44,40,0,4,0,1
"2011","E00023283","E00023283","Total",147,70,29,41,0,29,7,22,48,46,0,1,1,0
"2011","E00023288","E00023288","Total",121,73,20,53,1,17,6,11,30,25,3,2,0,0
"2011","E00023305","E00023305","Total",127,64,30,34,2,16,13,3,43,40,0,1,2,2
"2011","E00023314","E00023314","Total",105,88,46,42,1,4,4,0,12,11,0,1,0,0
"2011","E00023316","E00023316","Total",159,75,26,49,0,8,2,6,76,72,0,4,0,0
"2011","E00023279","E00023279","Total",130,106,35,71,0,3,2,1,19,17,0,2,0,2
"2011","E00023281","E00023281","Total",146,76,21,55,1,20,6,14,49,45,0,4,0,0
"2011","E00023282","E00023282","Total",122,78,28,50,0,18,11,7,25,25,0,0,0,1
"2011","E00023287","E00023287","Total",114,68,21,47,0,20,12,8,26,25,0,1,0,0
"2011","E00023291","E00023291","Total",200,120,41,79,0,20,3,17,60,59,1,0,0,0
"2011","E00023306","E00023306","Total",129,55,19,36,0,18,7,11,53,49,1,3,0,3
"2011","E00023307","E00023307","Total",140,103,40,63,1,20,2,18,16,14,0,2,0,0
"2011","E00023309","E00023309","Total",133,73,27,46,1,27,6,21,30,26,0,3,1,2
"2011","E00023310","E00023310","Total",115,54,14,40,2,22,14,8,37,33,0,2,2,0
"2011","E00023311","E00023311","Total",114,89,39,50,0,12,1,11,13,13,0,0,0,0
"2011","E00022635","E00022635","Total",120,53,22,31,0,18,4,14,48,45,0,2,1,1
"2011","E00022637","E00022637","Total",119,50,13,37,0,6,1,5,61,58,0,3,0,2
"2011","E00022640","E00022640","Total",126,39,15,24,2,9,6,3,75,73,0,2,0,1
"2011","E00022641","E00022641","Total",111,29,12,17,0,55,42,13,25,25,0,0,0,2
"2011","E00022647","E00022647","Total",107,61,24,37,1,3,3,0,41,37,0,4,0,1
"2011","E00022673","E00022673","Total",130,91,43,48,0,3,1,2,35,33,0,2,0,1
"2011","E00022643","E00022643","Total",148,67,21,46,1,8,1,7,72,71,0,1,0,0
"2011","E00022646","E00022646","Total",133,97,34,63,1,4,1,3,29,29,0,0,0,2
"2011","E00022655","E00022655","Total",134,106,43,63,1,4,3,1,21,20,0,0,1,2
"2011","E00022656","E00022656","Total",133,85,34,51,0,8,5,3,36,36,0,0,0,4
"2011","E00022659","E00022659","Total",122,91,35,56,0,7,2,5,24,22,1,1,0,0
"2011","E00022628","E00022628","Total",106,58,22,36,2,13,11,2,31,30,1,0,0,2
"2011","E00022650","E00022650","Total",117,56,32,24,0,2,1,1,58,11,34,0,13,1
"2011","E00022662","E00022662","Total",119,75,27,48,3,2,1,1,38,37,0,1,0,1
"2011","E00022663","E00022663","Total",126,79,46,33,0,1,1,0,43,37,1,5,0,3
"2011","E00022664","E00022664","Total",98,58,24,34,0,4,3,1,35,34,0,0,1,1
"2011","E00023161","E00023161","Total",113,84,36,48,1,3,2,1,25,22,1,2,0,0
"2011","E00023163","E00023163","Total",109,88,46,42,0,2,1,1,16,16,0,0,0,3
"2011","E00023166","E00023166","Total",107,88,49,39,0,0,0,0,18,17,1,0,0,1
"2011","E00023169","E00023169","Total",126,80,32,48,0,1,1,0,45,44,0,1,0,0
"2011","E00023170","E00023170","Total",135,86,35,51,0,3,3,0,45,43,0,2,0,1
"2011","E00023173","E00023173","Total",145,94,42,52,1,6,1,5,43,42,0,1,0,1
"2011","E00023174","E00023174","Total",127,60,22,38,1,4,2,2,60,57,1,2,0,2
"2011","E00023178","E00023178","Total",138,104,38,66,0,2,1,1,30,29,0,1,0,2
"2011","E00023180","E00023180","Total",120,97,43,54,1,1,1,0,20,19,0,1,0,1
"2011","E00023181","E00023181","Total",116,80,31,49,0,1,1,0,33,33,0,0,0,2
"2011","E00023338","E00023338","Total",140,119,63,56,0,9,8,1,12,11,0,1,0,0
"2011","E00023344","E00023344","Total",196,145,77,68,18,6,5,1,26,26,0,0,0,1
"2011","E00023355","E00023355","Total",131,53,18,35,0,29,27,2,47,43,0,4,0,2
"2011","E00023356","E00023356","Total",142,45,21,24,1,28,17,11,64,61,0,3,0,4
"2011","E00022488","E00022488","Total",181,98,49,49,12,9,5,4,60,56,1,3,0,2
"2011","E00022492","E00022492","Total",131,57,28,29,0,28,23,5,43,42,0,0,1,3
"2011","E00022493","E00022493","Total",153,107,53,54,0,11,2,9,35,33,1,1,0,0
"2011","E00022522","E00022522","Total",127,85,39,46,2,3,1,2,37,36,0,1,0,0
"2011","E00022529","E00022529","Total",150,103,44,59,2,4,3,1,41,40,0,1,0,0
"2011","E00022495","E00022495","Total",144,50,13,37,0,37,37,0,57,57,0,0,0,0
"2011","E00022496","E00022496","Total",234,56,6,50,22,33,6,27,122,118,1,3,0,1
"2011","E00022499","E00022499","Total",172,66,28,38,2,19,5,14,84,80,1,3,0,1
"2011","E00022500","E00022500","Total",164,86,17,69,1,29,2,27,46,44,0,2,0,2
"2011","E00022502","E00022502","Total",204,50,13,37,0,2,2,0,149,145,1,2,1,3
"2011","E00022512","E00022512","Total",125,50,25,25,0,20,5,15,53,49,0,4,0,2
"2011","E00022515","E00022515","Total",121,73,40,33,0,1,1,0,45,42,0,3,0,2
"2011","E00022517","E00022517","Total",163,77,25,52,1,11,7,4,73,71,0,1,1,1
"2011","E00022519","E00022519","Total",163,17,7,10,0,3,2,1,140,135,0,5,0,3
"2011","E00022521","E00022521","Total",118,60,18,42,0,5,2,3,53,51,0,2,0,0
"2011","E00022530","E00022530","Total",134,28,16,12,0,72,70,2,34,33,0,1,0,0
"2011","E00022863","E00022863","Total",116,89,27,62,0,4,4,0,23,21,0,2,0,0
"2011","E00022867","E00022867","Total",118,80,28,52,0,13,5,8,23,21,0,2,0,2
"2011","E00022868","E00022868","Total",141,73,25,48,0,20,7,13,47,45,0,2,0,1
"2011","E00022903","E00022903","Total",106,62,30,32,0,15,2,13,27,27,0,0,0,2
"2011","E00022905","E00022905","Total",137,93,34,59,2,13,4,9,28,28,0,0,0,1
"2011","E00022862","E00022862","Total",136,83,37,46,0,24,6,18,28,27,1,0,0,1
"2011","E00022864","E00022864","Total",128,84,39,45,0,11,1,10,31,28,0,3,0,2
"2011","E00022865","E00022865","Total",138,90,36,54,0,16,2,14,31,28,0,3,0,1
"2011","E00022866","E00022866","Total",94,32,8,24,0,25,1,24,37,37,0,0,0,0
"2011","E00022904","E00022904","Total",110,74,30,44,0,11,3,8,20,19,0,0,1,5
"2011","E00023324","E00023324","Total",206,80,26,54,1,67,37,30,57,43,13,0,1,1
"2011","E00023337","E00023337","Total",146,48,21,27,1,67,61,6,30,29,0,0,1,0
"2011","E00170910","E00170910","Total",145,79,38,41,0,1,1,0,62,61,0,1,0,3
"2011","E00170911","E00170911","Total",136,86,31,55,0,17,15,2,31,30,0,1,0,2
"2011","E00170912","E00170912","Total",148,49,8,41,10,1,1,0,86,84,0,1,1,2
"2011","E00170913","E00170913","Total",130,19,5,14,38,47,3,44,26,22,0,3,1,0
"2011","E00023339","E00023339","Total",146,32,11,21,0,87,86,1,26,24,0,0,2,1
"2011","E00023340","E00023340","Total",131,23,8,15,0,83,83,0,23,22,0,1,0,2
"2011","E00023342","E00023342","Total",137,25,6,19,0,89,85,4,23,20,0,3,0,0
"2011","E00023343","E00023343","Total",128,53,25,28,3,34,21,13,37,35,1,1,0,1
"2011","E00023347","E00023347","Total",137,43,17,26,1,49,49,0,43,41,0,1,1,1
"2011","E00023341","E00023341","Total",124,60,35,25,0,37,35,2,22,22,0,0,0,5
"2011","E00023349","E00023349","Total",119,34,11,23,0,45,41,4,39,39,0,0,0,1
"2011","E00023350","E00023350","Total",127,50,22,28,0,38,27,11,38,36,1,0,1,1
"2011","E00023351","E00023351","Total",137,61,23,38,1,31,29,2,43,40,0,2,1,1
"2011","E00023358","E00023358","Total",136,67,30,37,0,5,4,1,63,59,0,3,1,1
"2011","E00023345","E00023345","Total",133,24,7,17,0,61,57,4,48,45,1,2,0,0
"2011","E00023346","E00023346","Total",118,17,4,13,0,70,70,0,31,30,0,1,0,0
"2011","E00023348","E00023348","Total",125,19,6,13,3,73,73,0,29,26,0,3,0,1
"2011","E00023352","E00023352","Total",115,40,12,28,0,30,29,1,43,41,0,1,1,2
"2011","E00023353","E00023353","Total",132,34,13,21,0,59,58,1,39,37,0,2,0,0
"2011","E00023005","E00023005","Total",206,50,17,33,20,81,53,28,55,50,0,3,2,0
"2011","E00023007","E00023007","Total",125,89,40,49,1,7,7,0,28,27,0,1,0,0
"2011","E00023010","E00023010","Total",115,17,2,15,0,65,62,3,32,31,0,1,0,1
"2011","E00023013","E00023013","Total",158,65,24,41,1,32,31,1,59,57,2,0,0,1
"2011","E00170905","E00170905","Total",72,14,5,9,0,37,35,2,21,20,1,0,0,0
"2011","E00170906","E00170906","Total",61,8,4,4,0,24,24,0,29,27,0,2,0,0
"2011","E00023015","E00023015","Total",133,19,10,9,1,67,58,9,46,45,0,0,1,0
"2011","E00023019","E00023019","Total",159,25,12,13,1,85,83,2,47,46,0,1,0,1
"2011","E00023020","E00023020","Total",143,17,9,8,0,90,89,1,35,35,0,0,0,1
"2011","E00023022","E00023022","Total",146,19,8,11,0,99,56,43,28,28,0,0,0,0
"2011","E00023025","E00023025","Total",164,32,9,23,0,98,96,2,32,32,0,0,0,2
"2011","E00023016","E00023016","Total",127,29,13,16,0,66,25,41,30,28,0,1,1,2
"2011","E00023018","E00023018","Total",131,44,22,22,1,51,47,4,34,33,1,0,0,1
"2011","E00023023","E00023023","Total",145,31,9,22,0,76,73,3,35,33,0,2,0,3
"2011","E00023024","E00023024","Total",105,32,13,19,0,51,48,3,22,22,0,0,0,0
"2011","E00023028","E00023028","Total",143,36,18,18,0,61,58,3,45,43,0,1,1,1
"2011","E00023001","E00023001","Total",153,85,34,51,0,24,21,3,43,39,0,2,2,1
"2011","E00023027","E00023027","Total",101,61,34,27,0,17,14,3,20,17,3,0,0,3
"2011","E00023029","E00023029","Total",107,47,18,29,1,38,33,5,19,18,1,0,0,2
"2011","E00023030","E00023030","Total",133,91,24,67,1,4,3,1,37,37,0,0,0,0
"2011","E00023031","E00023031","Total",137,61,23,38,1,41,38,3,34,34,0,0,0,0
"2011","E00022583","E00022583","Total",149,21,8,13,0,92,91,1,31,30,0,1,0,5
"2011","E00022622","E00022622","Total",115,17,7,10,1,77,74,3,15,14,0,1,0,5
"2011","E00022624","E00022624","Total",117,59,8,51,9,9,1,8,39,39,0,0,0,1
"2011","E00022625","E00022625","Total",142,83,29,54,1,13,12,1,45,43,0,2,0,0
"2011","E00022586","E00022586","Total",105,44,12,32,0,31,13,18,30,27,0,3,0,0
"2011","E00022587","E00022587","Total",109,59,8,51,1,3,1,2,46,44,0,2,0,0
"2011","E00022588","E00022588","Total",90,41,5,36,0,5,1,4,43,41,0,2,0,1
"2011","E00022589","E00022589","Total",215,58,13,45,11,7,3,4,139,136,1,2,0,0
"2011","E00022623","E00022623","Total",164,72,16,56,2,23,3,20,67,65,0,2,0,0
"2011","E00170916","E00170916","Total",130,50,19,31,0,37,0,37,43,42,0,1,0,0
"2011","E00170923","E00170923","Total",138,45,6,39,25,8,1,7,60,59,0,1,0,0
"2011","E00022582","E00022582","Total",139,81,40,41,2,35,32,3,19,17,0,2,0,2
"2011","E00022585","E00022585","Total",132,89,33,56,1,16,16,0,26,26,0,0,0,0
"2011","E00022591","E00022591","Total",139,90,24,66,0,11,8,3,38,36,0,2,0,0
"2011","E00022592","E00022592","Total",131,78,32,46,0,35,31,4,15,14,0,1,0,3
"2011","E00023285","E00023285","Total",134,65,20,45,1,24,24,0,44,42,0,2,0,0
"2011","E00023289","E00023289","Total",152,76,37,39,10,25,3,22,41,31,3,7,0,0
"2011","E00023308","E00023308","Total",123,60,16,44,0,32,18,14,31,30,0,1,0,0
"2011","E00023312","E00023312","Total",124,54,17,37,1,38,36,2,31,27,0,4,0,0
"2011","E00023290","E00023290","Total",133,57,17,40,11,25,1,24,39,34,2,3,0,1
"2011","E00023292","E00023292","Total",121,86,31,55,1,17,16,1,17,16,0,0,1,0
"2011","E00023298","E00023298","Total",141,76,23,53,1,29,27,2,35,34,0,1,0,0
"2011","E00023300","E00023300","Total",115,78,33,45,2,10,10,0,24,22,1,1,0,1
"2011","E00023301","E00023301","Total",114,73,28,45,0,20,20,0,20,18,0,2,0,1
"2011","E00023140","E00023140","Total",128,69,26,43,1,6,5,1,49,46,0,1,2,3
"2011","E00023159","E00023159","Total",142,60,26,34,0,3,0,3,79,78,0,1,0,0
"2011","E00023160","E00023160","Total",152,62,27,35,0,35,13,22,53,50,0,3,0,2
"2011","E00023162","E00023162","Total",162,100,38,62,2,10,2,8,49,47,0,2,0,1
"2011","E00023164","E00023164","Total",128,72,28,44,1,6,4,2,48,46,0,2,0,1
"2011","E00023165","E00023165","Total",140,79,18,61,1,4,2,2,56,53,0,3,0,0
"2011","E00023141","E00023141","Total",133,57,32,25,0,5,3,2,71,70,0,0,1,0
"2011","E00023167","E00023167","Total",133,92,22,70,1,3,1,2,36,34,0,2,0,1
"2011","E00023168","E00023168","Total",115,71,27,44,0,3,2,1,41,38,0,3,0,0
"2011","E00023171","E00023171","Total",171,72,27,45,0,42,41,1,53,48,0,3,2,4
"2011","E00023172","E00023172","Total",126,75,17,58,0,0,0,0,51,50,0,1,0,0
"2011","E00023176","E00023176","Total",118,73,22,51,0,2,1,1,43,43,0,0,0,0
"2011","E00023175","E00023175","Total",147,9,2,7,9,122,13,109,7,5,0,1,1,0
"2011","E00023177","E00023177","Total",133,80,30,50,1,4,3,1,47,45,1,1,0,1
"2011","E00023179","E00023179","Total",124,83,33,50,0,13,12,1,26,24,0,2,0,2
"2011","E00023184","E00023184","Total",122,99,34,65,1,4,3,1,17,16,0,1,0,1
"2011","E00023185","E00023185","Total",134,66,25,41,4,14,9,5,49,46,0,3,0,1
"2011","E00023188","E00023188","Total",119,96,34,62,0,0,0,0,23,22,0,1,0,0
"2011","E00023142","E00023142","Total",137,86,25,61,0,14,9,5,36,33,0,3,0,1
"2011","E00023145","E00023145","Total",109,64,19,45,0,7,3,4,38,37,1,0,0,0
"2011","E00023147","E00023147","Total",158,86,22,64,25,5,1,4,41,38,0,3,0,1
"2011","E00023182","E00023182","Total",140,85,29,56,0,5,0,5,48,47,0,1,0,2
"2011","E00023183","E00023183","Total",158,83,19,64,0,21,4,17,53,46,2,4,1,1
"2011","E00023186","E00023186","Total",116,69,17,52,1,8,2,6,37,35,0,2,0,1
"2011","E00023143","E00023143","Total",94,74,38,36,2,2,1,1,15,13,0,2,0,1
"2011","E00023144","E00023144","Total",126,93,43,50,0,9,9,0,23,21,0,2,0,1
"2011","E00023146","E00023146","Total",118,102,53,49,0,0,0,0,16,16,0,0,0,0
"2011","E00023148","E00023148","Total",115,89,26,63,0,3,2,1,23,22,0,1,0,0
"2011","E00023187","E00023187","Total",122,95,29,66,0,1,1,0,24,23,0,1,0,2
"2011","E00022490","E00022490","Total",157,68,24,44,0,16,16,0,71,71,0,0,0,2
"2011","E00022494","E00022494","Total",167,90,34,56,0,18,14,4,59,56,0,3,0,0
"2011","E00022497","E00022497","Total",170,93,29,64,7,27,6,21,42,37,0,4,1,1
"2011","E00022498","E00022498","Total",147,59,21,38,1,26,10,16,57,56,0,1,0,4
"2011","E00022501","E00022501","Total",105,68,22,46,1,18,1,17,18,16,0,2,0,0
"2011","E00022489","E00022489","Total",99,40,8,32,0,16,8,8,43,41,0,2,0,0
"2011","E00022503","E00022503","Total",128,71,34,37,0,17,3,14,40,37,1,1,1,0
"2011","E00022504","E00022504","Total",111,49,16,33,0,32,2,30,28,28,0,0,0,2
"2011","E00022505","E00022505","Total",147,81,33,48,1,21,6,15,43,41,0,2,0,1
"2011","E00022506","E00022506","Total",137,48,9,39,1,20,8,12,67,62,0,4,1,1
"2011","E00022520","E00022520","Total",132,71,28,43,0,10,5,5,48,47,0,1,0,3
"2011","E00022523","E00022523","Total",129,72,33,39,0,10,1,9,46,44,0,2,0,1
"2011","E00022526","E00022526","Total",145,97,48,49,1,5,4,1,39,37,0,2,0,3
"2011","E00022528","E00022528","Total",144,73,20,53,0,8,4,4,62,62,0,0,0,1
"2011","E00022531","E00022531","Total",128,68,17,51,4,3,2,1,53,51,0,2,0,0
"2011","E00022536","E00022536","Total",130,67,17,50,1,3,2,1,59,58,0,1,0,0
"2011","E00022537","E00022537","Total",146,69,16,53,0,3,1,2,71,70,0,1,0,3
"2011","E00022577","E00022577","Total",142,75,25,50,2,26,23,3,38,34,0,4,0,1
"2011","E00022579","E00022579","Total",193,81,19,62,8,22,6,16,81,81,0,0,0,1
"2011","E00170956","E00170956","Total",162,76,29,47,0,2,0,2,81,75,0,6,0,3
"2011","E00170963","E00170963","Total",115,51,12,39,0,2,0,2,59,56,0,2,1,3
"2011","E00170965","E00170965","Total",123,32,5,27,13,2,0,2,76,73,0,3,0,0
"2011","E00022538","E00022538","Total",129,51,15,36,4,15,3,12,59,56,0,3,0,0
"2011","E00022539","E00022539","Total",125,78,27,51,0,10,1,9,36,34,0,2,0,1
"2011","E00022543","E00022543","Total",147,54,17,37,1,41,14,27,50,48,0,2,0,1
"2011","E00022545","E00022545","Total",113,56,15,41,0,12,6,6,42,38,0,4,0,3
"2011","E00022549","E00022549","Total",138,56,20,36,0,20,17,3,62,60,0,1,1,0
"2011","E00022550","E00022550","Total",125,71,27,44,2,4,1,3,48,47,0,0,1,0
"2011","E00022551","E00022551","Total",117,19,6,13,0,59,3,56,37,35,0,1,1,2
"2011","E00022553","E00022553","Total",134,51,12,39,2,27,3,24,54,53,0,1,0,0
"2011","E00022556","E00022556","Total",150,64,17,47,1,25,5,20,59,58,0,1,0,1
"2011","E00022561","E00022561","Total",110,61,30,31,2,7,1,6,40,40,0,0,0,0
"2011","E00022562","E00022562","Total",148,41,15,26,0,21,3,18,85,83,0,1,1,1
"2011","E00022871","E00022871","Total",182,113,61,52,0,7,3,4,58,56,0,2,0,4
"2011","E00022872","E00022872","Total",129,59,21,38,0,15,4,11,53,51,0,2,0,2
"2011","E00022873","E00022873","Total",80,57,25,32,0,3,1,2,20,19,0,1,0,0
"2011","E00022874","E00022874","Total",87,28,6,22,23,2,1,1,34,33,1,0,0,0
"2011","E00022875","E00022875","Total",159,96,34,62,1,12,5,7,44,41,1,2,0,6
"2011","E00022906","E00022906","Total",80,39,14,25,0,16,10,6,24,22,1,1,0,1
"2011","E00022869","E00022869","Total",101,50,18,32,0,16,4,12,35,35,0,0,0,0
"2011","E00022876","E00022876","Total",95,48,22,26,0,2,0,2,44,42,0,2,0,1
"2011","E00022881","E00022881","Total",114,60,24,36,0,3,1,2,50,49,0,1,0,1
"2011","E00170954","E00170954","Total",159,46,17,29,4,3,0,3,102,99,0,1,2,4
"2011","E00170971","E00170971","Total",125,52,30,22,0,4,0,4,69,63,0,6,0,0
"2011","E00171037","E00171037","Total",108,46,21,25,0,4,1,3,58,58,0,0,0,0
"2011","E00171040","E00171040","Total",148,63,35,28,0,3,0,3,81,77,1,3,0,1
"2011","E00022878","E00022878","Total",91,40,17,23,2,0,0,0,49,42,1,6,0,0
"2011","E00022879","E00022879","Total",110,50,19,31,0,17,3,14,42,39,0,3,0,1
"2011","E00022880","E00022880","Total",95,59,26,33,0,6,1,5,28,28,0,0,0,2
"2011","E00022885","E00022885","Total",116,71,30,41,0,24,5,19,21,19,0,2,0,0
"2011","E00022887","E00022887","Total",115,81,36,45,2,10,2,8,21,21,0,0,0,1
"2011","E00022888","E00022888","Total",113,60,16,44,1,3,2,1,48,46,0,2,0,1
"2011","E00022889","E00022889","Total",98,82,38,44,0,4,1,3,11,11,0,0,0,1
"2011","E00022890","E00022890","Total",145,50,21,29,1,32,2,30,61,59,0,2,0,1
"2011","E00022892","E00022892","Total",116,33,9,24,0,35,2,33,45,44,0,1,0,3
"2011","E00022893","E00022893","Total",162,88,26,62,2,34,4,30,36,36,0,0,0,2
"2011","E00022896","E00022896","Total",151,90,45,45,4,10,4,6,43,41,0,2,0,4
"2011","E00023293","E00023293","Total",124,105,53,52,1,3,2,1,14,14,0,0,0,1
"2011","E00023295","E00023295","Total",112,94,40,54,0,1,1,0,16,12,0,4,0,1
"2011","E00023297","E00023297","Total",106,99,48,51,0,1,0,1,5,5,0,0,0,1
"2011","E00023299","E00023299","Total",127,112,61,51,0,3,1,2,10,10,0,0,0,2
"2011","E00023277","E00023277","Total",136,80,29,51,0,7,2,5,47,46,1,0,0,2
"2011","E00023296","E00023296","Total",125,84,35,49,0,5,1,4,34,34,0,0,0,2
"2011","E00023302","E00023302","Total",161,117,63,54,1,4,2,2,38,36,0,2,0,1
"2011","E00023303","E00023303","Total",139,82,28,54,2,1,1,0,53,51,0,2,0,1
"2011","E00023304","E00023304","Total",163,117,39,78,1,1,0,1,43,30,11,1,1,1
"2011","E00023320","E00023320","Total",102,78,37,41,0,3,3,0,20,18,0,1,1,1
"2011","E00023327","E00023327","Total",112,86,41,45,1,6,6,0,17,16,0,0,1,2
"2011","E00023329","E00023329","Total",120,75,42,33,1,13,10,3,30,29,0,1,0,1
"2011","E00023359","E00023359","Total",133,68,32,36,0,16,14,2,45,42,0,3,0,4
"2011","E00023361","E00023361","Total",126,52,19,33,0,29,18,11,45,41,0,4,0,0
"2011","E00023321","E00023321","Total",140,64,16,48,0,4,4,0,71,65,0,6,0,1
"2011","E00023331","E00023331","Total",119,58,31,27,1,25,23,2,32,30,0,1,1,3
"2011","E00023360","E00023360","Total",145,86,37,49,0,4,3,1,53,50,0,3,0,2
"2011","E00023362","E00023362","Total",152,87,37,50,1,3,3,0,58,57,1,0,0,3
"2011","E00023365","E00023365","Total",141,26,8,18,0,82,81,1,32,31,0,1,0,1
"2011","E00023354","E00023354","Total",152,74,38,36,0,11,11,0,67,66,0,1,0,0
"2011","E00023357","E00023357","Total",154,85,54,31,4,18,18,0,46,45,0,1,0,1
"2011","E00023363","E00023363","Total",135,73,28,45,3,19,19,0,38,38,0,0,0,2
"2011","E00023364","E00023364","Total",132,73,23,50,1,7,7,0,51,48,0,2,1,0
"2011","E00023366","E00023366","Total",118,50,28,22,2,22,21,1,44,40,1,3,0,0
"2011","E00023323","E00023323","Total",137,81,35,46,0,12,11,1,43,43,0,0,0,1
"2011","E00023325","E00023325","Total",122,68,31,37,1,14,13,1,39,36,0,3,0,0
"2011","E00023328","E00023328","Total",120,54,14,40,0,21,21,0,44,43,0,0,1,1
"2011","E00023332","E00023332","Total",133,47,20,27,0,48,47,1,36,35,0,1,0,2
"2011","E00023333","E00023333","Total",138,71,26,45,1,18,17,1,43,42,0,1,0,5
"2011","E00023322","E00023322","Total",103,54,26,28,0,32,32,0,15,15,0,0,0,2
"2011","E00023326","E00023326","Total",110,63,37,26,1,11,11,0,32,32,0,0,0,3
"2011","E00023330","E00023330","Total",121,47,9,38,2,31,28,3,39,36,0,3,0,2
"2011","E00023334","E00023334","Total",133,52,18,34,1,45,44,1,34,33,0,1,0,1
"2011","E00023335","E00023335","Total",135,50,19,31,0,24,24,0,59,56,0,3,0,2
"2011","E00022563","E00022563","Total",128,61,29,32,0,11,1,10,55,52,0,3,0,1
"2011","E00022568","E00022568","Total",110,39,5,34,0,10,3,7,60,59,0,1,0,1
"2011","E00022569","E00022569","Total",151,50,14,36,0,4,1,3,97,91,2,4,0,0
"2011","E00022570","E00022570","Total",88,58,30,28,3,11,10,1,15,15,0,0,0,1
"2011","E00022571","E00022571","Total",138,55,18,37,0,23,5,18,59,58,0,0,1,1
"2011","E00022572","E00022572","Total",101,40,15,25,1,1,1,0,57,56,0,1,0,2
"2011","E00022533","E00022533","Total",135,85,27,58,0,21,1,20,28,28,0,0,0,1
"2011","E00022552","E00022552","Total",113,79,40,39,0,13,1,12,20,20,0,0,0,1
"2011","E00022557","E00022557","Total",131,48,21,27,0,61,36,25,20,19,0,0,1,2
"2011","E00022558","E00022558","Total",130,54,21,33,1,19,6,13,56,52,0,3,1,0
"2011","E00022559","E00022559","Total",116,58,22,36,0,19,0,19,39,38,0,1,0,0
"2011","E00022877","E00022877","Total",129,7,4,3,4,109,5,104,8,7,0,1,0,1
"2011","E00022882","E00022882","Total",109,63,22,41,3,14,2,12,29,28,0,1,0,0
"2011","E00022884","E00022884","Total",95,49,21,28,0,15,7,8,30,27,0,3,0,1
"2011","E00022886","E00022886","Total",128,64,22,42,0,21,2,19,42,41,0,1,0,1
"2011","E00022891","E00022891","Total",90,70,41,29,0,2,0,2,14,13,0,1,0,4
"2011","E00022894","E00022894","Total",214,70,26,44,0,40,37,3,101,98,0,3,0,3
"2011","E00022895","E00022895","Total",75,41,13,28,0,5,3,2,29,26,0,3,0,0
"2011","E00022897","E00022897","Total",86,30,7,23,6,6,2,4,42,42,0,0,0,2
"2011","E00170957","E00170957","Total",89,26,10,16,0,5,2,3,58,56,0,1,1,0
"2011","E00170959","E00170959","Total",127,45,24,21,2,10,1,9,69,65,0,4,0,1
"2011","E00170967","E00170967","Total",103,53,22,31,0,4,0,4,46,44,0,2,0,0
"2011","E00171038","E00171038","Total",244,114,59,55,0,5,4,1,121,118,1,2,0,4
"2011","E00171065","E00171065","Total",116,71,46,25,1,18,3,15,25,23,0,2,0,1
"2011","E00022532","E00022532","Total",86,47,24,23,0,5,2,3,33,33,0,0,0,1
"2011","E00022573","E00022573","Total",101,30,14,16,0,20,1,19,51,48,0,3,0,0
"2011","E00022574","E00022574","Total",159,79,41,38,1,16,2,14,61,61,0,0,0,2
"2011","E00022575","E00022575","Total",142,80,45,35,0,20,16,4,39,34,0,4,1,3
"2011","E00022576","E00022576","Total",138,68,28,40,0,24,16,8,44,42,0,2,0,2
"2011","E00022540","E00022540","Total",136,68,26,42,0,24,22,2,41,38,0,3,0,3
"2011","E00022541","E00022541","Total",172,36,15,21,0,10,3,7,124,121,1,2,0,2
"2011","E00022542","E00022542","Total",127,66,23,43,0,16,8,8,45,45,0,0,0,0
"2011","E00022546","E00022546","Total",131,84,34,50,0,24,7,17,23,23,0,0,0,0
"2011","E00022547","E00022547","Total",125,49,22,27,2,45,2,43,25,24,0,1,0,4
"2011","E00022534","E00022534","Total",109,46,11,35,0,30,6,24,33,31,0,2,0,0
"2011","E00022535","E00022535","Total",130,63,24,39,0,28,0,28,39,37,0,2,0,0
"2011","E00022544","E00022544","Total",158,61,21,40,0,38,7,31,58,56,1,0,1,1
"2011","E00022548","E00022548","Total",103,39,16,23,0,28,1,27,36,36,0,0,0,0
"2011","E00022554","E00022554","Total",103,25,11,14,0,35,3,32,42,41,0,1,0,1
"2011","E00022555","E00022555","Total",112,46,8,38,0,34,9,25,32,32,0,0,0,0
"2011","E00022560","E00022560","Total",121,58,17,41,1,31,2,29,31,30,0,1,0,0
"2011","E00022564","E00022564","Total",121,52,16,36,1,34,0,34,32,30,0,2,0,2
"2011","E00022565","E00022565","Total",120,39,12,27,0,29,2,27,52,51,0,1,0,0
"2011","E00022566","E00022566","Total",120,58,17,41,0,21,0,21,41,39,0,0,2,0
"2011","E00022567","E00022567","Total",130,58,19,39,0,30,0,30,42,41,0,1,0,0
"2011","E00022599","E00022599","Total",108,88,33,55,0,2,1,1,18,17,0,1,0,0
"2011","E00022601","E00022601","Total",127,65,19,46,0,8,2,6,53,51,0,2,0,1
"2011","E00022603","E00022603","Total",126,72,20,52,0,7,2,5,47,45,0,2,0,0
"2011","E00022604","E00022604","Total",139,78,24,54,0,12,5,7,48,46,1,1,0,1
"2011","E00022605","E00022605","Total",114,99,28,71,0,0,0,0,15,14,0,1,0,0
"2011","E00022598","E00022598","Total",128,55,26,29,1,35,32,3,35,35,0,0,0,2
"2011","E00022606","E00022606","Total",139,71,27,44,0,36,29,7,30,30,0,0,0,2
"2011","E00022611","E00022611","Total",141,67,28,39,0,36,32,4,37,34,0,3,0,1
"2011","E00170925","E00170925","Total",115,54,8,46,1,45,2,43,13,10,1,2,0,2
"2011","E00170926","E00170926","Total",135,6,4,2,0,116,1,115,13,9,1,0,3,0
"2011","E00170928","E00170928","Total",104,5,1,4,0,90,2,88,7,6,1,0,0,2
"2011","E00170929","E00170929","Total",209,5,0,5,0,181,4,177,22,12,7,0,3,1
"2011","E00022580","E00022580","Total",136,78,23,55,2,9,0,9,44,42,0,1,1,3
"2011","E00022597","E00022597","Total",112,25,9,16,0,57,55,2,28,27,0,0,1,2
"2011","E00022607","E00022607","Total",142,79,14,65,1,3,0,3,58,54,1,3,0,1
"2011","E00022608","E00022608","Total",96,28,10,18,1,45,39,6,20,18,0,2,0,2
"2011","E00022609","E00022609","Total",133,91,25,66,0,6,2,4,36,35,0,1,0,0
"2011","E00022610","E00022610","Total",125,85,30,55,1,7,3,4,31,31,0,0,0,1
"2011","E00022590","E00022590","Total",92,59,18,41,0,6,2,4,26,25,0,1,0,1
"2011","E00022593","E00022593","Total",144,94,32,62,1,14,2,12,35,34,0,1,0,0
"2011","E00022594","E00022594","Total",141,76,15,61,0,4,0,4,60,58,0,2,0,1
"2011","E00022595","E00022595","Total",125,79,14,65,1,3,1,2,40,36,0,4,0,2
"2011","E00022596","E00022596","Total",143,60,19,41,0,15,4,11,66,61,0,4,1,2
"2011","E00022600","E00022600","Total",139,66,11,55,2,4,2,2,66,65,0,1,0,1
"2011","E00022773","E00022773","Total",114,83,30,53,0,3,2,1,28,28,0,0,0,0
"2011","E00022774","E00022774","Total",116,69,23,46,0,12,4,8,35,34,0,0,1,0
"2011","E00022803","E00022803","Total",169,72,35,37,0,36,2,34,58,57,0,1,0,3
"2011","E00022804","E00022804","Total",120,63,31,32,1,29,12,17,26,25,0,1,0,1
"2011","E00022806","E00022806","Total",125,38,14,24,0,68,62,6,18,16,0,1,1,1
"2011","E00023236","E00023236","Total",125,84,53,31,0,1,1,0,39,38,1,0,0,1
"2011","E00023258","E00023258","Total",151,81,41,40,0,3,2,1,66,64,1,1,0,1
"2011","E00023262","E00023262","Total",139,81,42,39,0,21,18,3,36,35,0,1,0,1
"2011","E00023267","E00023267","Total",155,91,32,59,1,29,18,11,32,32,0,0,0,2
"2011","E00023235","E00023235","Total",122,55,22,33,5,17,16,1,44,42,0,1,1,1
"2011","E00023237","E00023237","Total",135,63,35,28,0,8,4,4,61,58,0,2,1,3
"2011","E00023260","E00023260","Total",158,50,23,27,4,5,2,3,98,94,0,2,2,1
"2011","E00023264","E00023264","Total",143,76,48,28,1,14,13,1,51,48,1,2,0,1
"2011","E00023254","E00023254","Total",134,93,36,57,0,4,1,3,37,36,0,0,1,0
"2011","E00023255","E00023255","Total",133,84,31,53,1,11,1,10,37,35,0,2,0,0
"2011","E00023256","E00023256","Total",132,88,43,45,1,1,1,0,41,40,0,1,0,1
"2011","E00023257","E00023257","Total",128,87,43,44,1,7,4,3,32,30,0,2,0,1
"2011","E00022800","E00022800","Total",102,44,16,28,0,38,35,3,20,18,0,2,0,0
"2011","E00022801","E00022801","Total",90,33,13,20,1,41,39,2,15,15,0,0,0,0
"2011","E00022802","E00022802","Total",109,35,9,26,1,56,56,0,17,17,0,0,0,0
"2011","E00170931","E00170931","Total",135,75,42,33,1,5,4,1,54,51,0,3,0,0
"2011","E00170932","E00170932","Total",143,86,45,41,0,9,8,1,47,45,0,2,0,1
"2011","E00170934","E00170934","Total",70,29,7,22,1,33,32,1,7,7,0,0,0,0
"2011","E00022777","E00022777","Total",134,41,11,30,0,68,67,1,25,22,0,3,0,0
"2011","E00022778","E00022778","Total",115,36,8,28,1,47,46,1,30,28,0,2,0,1
"2011","E00022783","E00022783","Total",88,51,22,29,1,10,8,2,25,25,0,0,0,1
"2011","E00022807","E00022807","Total",111,61,33,28,1,7,7,0,39,37,1,1,0,3
"2011","E00022809","E00022809","Total",121,38,4,34,1,57,55,2,25,23,0,1,1,0
"2011","E00023240","E00023240","Total",178,87,38,49,2,23,11,12,63,60,0,3,0,3
"2011","E00023261","E00023261","Total",122,93,61,32,0,5,2,3,22,20,0,2,0,2
"2011","E00023269","E00023269","Total",144,83,37,46,0,17,16,1,43,40,0,3,0,1
"2011","E00023270","E00023270","Total",188,81,43,38,0,25,1,24,80,69,1,9,1,2
"2011","E00023238","E00023238","Total",157,34,14,20,3,23,3,20,92,90,1,1,0,5
"2011","E00023263","E00023263","Total",131,57,30,27,0,40,39,1,32,28,0,4,0,2
"2011","E00023268","E00023268","Total",128,46,16,30,1,56,55,1,23,22,0,1,0,2
"2011","E00023271","E00023271","Total",140,42,18,24,0,69,55,14,27,26,0,0,1,2
"2011","E00023275","E00023275","Total",121,37,20,17,0,13,7,6,69,66,1,1,1,2
"2011","E00023234","E00023234","Total",130,62,29,33,2,20,7,13,43,42,0,1,0,3
"2011","E00023239","E00023239","Total",143,51,9,42,1,17,8,9,73,71,0,2,0,1
"2011","E00023245","E00023245","Total",152,37,10,27,10,33,13,20,69,66,1,2,0,3
"2011","E00023272","E00023272","Total",150,52,17,35,2,42,27,15,53,48,2,3,0,1
"2011","E00023274","E00023274","Total",155,76,20,56,0,30,5,25,48,44,0,3,1,1
"2011","E00023276","E00023276","Total",125,43,12,31,2,20,4,16,60,59,0,1,0,0
"2011","E00023241","E00023241","Total",107,50,25,25,4,18,17,1,34,32,0,2,0,1
"2011","E00023246","E00023246","Total",130,68,26,42,0,21,16,5,40,38,0,1,1,1
"2011","E00023259","E00023259","Total",140,30,10,20,0,56,55,1,52,49,1,2,0,2
"2011","E00023265","E00023265","Total",118,11,3,8,1,73,72,1,33,33,0,0,0,0
"2011","E00023266","E00023266","Total",133,18,8,10,0,94,92,2,18,18,0,0,0,3
"2011","E00023273","E00023273","Total",129,24,8,16,0,76,72,4,27,27,0,0,0,2
"2011","E00023243","E00023243","Total",143,62,24,38,1,10,0,10,63,60,0,3,0,7
"2011","E00023244","E00023244","Total",205,56,26,30,2,20,3,17,123,117,0,5,1,4
"2011","E00023247","E00023247","Total",166,45,16,29,1,9,4,5,109,107,0,2,0,2
"2011","E00023249","E00023249","Total",177,43,18,25,1,8,1,7,123,118,0,4,1,2
"2011","E00023250","E00023250","Total",125,43,20,23,0,18,5,13,63,63,0,0,0,1
"2011","E00023242","E00023242","Total",189,63,20,43,12,10,2,8,102,100,0,2,0,2
"2011","E00023248","E00023248","Total",74,22,14,8,1,30,2,28,21,19,0,1,1,0
"2011","E00023251","E00023251","Total",117,30,4,26,0,51,47,4,36,34,0,2,0,0
"2011","E00023252","E00023252","Total",151,48,24,24,0,18,4,14,84,81,0,2,1,1
"2011","E00023253","E00023253","Total",107,41,26,15,1,19,1,18,43,38,0,5,0,3
"2011","E00022779","E00022779","Total",166,52,22,30,1,10,1,9,100,97,0,3,0,3
"2011","E00022784","E00022784","Total",102,9,3,6,1,1,1,0,88,86,1,0,1,3
"2011","E00022787","E00022787","Total",146,63,12,51,0,3,1,2,80,73,0,6,1,0
"2011","E00022805","E00022805","Total",116,64,34,30,2,4,1,3,46,43,0,3,0,0
"2011","E00022808","E00022808","Total",129,53,33,20,1,5,0,5,68,67,0,0,1,2
"2011","E00022768","E00022768","Total",138,67,22,45,1,9,4,5,57,55,0,1,1,4
"2011","E00022780","E00022780","Total",129,59,16,43,0,5,2,3,63,61,0,2,0,2
"2011","E00022781","E00022781","Total",159,71,30,41,0,16,5,11,69,67,1,1,0,3
"2011","E00022786","E00022786","Total",81,2,1,1,1,71,8,63,5,5,0,0,0,2
"2011","E00022789","E00022789","Total",148,60,23,37,2,14,13,1,72,68,0,4,0,0
"2011","E00022776","E00022776","Total",123,59,32,27,0,12,5,7,51,48,0,3,0,1
"2011","E00022782","E00022782","Total",85,39,13,26,3,5,3,2,32,29,1,2,0,6
"2011","E00022785","E00022785","Total",120,65,35,30,1,5,0,5,48,44,0,4,0,1
"2011","E00022810","E00022810","Total",115,62,32,30,3,17,6,11,32,32,0,0,0,1
"2011","E00022811","E00022811","Total",135,74,38,36,1,2,2,0,58,58,0,0,0,0
"2011","E00022775","E00022775","Total",238,101,32,69,5,55,2,53,71,68,0,2,1,6
"2011","E00022788","E00022788","Total",109,68,27,41,1,3,1,2,37,31,1,3,2,0
"2011","E00022790","E00022790","Total",147,49,22,27,15,56,3,53,24,23,0,1,0,3
"2011","E00022791","E00022791","Total",161,31,10,21,0,52,28,24,74,71,0,3,0,4
"2011","E00022769","E00022769","Total",112,56,29,27,0,12,6,6,42,40,0,2,0,2
"2011","E00022770","E00022770","Total",124,65,17,48,1,5,1,4,53,52,0,0,1,0
"2011","E00022771","E00022771","Total",148,59,14,45,1,6,5,1,82,77,0,3,2,0
"2011","E00022796","E00022796","Total",122,71,14,57,1,1,0,1,49,48,0,1,0,0
"2011","E00022799","E00022799","Total",127,53,18,35,2,30,26,4,42,42,0,0,0,0
"2011","E00170935","E00170935","Total",136,69,12,57,4,11,0,11,50,50,0,0,0,2
"2011","E00170937","E00170937","Total",133,16,8,8,27,50,1,49,38,37,0,0,1,2
"2011","E00022793","E00022793","Total",115,69,31,38,0,3,3,0,43,40,0,2,1,0
"2011","E00022794","E00022794","Total",144,76,30,46,3,1,1,0,59,59,0,0,0,5
"2011","E00022797","E00022797","Total",143,55,28,27,1,55,6,49,32,29,0,1,2,0
"2011","E00022798","E00022798","Total",128,85,21,64,2,1,1,0,38,37,0,1,0,2
"2011","E00170939","E00170939","Total",120,47,20,27,0,23,0,23,47,45,0,2,0,3
"2011","E00170940","E00170940","Total",139,51,26,25,1,21,0,21,65,59,0,6,0,1
"2011","E00022745","E00022745","Total",132,108,46,62,0,6,1,5,17,16,0,1,0,1
"2011","E00022747","E00022747","Total",120,90,49,41,0,10,6,4,20,19,0,1,0,0
"2011","E00022750","E00022750","Total",134,111,48,63,2,5,5,0,16,16,0,0,0,0
"2011","E00022752","E00022752","Total",124,80,28,52,0,18,15,3,26,24,0,2,0,0
"2011","E00022753","E00022753","Total",129,91,29,62,1,7,5,2,29,29,0,0,0,1
"2011","E00022755","E00022755","Total",126,93,32,61,0,10,2,8,22,21,0,1,0,1
"2011","E00022757","E00022757","Total",134,86,31,55,2,6,4,2,38,37,0,1,0,2
"2011","E00022761","E00022761","Total",147,90,32,58,1,16,13,3,37,33,0,4,0,3
"2011","E00022764","E00022764","Total",114,84,28,56,0,5,2,3,25,25,0,0,0,0
"2011","E00022727","E00022727","Total",116,57,18,39,2,17,15,2,39,37,0,1,1,1
"2011","E00022730","E00022730","Total",159,50,22,28,1,51,37,14,54,53,0,1,0,3
"2011","E00022744","E00022744","Total",118,90,41,49,0,5,3,2,21,20,0,1,0,2
"2011","E00022756","E00022756","Total",132,88,32,56,1,6,4,2,35,34,0,1,0,2
"2011","E00022758","E00022758","Total",107,66,26,40,0,23,10,13,17,17,0,0,0,1
"2011","E00022724","E00022724","Total",109,65,18,47,0,6,2,4,38,36,0,2,0,0
"2011","E00022759","E00022759","Total",126,59,22,37,0,34,33,1,30,26,2,2,0,3
"2011","E00022766","E00022766","Total",112,79,39,40,2,17,12,5,13,13,0,0,0,1
"2011","E00022767","E00022767","Total",112,84,38,46,0,6,1,5,20,19,0,1,0,2
"2011","E00022734","E00022734","Total",115,21,8,13,0,78,74,4,14,12,0,2,0,2
"2011","E00022735","E00022735","Total",120,13,3,10,1,86,31,55,18,17,0,0,1,2
"2011","E00022738","E00022738","Total",124,68,28,40,0,16,12,4,39,37,1,1,0,1
"2011","E00022741","E00022741","Total",136,83,41,42,0,6,1,5,45,44,0,0,1,2
"2011","E00022742","E00022742","Total",116,83,32,51,0,8,4,4,22,19,0,3,0,3
"2011","E00022754","E00022754","Total",111,88,47,41,0,8,2,6,14,14,0,0,0,1
"2011","E00022748","E00022748","Total",126,64,16,48,0,18,4,14,43,41,0,1,1,1
"2011","E00022749","E00022749","Total",121,71,24,47,0,4,1,3,43,42,0,1,0,3
"2011","E00022751","E00022751","Total",170,66,17,49,9,17,0,17,75,70,0,3,2,3
"2011","E00022760","E00022760","Total",193,59,30,29,9,16,7,9,109,108,0,1,0,0
"2011","E00022762","E00022762","Total",200,78,14,64,3,29,2,27,90,87,0,3,0,0
"2011","E00022728","E00022728","Total",157,72,26,46,1,43,6,37,40,39,0,1,0,1
"2011","E00022729","E00022729","Total",151,69,22,47,5,24,1,23,50,48,0,2,0,3
"2011","E00022765","E00022765","Total",154,90,23,67,2,19,11,8,43,42,1,0,0,0
"2011","E00170962","E00170962","Total",116,90,33,57,3,7,3,4,16,15,0,1,0,0
"2011","E00170970","E00170970","Total",107,72,22,50,1,5,1,4,29,28,0,1,0,0
"2011","E00171088","E00171088","Total",83,57,25,32,0,4,1,3,20,20,0,0,0,2
"2011","E00022726","E00022726","Total",117,73,29,44,0,7,0,7,36,32,0,3,1,1
"2011","E00022731","E00022731","Total",114,59,15,44,1,8,1,7,44,43,0,1,0,2
"2011","E00022732","E00022732","Total",142,76,33,43,5,7,4,3,53,53,0,0,0,1
"2011","E00022733","E00022733","Total",145,75,25,50,3,33,4,29,34,32,0,2,0,0
"2011","E00022763","E00022763","Total",110,60,27,33,1,6,4,2,40,40,0,0,0,3
"2011","E00022736","E00022736","Total",133,55,15,40,0,46,45,1,30,28,0,2,0,2
"2011","E00022737","E00022737","Total",138,61,24,37,0,37,14,23,39,36,0,1,2,1
"2011","E00022739","E00022739","Total",134,38,8,30,2,59,33,26,34,32,0,2,0,1
"2011","E00022740","E00022740","Total",110,13,6,7,3,80,4,76,12,11,0,1,0,2
"2011","E00022743","E00022743","Total",122,38,17,21,0,33,28,5,50,49,0,0,1,1
"2011","E00022746","E00022746","Total",137,48,14,34,0,47,15,32,42,42,0,0,0,0
"2011","E00023418","E00023418","Total",125,47,32,15,1,6,5,1,61,59,0,0,2,10
"2011","E00023436","E00023436","Total",104,69,49,20,1,3,3,0,22,22,0,0,0,9
"2011","E00023440","E00023440","Total",110,44,28,16,0,31,10,21,33,32,0,0,1,2
"2011","E00023442","E00023442","Total",105,62,43,19,1,0,0,0,39,37,0,1,1,3
"2011","E00023443","E00023443","Total",102,30,23,7,1,38,24,14,29,27,0,1,1,4
"2011","E00023446","E00023446","Total",139,34,16,18,0,69,69,0,34,32,0,2,0,2
"2011","E00023412","E00023412","Total",121,70,51,19,1,4,2,2,40,38,1,1,0,6
"2011","E00023432","E00023432","Total",108,59,42,17,2,1,1,0,40,37,2,0,1,6
"2011","E00023433","E00023433","Total",108,55,39,16,1,3,2,1,40,38,1,0,1,9
"2011","E00023437","E00023437","Total",107,28,21,7,0,16,10,6,62,36,19,1,6,1
"2011","E00023444","E00023444","Total",134,52,41,11,0,21,19,2,50,49,1,0,0,11
"2011","E00023449","E00023449","Total",138,61,45,16,0,0,0,0,66,59,2,4,1,11
"2011","E00023881","E00023881","Total",145,60,33,27,1,3,0,3,80,79,1,0,0,1
"2011","E00023886","E00023886","Total",145,48,27,21,2,62,58,4,32,31,0,1,0,1
"2011","E00023889","E00023889","Total",120,24,17,7,0,43,32,11,51,33,16,0,2,2
"2011","E00023890","E00023890","Total",150,53,32,21,1,4,2,2,85,79,0,2,4,7
"2011","E00023893","E00023893","Total",148,29,19,10,2,4,2,2,113,108,0,5,0,0
"2011","E00023894","E00023894","Total",142,81,61,20,0,3,3,0,48,38,8,0,2,10
"2011","E00023880","E00023880","Total",126,55,40,15,0,2,0,2,62,59,1,2,0,7
"2011","E00023885","E00023885","Total",136,69,50,19,0,0,0,0,63,61,0,1,1,4
"2011","E00023888","E00023888","Total",137,64,41,23,1,6,4,2,60,57,0,3,0,6
"2011","E00023922","E00023922","Total",131,70,43,27,0,3,1,2,51,45,2,3,1,7
"2011","E00023923","E00023923","Total",88,47,31,16,0,0,0,0,36,33,2,1,0,5
"2011","E00023924","E00023924","Total",92,54,38,16,1,0,0,0,31,28,1,0,2,6
"2011","E00023925","E00023925","Total",94,62,46,16,0,0,0,0,24,20,1,2,1,8
"2011","E00023434","E00023434","Total",134,32,12,20,0,56,52,4,43,42,0,1,0,3
"2011","E00023435","E00023435","Total",122,85,53,32,1,0,0,0,34,33,0,1,0,2
"2011","E00023438","E00023438","Total",115,47,20,27,0,7,2,5,56,54,0,2,0,5
"2011","E00023441","E00023441","Total",136,70,35,35,0,7,0,7,56,55,0,1,0,3
"2011","E00023445","E00023445","Total",109,38,27,11,0,24,1,23,44,42,0,0,2,3
"2011","E00023413","E00023413","Total",179,118,77,41,0,9,3,6,48,48,0,0,0,4
"2011","E00023415","E00023415","Total",156,88,62,26,1,3,1,2,59,58,0,1,0,5
"2011","E00023429","E00023429","Total",191,58,31,27,1,12,9,3,114,109,1,4,0,6
"2011","E00023439","E00023439","Total",236,76,43,33,1,3,0,3,151,148,0,3,0,5
"2011","E00023447","E00023447","Total",167,77,45,32,0,41,3,38,47,46,0,1,0,2
"2011","E00023448","E00023448","Total",193,98,64,34,0,3,0,3,91,89,0,1,1,1
"2011","E00023419","E00023419","Total",186,87,58,29,1,4,2,2,87,82,1,4,0,7
"2011","E00023422","E00023422","Total",195,102,57,45,1,10,10,0,75,75,0,0,0,7
"2011","E00023426","E00023426","Total",160,87,44,43,0,0,0,0,71,71,0,0,0,2
"2011","E00023427","E00023427","Total",109,42,26,16,0,1,0,1,62,60,0,1,1,4
"2011","E00023430","E00023430","Total",110,26,8,18,0,1,0,1,81,78,0,3,0,2
"2011","E00023431","E00023431","Total",172,92,59,33,1,4,0,4,67,64,1,1,1,8
"2011","E00023774","E00023774","Total",135,40,12,28,2,61,49,12,30,29,0,1,0,2
"2011","E00023787","E00023787","Total",110,22,12,10,1,41,6,35,45,44,0,1,0,1
"2011","E00023790","E00023790","Total",123,29,18,11,1,53,44,9,39,37,2,0,0,1
"2011","E00023791","E00023791","Total",138,21,11,10,1,98,93,5,13,13,0,0,0,5
"2011","E00023793","E00023793","Total",129,45,19,26,0,50,35,15,28,27,0,0,1,6
"2011","E00023788","E00023788","Total",119,10,3,7,0,88,1,87,21,21,0,0,0,0
"2011","E00023789","E00023789","Total",142,16,9,7,0,79,53,26,42,42,0,0,0,5
"2011","E00023792","E00023792","Total",127,22,8,14,0,56,12,44,47,47,0,0,0,2
"2011","E00023794","E00023794","Total",100,19,12,7,0,54,44,10,26,26,0,0,0,1
"2011","E00023795","E00023795","Total",157,55,30,25,2,59,47,12,39,39,0,0,0,2
"2011","E00023796","E00023796","Total",114,49,19,30,0,12,1,11,53,51,0,2,0,0
"2011","E00023414","E00023414","Total",108,26,15,11,0,3,1,2,79,75,0,4,0,0
"2011","E00023416","E00023416","Total",238,67,43,24,3,32,2,30,132,128,0,4,0,4
"2011","E00023421","E00023421","Total",178,57,37,20,0,16,0,16,102,101,0,0,1,3
"2011","E00023423","E00023423","Total",174,71,43,28,1,3,1,2,94,92,0,1,1,5
"2011","E00023424","E00023424","Total",133,52,31,21,2,2,1,1,66,66,0,0,0,11
"2011","E00023425","E00023425","Total",95,31,21,10,1,39,1,38,21,19,2,0,0,3
"2011","E00023428","E00023428","Total",126,46,25,21,1,2,0,2,66,65,1,0,0,11
"2011","E00175242","E00175242","Total",85,30,24,6,0,2,0,2,49,49,0,0,0,4
"2011","E00023882","E00023882","Total",98,32,19,13,0,3,2,1,56,55,0,0,1,7
"2011","E00023883","E00023883","Total",106,11,6,5,6,74,4,70,13,10,1,0,2,2
"2011","E00023892","E00023892","Total",125,8,4,4,1,99,20,79,15,13,0,1,1,2
"2011","E00023899","E00023899","Total",90,34,25,9,0,3,1,2,43,39,2,2,0,10
"2011","E00023900","E00023900","Total",192,3,3,0,0,174,20,154,10,9,0,0,1,5
"2011","E00023902","E00023902","Total",111,31,25,6,0,31,1,30,47,47,0,0,0,2
"2011","E00023903","E00023903","Total",77,18,10,8,0,0,0,0,55,54,0,1,0,4
"2011","E00023887","E00023887","Total",105,44,21,23,1,14,11,3,42,39,1,2,0,4
"2011","E00023891","E00023891","Total",109,66,54,12,0,3,2,1,33,29,4,0,0,7
"2011","E00023895","E00023895","Total",118,60,48,12,1,0,0,0,51,51,0,0,0,6
"2011","E00023896","E00023896","Total",124,52,32,20,1,0,0,0,67,65,0,2,0,4
"2011","E00023897","E00023897","Total",122,49,28,21,0,8,7,1,61,57,0,4,0,4
"2011","E00023898","E00023898","Total",119,78,56,22,0,3,2,1,33,30,0,3,0,5
"2011","E00023905","E00023905","Total",127,58,34,24,0,3,1,2,59,57,0,2,0,7
"2011","E00023907","E00023907","Total",139,58,32,26,0,7,1,6,72,68,0,4,0,2
"2011","E00023910","E00023910","Total",142,77,57,20,0,1,1,0,56,55,0,0,1,8
"2011","E00023912","E00023912","Total",134,35,24,11,1,69,65,4,28,26,0,1,1,1
"2011","E00023914","E00023914","Total",127,68,42,26,0,4,3,1,49,46,1,2,0,6
"2011","E00023917","E00023917","Total",133,20,15,5,3,76,66,10,29,24,1,4,0,5
"2011","E00023918","E00023918","Total",133,54,30,24,0,4,3,1,72,72,0,0,0,3
"2011","E00023901","E00023901","Total",109,14,4,10,1,65,58,7,27,24,0,2,1,2
"2011","E00023906","E00023906","Total",106,16,4,12,1,63,57,6,25,23,0,1,1,1
"2011","E00023908","E00023908","Total",113,21,5,16,1,67,63,4,24,23,0,0,1,0
"2011","E00023909","E00023909","Total",130,69,53,16,1,9,2,7,48,45,3,0,0,3
"2011","E00023911","E00023911","Total",210,5,4,1,0,192,19,173,13,12,0,0,1,0
"2011","E00023913","E00023913","Total",188,76,38,38,0,22,1,21,82,77,3,1,1,8
"2011","E00023849","E00023849","Total",212,55,16,39,4,86,53,33,65,59,0,6,0,2
"2011","E00023856","E00023856","Total",159,33,7,26,4,59,24,35,62,62,0,0,0,1
"2011","E00023858","E00023858","Total",147,28,9,19,0,84,11,73,31,31,0,0,0,4
"2011","E00023862","E00023862","Total",167,48,21,27,7,69,33,36,41,37,0,2,2,2
"2011","E00023864","E00023864","Total",165,46,21,25,2,96,69,27,20,19,0,1,0,1
"2011","E00023852","E00023852","Total",152,61,23,38,2,69,49,20,18,16,0,2,0,2
"2011","E00023857","E00023857","Total",140,27,14,13,0,94,81,13,18,18,0,0,0,1
"2011","E00023873","E00023873","Total",204,48,21,27,3,122,69,53,29,26,0,3,0,2
"2011","E00023876","E00023876","Total",150,56,22,34,1,70,51,19,22,22,0,0,0,1
"2011","E00023879","E00023879","Total",140,36,11,25,0,83,46,37,19,19,0,0,0,2
"2011","E00023854","E00023854","Total",147,68,31,37,3,66,57,9,9,7,0,2,0,1
"2011","E00023855","E00023855","Total",144,59,28,31,2,64,47,17,17,15,0,1,1,2
"2011","E00023874","E00023874","Total",134,47,18,29,1,74,62,12,11,9,1,0,1,1
"2011","E00023875","E00023875","Total",134,51,27,24,1,66,52,14,12,10,0,1,1,4
"2011","E00023877","E00023877","Total",218,35,20,15,5,144,91,53,32,27,1,1,3,2
"2011","E00023860","E00023860","Total",138,32,13,19,1,89,77,12,14,10,0,4,0,2
"2011","E00023861","E00023861","Total",124,41,18,23,2,75,58,17,5,3,2,0,0,1
"2011","E00023863","E00023863","Total",168,31,8,23,0,106,95,11,27,25,0,1,1,4
"2011","E00023865","E00023865","Total",153,34,17,17,2,39,28,11,78,74,0,4,0,0
"2011","E00023866","E00023866","Total",139,13,5,8,1,101,90,11,24,23,0,0,1,0
"2011","E00023867","E00023867","Total",157,12,4,8,3,121,87,34,19,17,0,2,0,2
"2011","E00023851","E00023851","Total",144,29,14,15,4,65,35,30,41,41,0,0,0,5
"2011","E00023853","E00023853","Total",165,28,8,20,8,69,12,57,59,58,0,1,0,1
"2011","E00023872","E00023872","Total",124,22,7,15,0,95,64,31,6,6,0,0,0,1
"2011","E00023878","E00023878","Total",119,7,4,3,0,106,71,35,6,6,0,0,0,0
"2011","E00175260","E00175260","Total",103,7,3,4,0,84,59,25,11,11,0,0,0,1
"2011","E00175261","E00175261","Total",104,12,4,8,1,85,66,19,4,4,0,0,0,2
"2011","E00175262","E00175262","Total",90,7,4,3,0,75,66,9,6,6,0,0,0,2
"2011","E00023585","E00023585","Total",126,51,19,32,4,56,45,11,12,12,0,0,0,3
"2011","E00023586","E00023586","Total",218,33,17,16,1,138,59,79,41,41,0,0,0,5
"2011","E00023597","E00023597","Total",126,28,14,14,2,74,40,34,21,17,1,1,2,1
"2011","E00023598","E00023598","Total",170,25,7,18,4,113,17,96,27,25,0,1,1,1
"2011","E00023601","E00023601","Total",203,51,23,28,1,107,35,72,41,37,0,2,2,3
"2011","E00023599","E00023599","Total",106,26,5,21,1,46,3,43,29,22,0,6,1,4
"2011","E00023603","E00023603","Total",208,35,12,23,1,78,10,68,90,89,0,1,0,4
"2011","E00023604","E00023604","Total",230,30,15,15,0,155,33,122,43,40,0,2,1,2
"2011","E00023610","E00023610","Total",110,12,3,9,1,66,4,62,30,30,0,0,0,1
"2011","E00023612","E00023612","Total",169,23,12,11,1,114,22,92,27,24,0,2,1,4
"2011","E00175237","E00175237","Total",121,14,7,7,1,64,4,60,41,39,0,2,0,1
"2011","E00175238","E00175238","Total",154,53,14,39,1,17,5,12,77,74,0,2,1,6
"2011","E00023587","E00023587","Total",187,48,19,29,9,73,10,63,55,55,0,0,0,2
"2011","E00023588","E00023588","Total",198,58,23,35,4,52,11,41,83,82,0,1,0,1
"2011","E00023591","E00023591","Total",157,53,18,35,0,56,10,46,47,45,0,2,0,1
"2011","E00023615","E00023615","Total",170,37,11,26,0,96,11,85,37,35,0,1,1,0
"2011","E00023616","E00023616","Total",164,56,26,30,0,40,3,37,67,65,0,2,0,1
"2011","E00023589","E00023589","Total",137,29,7,22,1,69,10,59,34,34,0,0,0,4
"2011","E00023590","E00023590","Total",183,58,16,42,3,69,7,62,51,49,0,2,0,2
"2011","E00023592","E00023592","Total",190,45,19,26,1,80,26,54,64,62,0,2,0,0
"2011","E00023593","E00023593","Total",180,56,20,36,8,57,13,44,57,56,0,1,0,2
"2011","E00023595","E00023595","Total",199,64,24,40,1,59,10,49,72,68,0,2,2,3
"2011","E00023596","E00023596","Total",176,34,9,25,2,88,33,55,50,48,0,2,0,2
"2011","E00023606","E00023606","Total",213,42,15,27,4,64,8,56,100,95,0,5,0,3
"2011","E00023611","E00023611","Total",105,24,13,11,0,57,1,56,23,20,1,0,2,1
"2011","E00023613","E00023613","Total",142,23,3,20,0,73,4,69,45,44,0,1,0,1
"2011","E00175232","E00175232","Total",80,3,1,2,1,72,3,69,3,3,0,0,0,1
"2011","E00175234","E00175234","Total",109,23,8,15,1,33,4,29,50,49,0,1,0,2
"2011","E00175236","E00175236","Total",110,3,1,2,0,95,4,91,10,9,0,1,0,2
"2011","E00023859","E00023859","Total",167,18,10,8,0,90,12,78,58,51,0,7,0,1
"2011","E00023869","E00023869","Total",163,53,23,30,2,59,7,52,48,47,0,1,0,1
"2011","E00023870","E00023870","Total",245,39,14,25,1,121,17,104,83,81,0,2,0,1
"2011","E00023871","E00023871","Total",166,34,11,23,4,78,21,57,46,45,0,0,1,4
"2011","E00175233","E00175233","Total",128,13,3,10,0,60,40,20,55,49,2,0,4,0
"2011","E00175235","E00175235","Total",128,13,3,10,0,84,39,45,29,28,0,0,1,2
"2011","E00023600","E00023600","Total",135,42,14,28,0,24,5,19,65,60,1,4,0,4
"2011","E00023602","E00023602","Total",132,34,13,21,0,12,2,10,85,84,0,1,0,1
"2011","E00023605","E00023605","Total",125,45,14,31,1,37,12,25,41,40,0,1,0,1
"2011","E00023608","E00023608","Total",126,43,17,26,1,30,1,29,50,50,0,0,0,2
"2011","E00023609","E00023609","Total",141,39,14,25,3,60,18,42,37,36,0,0,1,2
"2011","E00023614","E00023614","Total",135,22,13,9,0,34,3,31,78,75,0,1,2,1
"2011","E00023777","E00023777","Total",144,56,24,32,1,4,2,2,82,82,0,0,0,1
"2011","E00023779","E00023779","Total",123,56,20,36,2,2,1,1,62,62,0,0,0,1
"2011","E00023784","E00023784","Total",115,46,24,22,0,24,16,8,45,42,0,3,0,0
"2011","E00023806","E00023806","Total",116,54,27,27,1,3,0,3,55,55,0,0,0,3
"2011","E00023807","E00023807","Total",105,56,24,32,0,3,1,2,46,46,0,0,0,0
"2011","E00023808","E00023808","Total",132,57,25,32,0,18,4,14,57,53,0,4,0,0
"2011","E00023781","E00023781","Total",113,51,27,24,0,1,0,1,61,58,0,2,1,0
"2011","E00023782","E00023782","Total",121,63,29,34,0,1,0,1,56,54,0,2,0,1
"2011","E00023785","E00023785","Total",110,52,25,27,1,0,0,0,54,47,0,5,2,3
"2011","E00023803","E00023803","Total",102,51,21,30,0,4,2,2,44,43,0,1,0,3
"2011","E00023805","E00023805","Total",106,72,32,40,0,2,1,1,27,27,0,0,0,5
"2011","E00023809","E00023809","Total",138,65,28,37,0,1,1,0,65,63,0,0,2,7
"2011","E00023810","E00023810","Total",108,57,28,29,0,3,0,3,46,44,0,1,1,2
"2011","E00023780","E00023780","Total",132,44,17,27,0,27,1,26,58,55,0,2,1,3
"2011","E00023783","E00023783","Total",141,54,17,37,0,12,1,11,72,70,0,2,0,3
"2011","E00023786","E00023786","Total",108,38,12,26,2,29,8,21,37,36,1,0,0,2
"2011","E00023797","E00023797","Total",146,33,14,19,5,61,35,26,45,43,0,2,0,2
"2011","E00023802","E00023802","Total",122,46,23,23,0,8,7,1,65,64,0,1,0,3
"2011","E00023804","E00023804","Total",139,25,6,19,0,60,8,52,50,50,0,0,0,4
"2011","E00024087","E00024087","Total",132,43,15,28,0,34,17,17,50,49,0,1,0,5
"2011","E00024088","E00024088","Total",136,40,12,28,1,32,3,29,62,59,0,3,0,1
"2011","E00024090","E00024090","Total",93,25,7,18,0,33,7,26,35,33,0,1,1,0
"2011","E00024093","E00024093","Total",165,49,13,36,0,32,3,29,83,80,0,3,0,1
"2011","E00024094","E00024094","Total",161,31,6,25,0,65,41,24,64,61,0,0,3,1
"2011","E00024095","E00024095","Total",179,36,15,21,2,62,7,55,76,72,0,3,1,3
"2011","E00023765","E00023765","Total",207,64,44,20,0,9,0,9,128,124,0,3,1,6
"2011","E00023766","E00023766","Total",137,70,37,33,1,2,0,2,60,57,0,3,0,4
"2011","E00175244","E00175244","Total",134,54,26,28,1,1,0,1,72,69,0,2,1,6
"2011","E00175246","E00175246","Total",132,54,23,31,0,4,0,4,73,68,0,5,0,1
"2011","E00175259","E00175259","Total",99,53,24,29,1,6,0,6,36,34,0,2,0,3
"2011","E00175264","E00175264","Total",134,69,39,30,0,5,0,5,57,55,0,2,0,3
"2011","E00023745","E00023745","Total",175,95,64,31,0,2,0,2,72,70,0,2,0,6
"2011","E00023746","E00023746","Total",168,76,47,29,2,3,1,2,84,79,0,5,0,3
"2011","E00023747","E00023747","Total",195,70,46,24,1,48,14,34,67,57,3,5,2,9
"2011","E00023755","E00023755","Total",145,98,62,36,1,5,0,5,38,37,0,0,1,3
"2011","E00023758","E00023758","Total",112,65,48,17,0,0,0,0,39,38,0,1,0,8
"2011","E00023759","E00023759","Total",85,62,48,14,0,3,0,3,17,17,0,0,0,3
"2011","E00023761","E00023761","Total",147,70,35,35,0,31,26,5,43,41,1,1,0,3
"2011","E00023750","E00023750","Total",148,72,40,32,2,19,0,19,50,47,0,1,2,5
"2011","E00023751","E00023751","Total",95,35,14,21,0,8,0,8,50,49,1,0,0,2
"2011","E00023767","E00023767","Total",113,59,27,32,0,0,0,0,52,49,0,3,0,2
"2011","E00023769","E00023769","Total",128,65,33,32,0,5,2,3,55,54,0,1,0,3
"2011","E00023770","E00023770","Total",61,35,15,20,0,3,0,3,22,22,0,0,0,1
"2011","E00023771","E00023771","Total",71,43,30,13,0,3,0,3,22,22,0,0,0,3
"2011","E00023773","E00023773","Total",84,28,16,12,0,2,2,0,52,52,0,0,0,2
"2011","E00023775","E00023775","Total",95,33,14,19,0,12,1,11,48,48,0,0,0,2
"2011","E00023776","E00023776","Total",117,15,11,4,0,85,5,80,16,16,0,0,0,1
"2011","E00023778","E00023778","Total",88,41,15,26,0,20,0,20,25,24,0,1,0,2
"2011","E00023798","E00023798","Total",115,36,24,12,2,16,12,4,53,51,0,2,0,8
"2011","E00023799","E00023799","Total",97,55,30,25,0,2,2,0,39,39,0,0,0,1
"2011","E00023800","E00023800","Total",128,70,26,44,0,7,2,5,48,45,0,2,1,3
"2011","E00023801","E00023801","Total",125,41,26,15,1,42,26,16,39,39,0,0,0,2
"2011","E00023744","E00023744","Total",195,91,49,42,0,13,0,13,89,86,0,2,1,2
"2011","E00023753","E00023753","Total",163,71,37,34,0,19,19,0,69,66,0,2,1,4
"2011","E00175243","E00175243","Total",113,29,19,10,0,42,31,11,40,39,0,1,0,2
"2011","E00175245","E00175245","Total",104,38,21,17,1,33,5,28,31,29,2,0,0,1
"2011","E00175247","E00175247","Total",69,25,10,15,0,15,3,12,28,28,0,0,0,1
"2011","E00023748","E00023748","Total",205,66,28,38,3,55,0,55,78,74,1,1,2,3
"2011","E00023749","E00023749","Total",242,81,32,49,1,25,6,19,134,130,0,3,1,1
"2011","E00023752","E00023752","Total",119,39,15,24,0,26,3,23,53,51,0,1,1,1
"2011","E00023768","E00023768","Total",71,36,16,20,0,1,0,1,33,33,0,0,0,1
"2011","E00023772","E00023772","Total",98,23,7,16,0,12,0,12,59,55,0,4,0,4
"2011","E00023511","E00023511","Total",127,40,26,14,1,3,0,3,76,75,0,1,0,7
"2011","E00023512","E00023512","Total",121,43,26,17,1,3,0,3,69,64,0,4,1,5
"2011","E00023513","E00023513","Total",124,21,14,7,0,1,1,0,99,95,0,3,1,3
"2011","E00023514","E00023514","Total",128,50,33,17,0,2,1,1,74,70,0,2,2,2
"2011","E00023517","E00023517","Total",180,72,42,30,3,16,6,10,83,78,0,5,0,6
"2011","E00023518","E00023518","Total",129,43,27,16,0,9,9,0,74,72,0,2,0,3
"2011","E00023519","E00023519","Total",152,66,37,29,1,24,21,3,61,60,0,1,0,0
"2011","E00023516","E00023516","Total",111,60,33,27,0,1,1,0,46,45,0,1,0,4
"2011","E00023520","E00023520","Total",131,66,44,22,0,6,6,0,54,49,0,5,0,5
"2011","E00023521","E00023521","Total",148,65,39,26,1,1,1,0,73,69,0,4,0,8
"2011","E00023522","E00023522","Total",249,89,64,25,10,39,4,35,92,86,2,1,3,19
"2011","E00023524","E00023524","Total",88,57,41,16,0,0,0,0,30,29,0,1,0,1
"2011","E00023526","E00023526","Total",146,44,24,20,1,8,0,8,89,83,3,2,1,4
"2011","E00023813","E00023813","Total",117,37,21,16,0,20,0,20,57,57,0,0,0,3
"2011","E00023815","E00023815","Total",105,44,30,14,1,31,27,4,25,23,0,1,1,4
"2011","E00023822","E00023822","Total",138,51,24,27,0,10,9,1,71,67,1,2,1,6
"2011","E00023828","E00023828","Total",164,57,41,16,0,0,0,0,102,98,0,2,2,5
"2011","E00023830","E00023830","Total",142,55,27,28,1,4,1,3,78,71,4,1,2,4
"2011","E00023836","E00023836","Total",176,58,43,15,0,2,0,2,109,105,1,1,2,7
"2011","E00023884","E00023884","Total",108,72,56,16,1,0,0,0,28,25,0,2,1,7
"2011","E00023904","E00023904","Total",124,51,31,20,3,0,0,0,65,62,1,2,0,5
"2011","E00023916","E00023916","Total",114,38,22,16,0,0,0,0,73,73,0,0,0,3
"2011","E00023919","E00023919","Total",120,76,53,23,1,2,0,2,26,21,1,1,3,15
"2011","E00023920","E00023920","Total",102,42,22,20,1,2,0,2,51,49,0,2,0,6
"2011","E00023921","E00023921","Total",128,74,50,24,1,0,0,0,50,49,0,1,0,3
"2011","E00175210","E00175210","Total",142,46,31,15,0,1,0,1,93,90,2,0,1,2
"2011","E00175211","E00175211","Total",139,50,26,24,7,1,0,1,77,75,1,1,0,4
"2011","E00023564","E00023564","Total",170,25,12,13,0,116,103,13,24,22,0,1,1,5
"2011","E00023580","E00023580","Total",159,6,5,1,2,135,111,24,14,12,0,0,2,2
"2011","E00023581","E00023581","Total",220,19,13,6,1,180,159,21,13,12,0,1,0,7
"2011","E00175221","E00175221","Total",87,7,5,2,1,69,56,13,6,6,0,0,0,4
"2011","E00175263","E00175263","Total",84,12,7,5,0,60,44,16,11,11,0,0,0,1
"2011","E00175268","E00175268","Total",135,21,14,7,0,104,84,20,8,6,0,0,2,2
"2011","E00175274","E00175274","Total",93,11,6,5,1,74,63,11,6,5,0,0,1,1
"2011","E00023754","E00023754","Total",144,28,21,7,0,81,71,10,32,32,0,0,0,3
"2011","E00023756","E00023756","Total",137,34,22,12,0,76,73,3,24,22,0,0,2,3
"2011","E00023757","E00023757","Total",83,4,2,2,0,40,37,3,39,37,0,2,0,0
"2011","E00023760","E00023760","Total",102,31,18,13,0,58,54,4,13,12,0,1,0,0
"2011","E00023762","E00023762","Total",186,19,8,11,1,122,75,47,36,35,1,0,0,8
"2011","E00023763","E00023763","Total",163,35,16,19,3,74,65,9,46,44,0,2,0,5
"2011","E00023764","E00023764","Total",179,52,28,24,1,61,24,37,63,62,0,1,0,2
"2011","E00175220","E00175220","Total",123,25,16,9,2,50,21,29,44,42,0,2,0,2
"2011","E00175265","E00175265","Total",124,16,7,9,0,84,55,29,22,21,0,0,1,2
"2011","E00175271","E00175271","Total",137,19,9,10,5,71,63,8,39,37,1,1,0,3
"2011","E00175272","E00175272","Total",118,10,6,4,1,96,68,28,11,11,0,0,0,0
"2011","E00023567","E00023567","Total",162,43,18,25,1,87,78,9,28,27,0,1,0,3
"2011","E00023573","E00023573","Total",162,21,10,11,1,121,28,93,18,18,0,0,0,1
"2011","E00175266","E00175266","Total",141,40,23,17,3,81,72,9,16,13,0,2,1,1
"2011","E00175267","E00175267","Total",124,17,6,11,0,92,55,37,13,12,0,0,1,2
"2011","E00023569","E00023569","Total",124,23,13,10,4,66,62,4,31,30,0,0,1,0
"2011","E00023571","E00023571","Total",192,14,8,6,3,146,50,96,27,26,0,0,1,2
"2011","E00175269","E00175269","Total",111,15,9,6,0,72,52,20,22,21,0,1,0,2
"2011","E00175270","E00175270","Total",111,24,12,12,0,53,43,10,31,30,0,1,0,3
"2011","E00175273","E00175273","Total",107,16,6,10,2,74,56,18,15,14,0,0,1,0
"2011","E00023570","E00023570","Total",191,71,36,35,0,60,33,27,55,53,0,1,1,5
"2011","E00023577","E00023577","Total",236,55,28,27,6,68,9,59,102,99,1,1,1,5
"2011","E00023578","E00023578","Total",173,27,14,13,0,85,76,9,60,57,0,3,0,1
"2011","E00023572","E00023572","Total",208,24,15,9,0,12,6,6,167,164,0,3,0,5
"2011","E00023575","E00023575","Total",189,28,14,14,1,102,17,85,53,50,0,2,1,5
"2011","E00023579","E00023579","Total",223,5,4,1,2,60,2,58,152,146,2,1,3,4
"2011","E00023565","E00023565","Total",203,55,21,34,7,82,68,14,57,55,0,2,0,2
"2011","E00023566","E00023566","Total",200,63,24,39,0,87,75,12,47,47,0,0,0,3
"2011","E00023574","E00023574","Total",219,38,25,13,1,138,118,20,38,37,0,1,0,4
"2011","E00023576","E00023576","Total",193,40,27,13,0,108,92,16,38,38,0,0,0,7
"2011","E00024091","E00024091","Total",121,30,14,16,2,66,58,8,21,20,0,1,0,2
"2011","E00024097","E00024097","Total",125,36,21,15,3,65,52,13,18,17,0,1,0,3
"2011","E00024099","E00024099","Total",108,7,5,2,0,79,67,12,16,14,0,0,2,6
"2011","E00024100","E00024100","Total",133,17,13,4,0,98,84,14,12,11,0,0,1,6
"2011","E00024103","E00024103","Total",113,11,4,7,3,77,68,9,18,17,0,0,1,4
"2011","E00024089","E00024089","Total",207,60,23,37,3,43,3,40,96,91,0,3,2,5
"2011","E00024092","E00024092","Total",196,38,10,28,7,104,7,97,45,42,0,3,0,2
"2011","E00024096","E00024096","Total",95,8,4,4,6,74,4,70,5,5,0,0,0,2
"2011","E00024098","E00024098","Total",176,51,22,29,0,18,5,13,101,99,1,1,0,6
"2011","E00175200","E00175200","Total",98,14,4,10,0,69,8,61,14,14,0,0,0,1
"2011","E00175275","E00175275","Total",90,3,2,1,0,83,2,81,4,4,0,0,0,0
"2011","E00175276","E00175276","Total",101,21,11,10,0,42,19,23,37,36,0,1,0,1
"2011","E00024075","E00024075","Total",144,34,16,18,2,69,51,18,37,33,1,0,3,2
"2011","E00024076","E00024076","Total",129,22,11,11,1,81,65,16,20,20,0,0,0,5
"2011","E00024104","E00024104","Total",124,21,12,9,5,58,43,15,38,34,0,4,0,2
"2011","E00024105","E00024105","Total",92,31,15,16,2,21,21,0,34,33,0,1,0,4
"2011","E00024106","E00024106","Total",111,9,3,6,0,84,72,12,15,15,0,0,0,3
"2011","E00024073","E00024073","Total",132,19,8,11,2,84,70,14,25,25,0,0,0,2
"2011","E00024079","E00024079","Total",119,13,6,7,0,89,82,7,14,13,0,1,0,3
"2011","E00024080","E00024080","Total",118,10,6,4,0,89,77,12,16,16,0,0,0,3
"2011","E00024101","E00024101","Total",162,38,21,17,14,83,56,27,25,23,0,1,1,2
"2011","E00024107","E00024107","Total",102,13,7,6,0,74,32,42,13,12,0,0,1,2
"2011","E00175201","E00175201","Total",121,20,4,16,20,24,7,17,53,52,0,0,1,4
"2011","E00175277","E00175277","Total",126,10,7,3,3,79,54,25,32,31,0,0,1,2
"2011","E00175279","E00175279","Total",109,12,7,5,0,55,8,47,38,38,0,0,0,4
"2011","E00024072","E00024072","Total",147,45,16,29,2,65,55,10,30,29,0,1,0,5
"2011","E00024074","E00024074","Total",158,22,9,13,1,101,72,29,30,29,0,1,0,4
"2011","E00024078","E00024078","Total",121,19,8,11,3,73,63,10,21,21,0,0,0,5
"2011","E00024081","E00024081","Total",141,16,7,9,2,94,89,5,28,25,1,2,0,1
"2011","E00023819","E00023819","Total",167,44,33,11,0,12,0,12,98,88,4,3,3,13
"2011","E00023820","E00023820","Total",130,50,34,16,1,1,0,1,69,65,1,1,2,9
"2011","E00023826","E00023826","Total",155,59,38,21,2,5,1,4,80,73,2,2,3,9
"2011","E00023827","E00023827","Total",133,53,33,20,1,1,0,1,69,63,3,2,1,9
"2011","E00023829","E00023829","Total",88,49,34,15,1,2,1,1,27,25,1,1,0,9
"2011","E00023837","E00023837","Total",106,18,12,6,2,3,0,3,82,80,2,0,0,1
"2011","E00023842","E00023842","Total",160,31,23,8,0,7,0,7,115,113,0,1,1,7
"2011","E00023834","E00023834","Total",190,57,39,18,2,18,0,18,107,96,1,1,9,6
"2011","E00023839","E00023839","Total",170,71,40,31,2,8,1,7,73,71,2,0,0,16
"2011","E00023840","E00023840","Total",176,55,30,25,4,32,12,20,81,80,0,0,1,4
"2011","E00023841","E00023841","Total",167,56,32,24,1,7,0,7,91,85,2,1,3,12
"2011","E00023843","E00023843","Total",116,41,31,10,0,7,0,7,61,55,2,2,2,7
"2011","E00023844","E00023844","Total",145,32,18,14,0,7,0,7,106,103,1,2,0,0
"2011","E00023845","E00023845","Total",213,36,26,10,0,32,11,21,138,136,0,0,2,7
"2011","E00023811","E00023811","Total",144,51,32,19,0,6,0,6,83,79,1,2,1,4
"2011","E00023816","E00023816","Total",109,42,27,15,0,42,0,42,20,13,1,0,6,5
"2011","E00023817","E00023817","Total",134,81,60,21,0,1,0,1,43,40,2,1,0,9
"2011","E00023821","E00023821","Total",129,61,47,14,0,3,1,2,59,58,0,1,0,6
"2011","E00023847","E00023847","Total",72,47,34,13,0,0,0,0,22,22,0,0,0,3
"2011","E00023848","E00023848","Total",136,40,26,14,1,5,0,5,84,76,0,3,5,6
"2011","E00023823","E00023823","Total",155,81,52,29,1,3,1,2,65,63,0,1,1,5
"2011","E00023825","E00023825","Total",108,33,19,14,0,1,0,1,68,65,1,1,1,6
"2011","E00023831","E00023831","Total",129,9,7,2,0,7,0,7,112,110,0,0,2,1
"2011","E00023832","E00023832","Total",127,39,27,12,0,3,0,3,80,79,0,1,0,5
"2011","E00023833","E00023833","Total",132,45,31,14,0,1,0,1,85,83,0,0,2,1
"2011","E00023835","E00023835","Total",135,9,5,4,0,13,0,13,109,107,0,2,0,4
"2011","E00023838","E00023838","Total",112,12,10,2,0,4,0,4,95,92,0,2,1,1
"2011","E00024117","E00024117","Total",165,45,29,16,0,28,22,6,78,75,1,0,2,14
"2011","E00024118","E00024118","Total",173,71,44,27,0,4,0,4,78,70,2,3,3,20
"2011","E00024135","E00024135","Total",142,14,11,3,0,118,10,108,8,6,0,0,2,2
"2011","E00024137","E00024137","Total",146,11,8,3,1,53,0,53,77,74,1,0,2,4
"2011","E00024140","E00024140","Total",196,61,48,13,0,30,0,30,89,82,3,0,4,16
"2011","E00175207","E00175207","Total",108,40,23,17,0,6,1,5,58,55,1,2,0,4
"2011","E00175218","E00175218","Total",109,19,12,7,0,27,1,26,51,49,0,1,1,12
"2011","E00175219","E00175219","Total",97,40,30,10,0,9,0,9,39,39,0,0,0,9
"2011","E00023488","E00023488","Total",192,68,36,32,1,8,0,8,112,107,0,0,5,3
"2011","E00023495","E00023495","Total",135,64,48,16,0,7,0,7,59,56,2,0,1,5
"2011","E00023503","E00023503","Total",107,20,16,4,1,4,0,4,75,72,0,1,2,7
"2011","E00023505","E00023505","Total",153,47,28,19,1,5,0,5,93,88,0,3,2,7
"2011","E00023506","E00023506","Total",122,12,9,3,0,8,1,7,99,95,0,1,3,3
"2011","E00023510","E00023510","Total",118,16,10,6,0,1,0,1,98,95,2,1,0,3
"2011","E00023500","E00023500","Total",165,44,29,15,0,4,0,4,112,111,1,0,0,5
"2011","E00023501","E00023501","Total",124,59,41,18,1,1,1,0,56,54,1,0,1,7
"2011","E00023504","E00023504","Total",86,11,5,6,0,5,0,5,66,66,0,0,0,4
"2011","E00023507","E00023507","Total",121,25,17,8,0,5,2,3,89,83,1,3,2,2
"2011","E00023508","E00023508","Total",136,29,15,14,0,1,0,1,102,100,1,0,1,4
"2011","E00023509","E00023509","Total",112,30,25,5,1,4,0,4,67,64,0,1,2,10
"2011","E00023487","E00023487","Total",105,43,29,14,0,10,8,2,45,43,0,1,1,7
"2011","E00023489","E00023489","Total",148,53,31,22,0,3,2,1,90,85,0,2,3,2
"2011","E00023490","E00023490","Total",204,56,25,31,0,9,1,8,136,129,5,1,1,3
"2011","E00023493","E00023493","Total",119,43,11,32,0,3,1,2,65,63,0,2,0,8
"2011","E00023494","E00023494","Total",186,36,20,16,1,8,3,5,136,134,0,2,0,5
"2011","E00023529","E00023529","Total",130,25,16,9,1,54,0,54,47,45,1,0,1,3
"2011","E00023486","E00023486","Total",163,34,16,18,1,15,15,0,110,107,0,3,0,3
"2011","E00023496","E00023496","Total",134,40,20,20,0,0,0,0,90,84,0,3,3,4
"2011","E00023515","E00023515","Total",133,26,15,11,0,13,0,13,92,92,0,0,0,2
"2011","E00023523","E00023523","Total",109,33,24,9,1,11,2,9,62,59,0,2,1,2
"2011","E00023525","E00023525","Total",126,55,37,18,0,4,4,0,62,60,0,0,2,5
"2011","E00023527","E00023527","Total",233,41,24,17,1,11,0,11,172,169,0,2,1,8
"2011","E00023528","E00023528","Total",142,28,21,7,0,17,5,12,91,88,0,1,2,6
"2011","E00023491","E00023491","Total",186,42,22,20,1,94,40,54,46,44,0,1,1,3
"2011","E00023492","E00023492","Total",110,44,23,21,1,14,12,2,50,48,0,1,1,1
"2011","E00023497","E00023497","Total",128,75,48,27,0,0,0,0,52,52,0,0,0,1
"2011","E00023498","E00023498","Total",136,79,45,34,0,6,0,6,41,38,0,2,1,10
"2011","E00023499","E00023499","Total",140,40,25,15,2,46,8,38,49,43,1,4,1,3
"2011","E00023502","E00023502","Total",151,87,56,31,1,0,0,0,48,43,3,1,1,15
"2011","E00023812","E00023812","Total",118,35,26,9,3,10,2,8,68,67,0,0,1,2
"2011","E00023814","E00023814","Total",240,74,32,42,3,97,92,5,58,54,0,4,0,8
"2011","E00023818","E00023818","Total",180,58,45,13,1,14,5,9,98,90,2,3,3,9
"2011","E00023824","E00023824","Total",133,34,14,20,1,37,4,33,53,49,0,2,2,8
"2011","E00023846","E00023846","Total",153,25,8,17,1,79,44,35,44,38,5,0,1,4
"2011","E00024121","E00024121","Total",154,47,15,32,2,24,0,24,74,72,2,0,0,7
"2011","E00024127","E00024127","Total",127,31,18,13,0,49,0,49,41,38,0,3,0,6
"2011","E00024128","E00024128","Total",134,49,28,21,1,3,0,3,77,74,0,2,1,4
"2011","E00024133","E00024133","Total",234,18,10,8,0,7,0,7,201,190,6,1,4,8
"2011","E00024138","E00024138","Total",153,17,12,5,1,26,6,20,105,105,0,0,0,4
"2011","E00175193","E00175193","Total",138,18,12,6,0,38,23,15,77,73,1,3,0,5
"2011","E00175194","E00175194","Total",136,20,15,5,1,7,4,3,96,94,1,1,0,12
"2011","E00024122","E00024122","Total",144,20,11,9,1,74,27,47,43,42,1,0,0,6
"2011","E00024123","E00024123","Total",126,13,6,7,0,99,6,93,12,10,0,1,1,2
"2011","E00024124","E00024124","Total",185,66,37,29,1,21,0,21,88,87,0,1,0,9
"2011","E00024125","E00024125","Total",128,44,23,21,0,13,0,13,64,60,0,3,1,7
"2011","E00024126","E00024126","Total",122,50,25,25,0,41,30,11,31,28,0,2,1,0
"2011","E00024129","E00024129","Total",168,79,46,33,0,2,2,0,71,69,0,2,0,16
"2011","E00024130","E00024130","Total",230,63,38,25,0,38,0,38,124,118,1,2,3,5
"2011","E00024112","E00024112","Total",144,18,13,5,0,29,1,28,90,84,1,1,4,7
"2011","E00024114","E00024114","Total",148,20,14,6,0,89,23,66,37,36,0,1,0,2
"2011","E00175189","E00175189","Total",78,17,5,12,0,25,24,1,32,27,3,1,1,4
"2011","E00175190","E00175190","Total",104,12,6,6,0,32,26,6,59,54,2,1,2,1
"2011","E00175191","E00175191","Total",90,13,6,7,3,15,11,4,58,54,0,1,3,1
"2011","E00175192","E00175192","Total",87,4,1,3,0,27,4,23,52,52,0,0,0,4
"2011","E00175196","E00175196","Total",104,6,1,5,0,18,15,3,73,67,2,0,4,7
"2011","E00024108","E00024108","Total",136,4,1,3,0,99,2,97,30,28,0,1,1,3
"2011","E00024110","E00024110","Total",145,30,23,7,7,60,44,16,39,37,1,1,0,9
"2011","E00024134","E00024134","Total",212,54,31,23,0,94,47,47,56,56,0,0,0,8
"2011","E00024136","E00024136","Total",146,19,9,10,0,62,34,28,61,61,0,0,0,4
"2011","E00175195","E00175195","Total",106,25,12,13,0,11,5,6,66,66,0,0,0,4
"2011","E00023468","E00023468","Total",154,72,35,37,0,10,5,5,68,66,0,2,0,4
"2011","E00023470","E00023470","Total",125,83,55,28,2,8,2,6,32,31,0,1,0,0
"2011","E00023471","E00023471","Total",132,41,25,16,1,45,5,40,43,43,0,0,0,2
"2011","E00023472","E00023472","Total",113,41,24,17,0,29,1,28,43,39,0,1,3,0
"2011","E00023475","E00023475","Total",109,57,35,22,0,20,19,1,30,29,0,1,0,2
"2011","E00023478","E00023478","Total",183,74,54,20,0,41,4,37,63,58,1,4,0,5
"2011","E00023481","E00023481","Total",113,50,31,19,0,18,10,8,39,35,0,3,1,6
"2011","E00023456","E00023456","Total",158,65,33,32,0,31,30,1,58,47,0,11,0,4
"2011","E00023465","E00023465","Total",114,74,45,29,0,9,9,0,30,25,0,5,0,1
"2011","E00023466","E00023466","Total",173,74,44,30,0,28,6,22,64,64,0,0,0,7
"2011","E00023476","E00023476","Total",219,102,39,63,0,9,5,4,101,100,0,1,0,7
"2011","E00023477","E00023477","Total",172,48,36,12,0,88,10,78,33,30,0,3,0,3
"2011","E00023479","E00023479","Total",160,53,31,22,0,1,1,0,103,100,0,3,0,3
"2011","E00023480","E00023480","Total",136,31,15,16,1,22,7,15,78,76,0,1,1,4
"2011","E00023482","E00023482","Total",72,26,8,18,0,0,0,0,39,39,0,0,0,7
"2011","E00023454","E00023454","Total",128,39,21,18,2,18,0,18,61,59,0,0,2,8
"2011","E00023458","E00023458","Total",138,63,31,32,7,26,18,8,40,40,0,0,0,2
"2011","E00023459","E00023459","Total",106,39,22,17,0,8,0,8,58,58,0,0,0,1
"2011","E00023462","E00023462","Total",132,56,31,25,0,33,31,2,40,40,0,0,0,3
"2011","E00023464","E00023464","Total",117,54,25,29,7,11,7,4,43,40,0,3,0,2
"2011","E00023483","E00023483","Total",205,49,25,24,1,105,38,67,48,44,0,4,0,2
"2011","E00023485","E00023485","Total",95,16,6,10,0,4,1,3,71,68,1,2,0,4
"2011","E00175185","E00175185","Total",139,20,6,14,0,74,68,6,45,45,0,0,0,0
"2011","E00175188","E00175188","Total",118,47,28,19,2,26,19,7,42,40,0,1,1,1
"2011","E00024077","E00024077","Total",176,74,29,45,0,28,8,20,74,71,0,3,0,0
"2011","E00024083","E00024083","Total",140,53,17,36,0,48,28,20,39,39,0,0,0,0
"2011","E00024084","E00024084","Total",157,67,28,39,0,45,2,43,44,44,0,0,0,1
"2011","E00024085","E00024085","Total",156,43,21,22,1,76,70,6,34,33,0,1,0,2
"2011","E00024086","E00024086","Total",142,19,10,9,1,104,95,9,18,17,0,0,1,0
"2011","E00023451","E00023451","Total",245,77,43,34,2,35,5,30,127,118,2,5,2,4
"2011","E00023460","E00023460","Total",125,39,16,23,5,37,13,24,41,39,0,1,1,3
"2011","E00023461","E00023461","Total",244,33,21,12,0,51,0,51,157,154,0,3,0,3
"2011","E00023450","E00023450","Total",155,36,23,13,1,83,20,63,31,31,0,0,0,4
"2011","E00023455","E00023455","Total",136,43,26,17,0,35,2,33,55,54,1,0,0,3
"2011","E00023467","E00023467","Total",184,42,22,20,2,100,6,94,35,34,0,1,0,5
"2011","E00023484","E00023484","Total",141,52,30,22,0,29,0,29,58,55,0,3,0,2
"2011","E00023623","E00023623","Total",128,44,30,14,0,1,1,0,74,72,0,0,2,9
"2011","E00023624","E00023624","Total",118,48,34,14,0,7,1,6,60,54,0,1,5,3
"2011","E00023629","E00023629","Total",108,56,44,12,2,0,0,0,41,38,1,1,1,9
"2011","E00023632","E00023632","Total",122,66,50,16,0,4,1,3,47,44,1,1,1,5
"2011","E00023634","E00023634","Total",130,86,61,25,0,1,0,1,32,31,1,0,0,11
"2011","E00023639","E00023639","Total",102,40,30,10,0,3,0,3,54,50,1,2,1,5
"2011","E00023622","E00023622","Total",143,75,57,18,1,3,0,3,51,46,0,3,2,13
"2011","E00023628","E00023628","Total",134,56,15,41,0,4,0,4,72,68,0,2,2,2
"2011","E00023631","E00023631","Total",130,63,44,19,1,4,0,4,58,56,0,2,0,4
"2011","E00023637","E00023637","Total",122,68,46,22,0,2,0,2,43,41,1,0,1,9
"2011","E00023640","E00023640","Total",123,68,43,25,0,3,0,3,43,40,1,0,2,9
"2011","E00023641","E00023641","Total",115,50,30,20,0,7,0,7,54,52,0,1,1,4
"2011","E00023644","E00023644","Total",135,25,13,12,0,7,2,5,97,96,0,1,0,6
"2011","E00023647","E00023647","Total",135,40,20,20,0,13,9,4,64,61,0,0,3,18
"2011","E00023648","E00023648","Total",171,54,37,17,0,20,17,3,91,88,0,2,1,6
"2011","E00023650","E00023650","Total",100,36,17,19,0,3,1,2,59,58,0,1,0,2
"2011","E00023651","E00023651","Total",160,58,38,20,0,7,1,6,83,82,1,0,0,12
"2011","E00023617","E00023617","Total",398,67,30,37,1,10,7,3,311,303,0,8,0,9
"2011","E00023625","E00023625","Total",126,58,45,13,0,6,0,6,55,54,0,0,1,7
"2011","E00023627","E00023627","Total",109,42,21,21,0,2,1,1,60,59,0,1,0,5
"2011","E00023652","E00023652","Total",49,13,8,5,0,5,0,5,31,30,1,0,0,0
"2011","E00023656","E00023656","Total",166,53,31,22,1,8,0,8,98,96,0,1,1,6
"2011","E00023619","E00023619","Total",237,43,26,17,12,88,32,56,85,83,0,0,2,9
"2011","E00175183","E00175183","Total",216,61,41,20,3,15,5,10,126,124,0,0,2,11
"2011","E00175184","E00175184","Total",92,13,7,6,2,5,0,5,70,69,0,1,0,2
"2011","E00175216","E00175216","Total",100,38,26,12,0,2,0,2,60,58,1,1,0,0
"2011","E00023633","E00023633","Total",127,51,29,22,1,4,0,4,62,61,0,1,0,9
"2011","E00023646","E00023646","Total",107,15,5,10,0,65,3,62,26,25,0,1,0,1
"2011","E00023649","E00023649","Total",142,17,10,7,0,51,3,48,72,72,0,0,0,2
"2011","E00175186","E00175186","Total",91,7,2,5,6,25,2,23,50,44,2,1,3,3
"2011","E00175187","E00175187","Total",137,44,33,11,0,10,1,9,82,76,0,3,3,1
"2011","E00175215","E00175215","Total",107,5,1,4,0,71,10,61,31,29,1,1,0,0
"2011","E00023621","E00023621","Total",153,49,20,29,1,11,11,0,88,86,0,1,1,4
"2011","E00023626","E00023626","Total",169,57,36,21,0,0,0,0,109,109,0,0,0,3
"2011","E00023635","E00023635","Total",155,52,29,23,1,3,1,2,96,93,0,2,1,3
"2011","E00023643","E00023643","Total",142,58,33,25,1,1,0,1,79,73,0,6,0,3
"2011","E00023653","E00023653","Total",135,65,31,34,1,1,1,0,67,63,0,4,0,1
"2011","E00023655","E00023655","Total",124,48,30,18,0,0,0,0,70,64,1,4,1,6
"2011","E00175181","E00175181","Total",178,57,34,23,8,47,32,15,62,59,0,1,2,4
"2011","E00175182","E00175182","Total",94,13,9,4,15,11,2,9,54,50,0,3,1,1
"2011","E00023618","E00023618","Total",155,57,35,22,0,2,0,2,91,90,0,0,1,5
"2011","E00023620","E00023620","Total",147,27,18,9,1,21,4,17,98,92,0,3,3,0
"2011","E00023630","E00023630","Total",157,66,39,27,0,1,0,1,88,86,0,2,0,2
"2011","E00023636","E00023636","Total",177,54,32,22,0,12,0,12,98,93,0,2,3,13
"2011","E00023638","E00023638","Total",129,25,12,13,1,53,4,49,50,49,0,0,1,0
"2011","E00023699","E00023699","Total",79,25,20,5,0,13,0,13,38,38,0,0,0,3
"2011","E00023702","E00023702","Total",154,22,14,8,1,28,27,1,100,95,0,3,2,3
"2011","E00023725","E00023725","Total",186,35,16,19,0,7,0,7,143,143,0,0,0,1
"2011","E00023728","E00023728","Total",182,55,29,26,1,2,0,2,120,116,1,3,0,4
"2011","E00023733","E00023733","Total",190,51,26,25,0,1,0,1,136,132,1,1,2,2
"2011","E00023734","E00023734","Total",158,74,54,20,2,0,0,0,68,64,1,3,0,14
"2011","E00023708","E00023708","Total",89,48,32,16,0,1,0,1,37,36,0,1,0,3
"2011","E00023711","E00023711","Total",99,30,23,7,1,32,31,1,31,29,0,2,0,5
"2011","E00023712","E00023712","Total",133,47,26,21,0,31,0,31,52,49,0,1,2,3
"2011","E00023713","E00023713","Total",104,54,30,24,0,7,0,7,40,35,0,4,1,3
"2011","E00023717","E00023717","Total",121,14,4,10,0,2,2,0,105,101,0,2,2,0
"2011","E00023718","E00023718","Total",128,72,43,29,0,1,1,0,51,50,0,1,0,4
"2011","E00023719","E00023719","Total",142,28,11,17,1,9,0,9,102,101,0,1,0,2
"2011","E00023694","E00023694","Total",192,37,14,23,1,9,0,9,142,140,0,2,0,3
"2011","E00023695","E00023695","Total",142,46,24,22,0,4,1,3,88,86,0,1,1,4
"2011","E00023696","E00023696","Total",154,36,22,14,0,13,10,3,103,102,0,0,1,2
"2011","E00023716","E00023716","Total",146,51,15,36,0,29,19,10,64,63,0,0,1,2
"2011","E00023722","E00023722","Total",73,8,3,5,0,8,0,8,55,53,1,1,0,2
"2011","E00023726","E00023726","Total",127,53,26,27,1,1,0,1,69,66,0,3,0,3
"2011","E00023729","E00023729","Total",107,43,20,23,0,1,0,1,61,57,0,4,0,2
"2011","E00023452","E00023452","Total",223,74,41,33,2,2,2,0,137,129,0,8,0,8
"2011","E00023453","E00023453","Total",133,34,20,14,1,16,2,14,79,76,0,2,1,3
"2011","E00023463","E00023463","Total",118,32,18,14,0,37,32,5,49,47,0,2,0,0
"2011","E00023469","E00023469","Total",188,61,41,20,0,2,2,0,120,114,0,6,0,5
"2011","E00023473","E00023473","Total",162,33,15,18,1,28,28,0,92,89,0,2,1,8
"2011","E00023474","E00023474","Total",134,33,14,19,0,2,2,0,97,96,0,1,0,2
"2011","E00023691","E00023691","Total",88,32,16,16,0,12,1,11,35,35,0,0,0,9
"2011","E00023704","E00023704","Total",118,52,28,24,2,1,0,1,59,58,1,0,0,4
"2011","E00023738","E00023738","Total",126,53,38,15,0,31,18,13,37,34,0,2,1,5
"2011","E00023739","E00023739","Total",164,63,37,26,0,1,1,0,98,94,1,2,1,2
"2011","E00023740","E00023740","Total",117,79,63,16,0,1,1,0,32,31,0,0,1,5
"2011","E00023741","E00023741","Total",122,39,26,13,0,8,2,6,75,73,0,2,0,0
"2011","E00023698","E00023698","Total",143,44,23,21,1,3,0,3,93,89,1,2,1,2
"2011","E00023700","E00023700","Total",107,40,23,17,1,10,1,9,52,50,0,1,1,4
"2011","E00023701","E00023701","Total",183,53,37,16,0,2,1,1,122,115,0,5,2,6
"2011","E00023703","E00023703","Total",121,36,21,15,1,2,1,1,75,73,0,0,2,7
"2011","E00023737","E00023737","Total",115,27,23,4,0,0,0,0,76,75,0,1,0,12
"2011","E00023692","E00023692","Total",103,52,21,31,1,2,1,1,46,45,0,0,1,2
"2011","E00023705","E00023705","Total",102,14,6,8,0,77,72,5,10,10,0,0,0,1
"2011","E00023706","E00023706","Total",113,33,18,15,0,51,47,4,28,25,0,2,1,1
"2011","E00023707","E00023707","Total",101,33,22,11,2,36,33,3,28,25,0,3,0,2
"2011","E00023709","E00023709","Total",118,43,21,22,1,46,43,3,26,25,0,1,0,2
"2011","E00023710","E00023710","Total",97,26,14,12,0,53,48,5,17,16,0,0,1,1
"2011","E00023715","E00023715","Total",126,26,13,13,2,72,70,2,24,24,0,0,0,2
"2011","E00023697","E00023697","Total",130,61,36,25,0,0,0,0,55,52,1,2,0,14
"2011","E00023720","E00023720","Total",142,46,35,11,0,20,19,1,73,71,0,2,0,3
"2011","E00023724","E00023724","Total",112,30,15,15,2,2,1,1,76,69,0,4,3,2
"2011","E00023730","E00023730","Total",146,21,8,13,1,7,0,7,114,114,0,0,0,3
"2011","E00175198","E00175198","Total",224,50,22,28,0,16,16,0,156,151,0,3,2,2
"2011","E00023714","E00023714","Total",146,47,36,11,0,6,3,3,89,89,0,0,0,4
"2011","E00023721","E00023721","Total",242,73,34,39,1,34,19,15,121,111,0,7,3,13
"2011","E00023723","E00023723","Total",142,42,17,25,1,2,0,2,95,94,0,0,1,2
"2011","E00023727","E00023727","Total",126,36,22,14,0,0,0,0,86,83,0,2,1,4
"2011","E00023731","E00023731","Total",119,4,3,1,2,1,1,0,112,109,2,0,1,0
"2011","E00023732","E00023732","Total",131,56,27,29,1,1,1,0,66,64,1,1,0,7
"2011","E00175197","E00175197","Total",83,18,13,5,0,7,5,2,53,51,1,1,0,5
"2011","E00175199","E00175199","Total",176,50,26,24,0,8,0,8,114,109,0,1,4,4
"2011","E00023928","E00023928","Total",183,12,10,2,0,9,1,8,150,146,0,1,3,12
"2011","E00023929","E00023929","Total",195,24,15,9,0,47,10,37,119,116,2,0,1,5
"2011","E00023931","E00023931","Total",164,40,24,16,0,32,1,31,84,81,1,1,1,8
"2011","E00023933","E00023933","Total",141,25,14,11,0,68,1,67,43,43,0,0,0,5
"2011","E00023934","E00023934","Total",153,32,17,15,2,6,2,4,103,99,2,1,1,10
"2011","E00023959","E00023959","Total",136,9,8,1,0,102,0,102,20,17,0,3,0,5
"2011","E00023960","E00023960","Total",132,20,14,6,2,83,79,4,25,22,0,3,0,2
"2011","E00023930","E00023930","Total",221,81,51,30,1,30,26,4,99,88,3,6,2,10
"2011","E00023932","E00023932","Total",170,47,36,11,1,41,28,13,72,69,0,1,2,9
"2011","E00023955","E00023955","Total",124,10,7,3,2,41,26,15,70,70,0,0,0,1
"2011","E00023956","E00023956","Total",190,31,15,16,0,107,13,94,50,37,2,0,11,2
"2011","E00023957","E00023957","Total",114,31,18,13,0,32,24,8,49,45,1,1,2,2
"2011","E00023958","E00023958","Total",158,3,2,1,0,146,2,144,9,8,0,1,0,0
"2011","E00023935","E00023935","Total",165,38,28,10,1,8,0,8,105,90,7,0,8,13
"2011","E00023936","E00023936","Total",141,88,59,29,0,0,0,0,45,40,0,2,3,8
"2011","E00023937","E00023937","Total",149,60,46,14,0,1,0,1,72,65,0,1,6,16
"2011","E00023938","E00023938","Total",113,59,28,31,3,3,0,3,41,26,6,0,9,7
"2011","E00023939","E00023939","Total",161,38,30,8,1,2,0,2,112,98,8,2,4,8
"2011","E00024109","E00024109","Total",145,68,53,15,1,1,0,1,48,44,1,0,3,27
"2011","E00024113","E00024113","Total",190,44,31,13,0,10,0,10,123,113,2,6,2,13
"2011","E00024115","E00024115","Total",154,36,23,13,0,38,1,37,69,63,2,1,3,11
"2011","E00024116","E00024116","Total",145,60,45,15,0,8,0,8,63,60,0,0,3,14
"2011","E00024119","E00024119","Total",150,40,22,18,1,5,0,5,92,90,1,1,0,12
"2011","E00175212","E00175212","Total",115,45,32,13,0,13,0,13,52,50,0,0,2,5
"2011","E00175213","E00175213","Total",94,25,14,11,1,10,1,9,54,50,2,0,2,4
"2011","E00175214","E00175214","Total",92,21,14,7,1,23,0,23,41,37,2,0,2,6
"2011","E00023658","E00023658","Total",121,49,41,8,0,7,0,7,55,54,1,0,0,10
"2011","E00023659","E00023659","Total",105,41,31,10,2,1,0,1,49,46,0,1,2,12
"2011","E00023660","E00023660","Total",94,40,22,18,1,1,0,1,34,33,0,1,0,18
"2011","E00023663","E00023663","Total",88,40,30,10,2,0,0,0,36,35,0,0,1,10
"2011","E00023664","E00023664","Total",133,92,65,27,0,0,0,0,40,40,0,0,0,1
"2011","E00023665","E00023665","Total",114,48,33,15,1,1,1,0,57,51,0,2,4,7
"2011","E00023666","E00023666","Total",144,84,62,22,0,1,1,0,37,24,8,3,2,22
"2011","E00023684","E00023684","Total",131,68,58,10,1,1,0,1,52,46,0,5,1,9
"2011","E00023685","E00023685","Total",107,50,42,8,0,5,0,5,39,38,0,0,1,13
"2011","E00175204","E00175204","Total",70,40,31,9,1,0,0,0,25,25,0,0,0,4
"2011","E00175205","E00175205","Total",44,26,21,5,0,0,0,0,14,14,0,0,0,4
"2011","E00175208","E00175208","Total",52,16,11,5,0,2,1,1,23,21,2,0,0,11
"2011","E00175250","E00175250","Total",82,50,37,13,0,1,1,0,22,19,1,0,2,9
"2011","E00023681","E00023681","Total",208,108,83,25,1,0,0,0,77,71,0,1,5,22
"2011","E00023686","E00023686","Total",107,69,49,20,0,1,1,0,35,32,1,0,2,2
"2011","E00175206","E00175206","Total",195,75,48,27,1,34,4,30,76,62,8,4,2,9
"2011","E00023661","E00023661","Total",126,41,23,18,0,5,4,1,74,71,2,0,1,6
"2011","E00023662","E00023662","Total",96,53,42,11,0,9,0,9,24,23,0,0,1,10
"2011","E00023670","E00023670","Total",117,62,40,22,0,10,0,10,37,34,0,1,2,8
"2011","E00023682","E00023682","Total",78,33,22,11,0,0,0,0,28,23,1,1,3,17
"2011","E00023688","E00023688","Total",102,33,25,8,1,7,7,0,42,41,0,0,1,19
"2011","E00023689","E00023689","Total",108,57,39,18,0,1,1,0,40,40,0,0,0,10
"2011","E00023657","E00023657","Total",125,52,44,8,1,17,0,17,44,40,1,1,2,11
"2011","E00023668","E00023668","Total",133,36,28,8,0,15,1,14,71,70,0,0,1,11
"2011","E00023669","E00023669","Total",109,56,37,19,0,0,0,0,42,37,1,4,0,11
"2011","E00023671","E00023671","Total",113,44,30,14,1,0,0,0,53,49,0,0,4,15
"2011","E00023674","E00023674","Total",127,56,48,8,0,10,0,10,42,37,1,2,2,19
"2011","E00023687","E00023687","Total",114,35,32,3,3,10,0,10,61,54,0,4,3,5
"2011","E00023690","E00023690","Total",95,37,25,12,0,0,0,0,47,44,0,2,1,11
"2011","E00023672","E00023672","Total",112,52,43,9,1,0,0,0,49,44,0,4,1,10
"2011","E00023675","E00023675","Total",131,59,41,18,0,1,0,1,63,60,1,0,2,8
"2011","E00023676","E00023676","Total",102,37,32,5,0,4,1,3,42,31,6,1,4,19
"2011","E00023678","E00023678","Total",104,58,45,13,0,4,0,4,33,30,2,0,1,9
"2011","E00023679","E00023679","Total",103,52,39,13,2,1,1,0,35,32,0,0,3,13
"2011","E00023680","E00023680","Total",92,44,34,10,1,1,1,0,33,27,1,4,1,13
"2011","E00023941","E00023941","Total",118,38,28,10,1,3,1,2,67,63,3,1,0,9
"2011","E00023942","E00023942","Total",107,66,43,23,0,1,0,1,34,33,0,0,1,6
"2011","E00023943","E00023943","Total",90,45,34,11,1,11,1,10,28,24,2,2,0,5
"2011","E00023946","E00023946","Total",156,30,23,7,1,9,1,8,107,81,22,0,4,9
"2011","E00023948","E00023948","Total",130,44,31,13,0,2,0,2,77,72,2,3,0,7
"2011","E00175226","E00175226","Total",90,51,31,20,1,3,0,3,29,27,1,1,0,6
"2011","E00175248","E00175248","Total",110,31,14,17,1,15,3,12,58,55,2,1,0,5
"2011","E00175249","E00175249","Total",109,35,23,12,5,20,1,19,43,39,0,1,3,6
"2011","E00023926","E00023926","Total",77,3,1,2,0,66,3,63,8,8,0,0,0,0
"2011","E00023944","E00023944","Total",121,2,1,1,0,111,2,109,6,5,0,0,1,2
"2011","E00023947","E00023947","Total",142,27,19,8,0,50,2,48,54,52,0,1,1,11
"2011","E00023949","E00023949","Total",125,22,16,6,0,91,3,88,10,9,0,0,1,2
"2011","E00023950","E00023950","Total",114,3,3,0,0,107,1,106,4,3,0,0,1,0
"2011","E00023951","E00023951","Total",118,2,1,1,0,113,5,108,2,1,0,0,1,1
"2011","E00023927","E00023927","Total",225,79,57,22,12,76,17,59,55,51,3,0,1,3
"2011","E00023945","E00023945","Total",146,68,52,16,0,2,0,2,34,20,10,1,3,42
"2011","E00023953","E00023953","Total",89,28,15,13,1,9,1,8,49,45,1,2,1,2
"2011","E00023954","E00023954","Total",131,44,30,14,4,38,1,37,38,33,1,3,1,7
"2011","E00175227","E00175227","Total",70,39,32,7,0,3,2,1,23,18,2,3,0,5
"2011","E00175228","E00175228","Total",118,29,16,13,0,3,0,3,80,78,0,2,0,6
"2011","E00175229","E00175229","Total",147,47,31,16,0,5,0,5,91,85,0,4,2,4
"2011","E00024004","E00024004","Total",117,1,1,0,1,28,2,26,86,5,44,0,37,1
"2011","E00024005","E00024005","Total",133,59,34,25,0,7,5,2,59,55,1,3,0,8
"2011","E00024008","E00024008","Total",116,21,13,8,1,63,3,60,23,21,0,2,0,8
"2011","E00024013","E00024013","Total",121,2,0,2,0,96,2,94,17,17,0,0,0,6
"2011","E00024014","E00024014","Total",106,14,6,8,0,69,15,54,20,16,1,3,0,3
"2011","E00024034","E00024034","Total",151,61,47,14,1,58,0,58,27,24,1,2,0,4
"2011","E00024006","E00024006","Total",121,46,28,18,0,14,0,14,60,55,2,1,2,1
"2011","E00024007","E00024007","Total",119,54,40,14,0,4,0,4,53,38,7,1,7,8
"2011","E00024031","E00024031","Total",128,78,52,26,8,15,1,14,22,18,1,2,1,5
"2011","E00024032","E00024032","Total",144,91,59,32,0,3,0,3,45,42,1,0,2,5
"2011","E00024033","E00024033","Total",103,67,41,26,1,1,0,1,26,25,0,1,0,8
"2011","E00023985","E00023985","Total",137,37,14,23,0,79,76,3,20,18,0,1,1,1
"2011","E00023986","E00023986","Total",87,27,13,14,1,48,48,0,11,10,0,1,0,0
"2011","E00023987","E00023987","Total",106,22,13,9,0,67,60,7,16,12,0,4,0,1
"2011","E00023988","E00023988","Total",80,36,21,15,1,29,27,2,10,8,0,2,0,4
"2011","E00023989","E00023989","Total",127,18,5,13,0,96,72,24,8,7,0,1,0,5
"2011","E00023990","E00023990","Total",147,11,7,4,0,121,117,4,9,7,0,1,1,6
"2011","E00023992","E00023992","Total",92,42,25,17,0,15,0,15,33,33,0,0,0,2
"2011","E00024010","E00024010","Total",94,11,7,4,1,73,53,20,8,7,0,1,0,1
"2011","E00024011","E00024011","Total",142,31,17,14,0,92,84,8,18,15,0,3,0,1
"2011","E00024016","E00024016","Total",107,18,10,8,0,68,66,2,21,20,0,1,0,0
"2011","E00024019","E00024019","Total",109,39,18,21,0,28,26,2,37,35,0,2,0,5
"2011","E00175253","E00175253","Total",133,50,36,14,1,7,3,4,70,64,0,4,2,5
"2011","E00175254","E00175254","Total",128,63,41,22,0,3,2,1,60,57,0,2,1,2
"2011","E00024024","E00024024","Total",167,60,36,24,1,41,41,0,59,58,0,1,0,6
"2011","E00024026","E00024026","Total",141,44,18,26,1,52,50,2,33,31,0,1,1,11
"2011","E00024029","E00024029","Total",117,36,11,25,0,36,2,34,41,39,0,1,1,4
"2011","E00024030","E00024030","Total",125,37,22,15,2,64,27,37,20,15,0,5,0,2
"2011","E00175251","E00175251","Total",140,33,12,21,0,79,75,4,24,21,0,3,0,4
"2011","E00175252","E00175252","Total",88,29,16,13,5,19,0,19,33,31,0,2,0,2
"2011","E00175255","E00175255","Total",110,54,28,26,0,2,1,1,53,48,1,4,0,1
"2011","E00175256","E00175256","Total",66,9,5,4,12,30,2,28,12,11,0,0,1,3
"2011","E00175257","E00175257","Total",171,109,72,37,1,9,4,5,46,41,1,4,0,6
"2011","E00024009","E00024009","Total",113,24,14,10,0,73,17,56,16,16,0,0,0,0
"2011","E00024012","E00024012","Total",119,21,9,12,0,73,68,5,20,18,0,2,0,5
"2011","E00024017","E00024017","Total",102,25,12,13,0,59,51,8,17,13,0,4,0,1
"2011","E00024018","E00024018","Total",112,42,18,24,1,45,41,4,24,21,1,0,2,0
"2011","E00024020","E00024020","Total",125,14,6,8,0,86,83,3,24,23,0,1,0,1
"2011","E00024021","E00024021","Total",186,34,26,8,3,108,99,9,37,34,1,2,0,4
"2011","E00024001","E00024001","Total",201,73,39,34,1,49,3,46,75,62,9,3,1,3
"2011","E00024002","E00024002","Total",243,72,33,39,18,81,6,75,68,64,0,3,1,4
"2011","E00024022","E00024022","Total",159,73,47,26,2,18,2,16,59,56,0,3,0,7
"2011","E00024023","E00024023","Total",175,56,42,14,14,62,12,50,39,38,0,1,0,4
"2011","E00024025","E00024025","Total",196,51,41,10,0,41,6,35,99,95,0,1,3,5
"2011","E00024028","E00024028","Total",153,31,11,20,1,95,14,81,24,23,0,1,0,2
"2011","E00023967","E00023967","Total",108,45,24,21,1,0,0,0,59,59,0,0,0,3
"2011","E00023968","E00023968","Total",85,39,21,18,0,1,0,1,44,44,0,0,0,1
"2011","E00023969","E00023969","Total",83,37,20,17,1,1,0,1,44,40,0,4,0,0
"2011","E00023991","E00023991","Total",92,36,21,15,0,2,1,1,52,50,0,2,0,2
"2011","E00023996","E00023996","Total",114,47,18,29,0,4,1,3,61,56,1,3,1,2
"2011","E00023997","E00023997","Total",93,53,23,30,1,2,1,1,36,32,0,3,1,1
"2011","E00023998","E00023998","Total",71,27,10,17,0,1,0,1,41,40,0,0,1,2
"2011","E00175222","E00175222","Total",133,6,6,0,0,116,2,114,11,9,0,2,0,0
"2011","E00024052","E00024052","Total",132,49,21,28,1,1,0,1,78,76,0,1,1,3
"2011","E00024055","E00024055","Total",134,62,48,14,1,1,0,1,67,65,0,2,0,3
"2011","E00024057","E00024057","Total",124,61,31,30,0,4,1,3,50,49,0,1,0,9
"2011","E00024058","E00024058","Total",142,61,44,17,3,13,1,12,62,56,0,5,1,3
"2011","E00024059","E00024059","Total",91,58,40,18,2,5,1,4,21,20,1,0,0,5
"2011","E00024060","E00024060","Total",131,75,44,31,1,9,0,9,42,38,1,2,1,4
"2011","E00175180","E00175180","Total",105,22,16,6,14,51,2,49,17,15,0,2,0,1
"2011","E00175239","E00175239","Total",93,27,12,15,4,18,3,15,44,42,1,1,0,0
"2011","E00175240","E00175240","Total",146,15,6,9,14,66,2,64,48,45,0,3,0,3
"2011","E00175241","E00175241","Total",87,30,18,12,0,2,0,2,52,50,0,0,2,3
"2011","E00024053","E00024053","Total",142,69,45,24,0,23,0,23,45,44,0,0,1,5
"2011","E00024056","E00024056","Total",136,81,45,36,2,9,0,9,40,37,0,2,1,4
"2011","E00024063","E00024063","Total",134,46,23,23,2,11,1,10,72,65,0,6,1,3
"2011","E00024065","E00024065","Total",144,58,34,24,2,17,0,17,61,56,0,5,0,6
"2011","E00024067","E00024067","Total",141,58,29,29,0,25,14,11,56,52,0,4,0,2
"2011","E00024068","E00024068","Total",127,73,38,35,0,2,2,0,49,46,0,3,0,3
"2011","E00024071","E00024071","Total",119,46,21,25,0,21,0,21,51,44,2,2,3,1
"2011","E00024036","E00024036","Total",126,2,0,2,1,107,3,104,16,15,0,1,0,0
"2011","E00024037","E00024037","Total",92,49,22,27,0,2,1,1,40,37,0,3,0,1
"2011","E00024039","E00024039","Total",125,54,29,25,1,36,22,14,34,33,0,1,0,0
"2011","E00024045","E00024045","Total",123,35,22,13,1,39,3,36,47,43,0,3,1,1
"2011","E00024062","E00024062","Total",142,33,17,16,0,51,1,50,56,52,0,4,0,2
"2011","E00024064","E00024064","Total",124,30,13,17,0,71,0,71,20,19,0,1,0,3
"2011","E00024066","E00024066","Total",93,28,23,5,1,29,0,29,31,28,0,3,0,4
"2011","E00024069","E00024069","Total",80,10,8,2,0,61,0,61,8,6,0,1,1,1
"2011","E00024038","E00024038","Total",109,31,22,9,0,17,0,17,60,59,0,1,0,1
"2011","E00024040","E00024040","Total",113,39,19,20,0,50,2,48,23,20,1,2,0,1
"2011","E00024041","E00024041","Total",137,16,10,6,0,85,4,81,33,31,1,1,0,3
"2011","E00024042","E00024042","Total",119,40,22,18,0,41,10,31,34,32,0,1,1,4
"2011","E00024043","E00024043","Total",154,45,26,19,0,41,0,41,60,56,0,4,0,8
"2011","E00024044","E00024044","Total",124,49,30,19,1,25,0,25,49,45,0,4,0,0
"2011","E00024046","E00024046","Total",147,58,33,25,1,34,3,31,52,50,0,2,0,2
"2011","E00024047","E00024047","Total",138,30,16,14,0,81,3,78,25,23,0,2,0,2
"2011","E00023532","E00023532","Total",129,3,3,0,3,122,116,6,0,0,0,0,0,1
"2011","E00023557","E00023557","Total",77,10,8,2,0,6,1,5,59,58,0,0,1,2
"2011","E00023558","E00023558","Total",98,41,23,18,2,32,28,4,19,16,1,2,0,4
"2011","E00023560","E00023560","Total",130,57,40,17,1,2,0,2,68,65,2,0,1,2
"2011","E00023561","E00023561","Total",119,3,2,1,1,91,3,88,24,22,0,1,1,0
"2011","E00023530","E00023530","Total",114,36,18,18,7,41,39,2,30,28,0,2,0,0
"2011","E00023531","E00023531","Total",127,9,3,6,2,91,69,22,25,22,0,3,0,0
"2011","E00023533","E00023533","Total",136,31,20,11,2,73,7,66,30,28,0,1,1,0
"2011","E00023534","E00023534","Total",119,45,23,22,0,7,2,5,62,58,3,1,0,5
"2011","E00023559","E00023559","Total",125,59,46,13,1,21,3,18,38,34,2,0,2,6
"2011","E00023562","E00023562","Total",122,0,0,0,0,115,4,111,7,5,0,0,2,0
"2011","E00023537","E00023537","Total",133,86,51,35,0,5,2,3,42,40,0,2,0,0
"2011","E00023545","E00023545","Total",126,73,47,26,0,4,2,2,47,46,0,1,0,2
"2011","E00023547","E00023547","Total",117,33,19,14,0,68,57,11,16,15,1,0,0,0
"2011","E00023548","E00023548","Total",139,39,21,18,1,72,66,6,27,22,1,4,0,0
"2011","E00023550","E00023550","Total",130,59,39,20,0,49,44,5,20,18,0,2,0,2
"2011","E00024048","E00024048","Total",147,39,26,13,1,25,1,24,72,59,10,1,2,10
"2011","E00024050","E00024050","Total",97,23,10,13,1,11,7,4,60,53,4,0,3,2
"2011","E00024051","E00024051","Total",99,44,26,18,1,9,5,4,43,38,0,5,0,2
"2011","E00024054","E00024054","Total",109,58,37,21,2,10,4,6,39,33,0,6,0,0
"2011","E00024061","E00024061","Total",103,33,18,15,0,54,50,4,12,11,0,1,0,4
"2011","E00024070","E00024070","Total",117,25,14,11,0,79,73,6,13,13,0,0,0,0
"2011","E00175209","E00175209","Total",75,22,14,8,0,12,7,5,37,36,1,0,0,4
"2011","E00175278","E00175278","Total",204,18,11,7,0,168,160,8,16,15,0,1,0,2
"2011","E00023541","E00023541","Total",136,22,13,9,2,81,41,40,28,28,0,0,0,3
"2011","E00023546","E00023546","Total",186,18,9,9,1,132,7,125,31,29,0,1,1,4
"2011","E00175217","E00175217","Total",175,51,27,24,1,9,0,9,112,108,2,1,1,2
"2011","E00175231","E00175231","Total",124,16,10,6,12,76,32,44,20,15,0,3,2,0
"2011","E00023535","E00023535","Total",91,2,0,2,0,80,6,74,7,6,0,0,1,2
"2011","E00023536","E00023536","Total",107,23,9,14,0,59,57,2,21,19,0,2,0,4
"2011","E00023539","E00023539","Total",138,3,3,0,0,123,9,114,11,5,0,0,6,1
"2011","E00175223","E00175223","Total",92,12,10,2,0,59,7,52,19,19,0,0,0,2
"2011","E00175230","E00175230","Total",202,10,4,6,68,102,11,91,22,18,0,3,1,0
"2011","E00023543","E00023543","Total",132,26,18,8,1,80,67,13,22,21,0,0,1,3
"2011","E00023549","E00023549","Total",100,20,13,7,0,62,56,6,14,13,0,1,0,4
"2011","E00023551","E00023551","Total",136,21,9,12,2,98,83,15,11,11,0,0,0,4
"2011","E00023554","E00023554","Total",125,23,19,4,1,74,63,11,26,25,0,1,0,1
"2011","E00023556","E00023556","Total",118,33,21,12,1,69,61,8,14,12,0,2,0,1
"2011","E00023538","E00023538","Total",129,35,23,12,1,60,49,11,29,25,0,3,1,4
"2011","E00023540","E00023540","Total",152,45,23,22,2,71,42,29,32,29,1,2,0,2
"2011","E00023542","E00023542","Total",135,32,16,16,0,69,57,12,32,28,0,3,1,2
"2011","E00023544","E00023544","Total",88,17,8,9,1,59,52,7,11,11,0,0,0,0
"2011","E00023552","E00023552","Total",128,45,27,18,0,53,47,6,27,27,0,0,0,3
"2011","E00023555","E00023555","Total",126,39,23,16,1,57,51,6,27,22,1,4,0,2
"2011","E00023972","E00023972","Total",161,92,63,29,1,2,0,2,60,54,0,3,3,6
"2011","E00023973","E00023973","Total",111,62,48,14,0,1,0,1,46,42,0,4,0,2
"2011","E00023974","E00023974","Total",123,1,1,0,0,108,6,102,14,13,0,0,1,0
"2011","E00023976","E00023976","Total",42,20,15,5,2,2,1,1,18,18,0,0,0,0
"2011","E00023978","E00023978","Total",72,4,4,0,0,64,1,63,4,3,0,1,0,0
"2011","E00023980","E00023980","Total",54,0,0,0,0,49,2,47,4,4,0,0,0,1
"2011","E00023982","E00023982","Total",120,2,1,1,0,113,6,107,5,3,0,0,2,0
"2011","E00023964","E00023964","Total",166,78,42,36,0,0,0,0,86,80,0,6,0,2
"2011","E00023965","E00023965","Total",126,50,37,13,0,44,1,43,28,23,0,4,1,4
"2011","E00023975","E00023975","Total",158,63,44,19,0,2,1,1,88,88,0,0,0,5
"2011","E00023977","E00023977","Total",69,32,17,15,0,10,7,3,26,24,0,1,1,1
"2011","E00023979","E00023979","Total",91,23,11,12,0,16,1,15,52,50,0,2,0,0
"2011","E00023981","E00023981","Total",112,43,31,12,0,6,6,0,57,56,0,0,1,6
"2011","E00175202","E00175202","Total",268,3,2,1,0,20,1,19,241,236,0,0,5,4
"2011","E00175203","E00175203","Total",246,3,3,0,0,13,3,10,228,225,1,1,1,2
"2011","E00175224","E00175224","Total",180,4,4,0,0,16,1,15,157,156,0,0,1,3
"2011","E00175225","E00175225","Total",83,20,10,10,0,9,3,6,52,47,1,4,0,2
"2011","E00175258","E00175258","Total",173,0,0,0,0,14,2,12,157,152,1,0,4,2
"2011","E00023963","E00023963","Total",78,25,15,10,0,2,1,1,50,48,1,0,1,1
"2011","E00023966","E00023966","Total",89,6,3,3,0,74,0,74,9,6,0,2,1,0
"2011","E00023971","E00023971","Total",75,6,4,2,0,64,6,58,3,2,0,0,1,2
"2011","E00023993","E00023993","Total",175,59,30,29,5,68,57,11,41,39,0,2,0,2
"2011","E00023994","E00023994","Total",96,39,22,17,0,36,35,1,21,19,0,1,1,0
"2011","E00023995","E00023995","Total",66,18,10,8,0,36,30,6,11,11,0,0,0,1
"2011","E00023999","E00023999","Total",119,63,30,33,2,1,0,1,51,49,0,2,0,2
"2011","E00000138","E00000138","Total",119,60,18,42,1,50,42,8,8,7,0,1,0,0
"2011","E00000156","E00000156","Total",136,82,35,47,1,37,33,4,15,15,0,0,0,1
"2011","E00000157","E00000157","Total",116,64,22,42,0,40,38,2,11,10,0,1,0,1
"2011","E00000158","E00000158","Total",146,56,19,37,1,74,34,40,13,13,0,0,0,2
"2011","E00000160","E00000160","Total",124,28,11,17,1,90,6,84,4,3,0,1,0,1
"2011","E00000137","E00000137","Total",143,56,20,36,4,57,54,3,22,21,0,1,0,4
"2011","E00000161","E00000161","Total",120,35,15,20,2,65,57,8,14,12,0,2,0,4
"2011","E00000162","E00000162","Total",111,42,13,29,0,59,43,16,9,9,0,0,0,1
"2011","E00000164","E00000164","Total",148,26,3,23,1,98,75,23,20,20,0,0,0,3
"2011","E00000166","E00000166","Total",90,28,8,20,0,41,40,1,17,16,0,1,0,4
"2011","E00000140","E00000140","Total",137,94,36,58,1,17,17,0,25,22,0,3,0,0
"2011","E00000143","E00000143","Total",111,76,35,41,0,20,17,3,14,14,0,0,0,1
"2011","E00000144","E00000144","Total",111,103,60,43,0,2,1,1,6,6,0,0,0,0
"2011","E00000145","E00000145","Total",117,95,75,20,0,10,3,7,11,9,0,2,0,1
"2011","E00000147","E00000147","Total",113,99,60,39,2,4,2,2,4,4,0,0,0,4
"2011","E00000148","E00000148","Total",101,95,79,16,0,2,1,1,4,4,0,0,0,0
"2011","E00000139","E00000139","Total",134,60,25,35,1,62,54,8,10,10,0,0,0,1
"2011","E00000141","E00000141","Total",141,9,3,6,2,125,105,20,4,4,0,0,0,1
"2011","E00000142","E00000142","Total",157,30,10,20,1,111,108,3,13,13,0,0,0,2
"2011","E00000159","E00000159","Total",120,45,17,28,0,63,63,0,12,11,0,1,0,0
"2011","E00000163","E00000163","Total",111,21,5,16,0,76,74,2,11,11,0,0,0,3
"2011","E00000165","E00000165","Total",107,55,27,28,0,30,27,3,22,21,0,1,0,0
"2011","E00000136","E00000136","Total",118,97,36,61,0,9,4,5,11,10,0,1,0,1
"2011","E00000146","E00000146","Total",96,80,34,46,1,5,3,2,9,8,0,1,0,1
"2011","E00000149","E00000149","Total",117,85,36,49,0,12,8,4,20,19,0,1,0,0
"2011","E00000151","E00000151","Total",143,98,34,64,0,5,3,2,39,36,0,3,0,1
"2011","E00000152","E00000152","Total",124,114,71,43,0,1,1,0,7,7,0,0,0,2
"2011","E00000135","E00000135","Total",109,63,29,34,0,24,24,0,21,20,0,1,0,1
"2011","E00000150","E00000150","Total",121,74,24,50,0,33,31,2,13,13,0,0,0,1
"2011","E00000153","E00000153","Total",131,104,61,43,1,12,9,3,12,11,0,1,0,2
"2011","E00000154","E00000154","Total",128,73,34,39,1,4,1,3,48,47,0,1,0,2
"2011","E00000155","E00000155","Total",142,80,34,46,0,24,22,2,38,36,0,2,0,0
"2011","E00000560","E00000560","Total",130,107,47,60,1,5,3,2,17,16,0,1,0,0
"2011","E00000561","E00000561","Total",122,91,26,65,3,4,3,1,24,21,0,3,0,0
"2011","E00000562","E00000562","Total",140,117,56,61,1,1,1,0,21,21,0,0,0,0
"2011","E00000564","E00000564","Total",109,92,37,55,1,3,3,0,10,10,0,0,0,3
"2011","E00000545","E00000545","Total",121,76,30,46,0,23,22,1,21,19,0,1,1,1
"2011","E00000548","E00000548","Total",131,71,36,35,0,42,40,2,16,15,0,1,0,2
"2011","E00000551","E00000551","Total",129,52,13,39,0,53,53,0,24,23,0,1,0,0
"2011","E00000563","E00000563","Total",122,28,8,20,1,79,56,23,14,14,0,0,0,0
"2011","E00000565","E00000565","Total",114,84,27,57,0,16,15,1,14,11,0,2,1,0
"2011","E00000567","E00000567","Total",115,72,26,46,0,7,4,3,35,32,0,3,0,1
"2011","E00000549","E00000549","Total",147,83,29,54,3,10,7,3,50,47,0,2,1,1
"2011","E00000566","E00000566","Total",183,60,17,43,15,14,8,6,94,92,0,0,2,0
"2011","E00000569","E00000569","Total",122,97,42,55,0,8,3,5,17,16,0,1,0,0
"2011","E00000570","E00000570","Total",112,83,41,42,0,16,14,2,11,10,0,1,0,2
"2011","E00000573","E00000573","Total",175,112,42,70,0,8,4,4,55,52,1,2,0,0
"2011","E00000568","E00000568","Total",135,39,18,21,0,7,2,5,88,84,0,3,1,1
"2011","E00000571","E00000571","Total",137,109,36,73,4,6,4,2,18,18,0,0,0,0
"2011","E00000572","E00000572","Total",131,92,45,47,0,6,6,0,32,31,0,1,0,1
"2011","E00000574","E00000574","Total",108,80,30,50,0,6,2,4,22,20,0,2,0,0
"2011","E00000575","E00000575","Total",122,88,29,59,2,3,3,0,29,29,0,0,0,0
"2011","E00000170","E00000170","Total",134,72,22,50,1,50,49,1,11,11,0,0,0,0
"2011","E00000171","E00000171","Total",134,62,20,42,0,58,58,0,11,11,0,0,0,3
"2011","E00000187","E00000187","Total",117,47,12,35,0,53,52,1,16,16,0,0,0,1
"2011","E00000195","E00000195","Total",132,63,19,44,7,45,3,42,14,14,0,0,0,3
"2011","E00000181","E00000181","Total",121,111,52,59,1,2,1,1,5,4,0,1,0,2
"2011","E00000184","E00000184","Total",117,112,50,62,1,2,1,1,2,2,0,0,0,0
"2011","E00000185","E00000185","Total",99,93,32,61,0,1,1,0,5,5,0,0,0,0
"2011","E00000189","E00000189","Total",113,100,45,55,0,6,4,2,6,6,0,0,0,1
"2011","E00000191","E00000191","Total",129,104,36,68,0,4,2,2,21,20,0,0,1,0
"2011","E00000182","E00000182","Total",110,86,37,49,0,13,12,1,10,10,0,0,0,1
"2011","E00000183","E00000183","Total",116,93,55,38,0,10,10,0,12,11,0,1,0,1
"2011","E00000186","E00000186","Total",126,110,66,44,0,1,1,0,15,13,0,1,1,0
"2011","E00000188","E00000188","Total",108,83,40,43,0,21,21,0,4,3,0,1,0,0
"2011","E00000190","E00000190","Total",103,62,34,28,1,31,31,0,9,8,0,0,1,0
"2011","E00000192","E00000192","Total",130,105,31,74,2,5,4,1,18,15,0,3,0,0
"2011","E00000193","E00000193","Total",130,85,23,62,1,14,1,13,30,28,0,2,0,0
"2011","E00000194","E00000194","Total",135,119,65,54,0,5,4,1,10,10,0,0,0,1
"2011","E00000196","E00000196","Total",144,89,35,54,1,39,6,33,14,12,0,2,0,1
"2011","E00000197","E00000197","Total",120,91,44,47,1,11,7,4,15,14,0,1,0,2
"2011","E00000298","E00000298","Total",129,77,30,47,0,37,34,3,15,13,0,2,0,0
"2011","E00000302","E00000302","Total",133,77,36,41,0,37,33,4,18,17,0,1,0,1
"2011","E00000303","E00000303","Total",143,70,19,51,0,54,52,2,17,17,0,0,0,2
"2011","E00000306","E00000306","Total",118,66,30,36,1,44,42,2,7,7,0,0,0,0
"2011","E00000315","E00000315","Total",112,60,23,37,0,40,40,0,11,11,0,0,0,1
"2011","E00000493","E00000493","Total",121,60,19,41,0,47,43,4,13,10,0,3,0,1
"2011","E00000495","E00000495","Total",117,65,23,42,0,41,37,4,8,7,0,1,0,3
"2011","E00000497","E00000497","Total",120,62,19,43,1,40,37,3,14,14,0,0,0,3
"2011","E00000500","E00000500","Total",125,62,20,42,0,40,32,8,23,20,0,3,0,0
"2011","E00000506","E00000506","Total",132,75,29,46,0,39,36,3,17,16,0,1,0,1
"2011","E00000494","E00000494","Total",135,65,29,36,0,45,38,7,21,21,0,0,0,4
"2011","E00000496","E00000496","Total",107,59,14,45,0,33,28,5,15,14,0,1,0,0
"2011","E00000498","E00000498","Total",114,65,28,37,0,37,30,7,12,12,0,0,0,0
"2011","E00000501","E00000501","Total",98,42,15,27,0,46,42,4,9,8,0,0,1,1
"2011","E00000503","E00000503","Total",113,59,17,42,0,43,41,2,10,9,0,0,1,1
"2011","E00000546","E00000546","Total",107,49,13,36,0,40,38,2,17,16,0,0,1,1
"2011","E00000554","E00000554","Total",116,87,30,57,1,4,2,2,23,21,0,1,1,1
"2011","E00000555","E00000555","Total",133,99,36,63,1,5,2,3,28,28,0,0,0,0
"2011","E00000556","E00000556","Total",120,94,52,42,1,9,3,6,14,13,0,1,0,2
"2011","E00000559","E00000559","Total",132,74,24,50,1,35,30,5,20,20,0,0,0,2
"2011","E00000547","E00000547","Total",126,90,33,57,0,21,18,3,15,15,0,0,0,0
"2011","E00000550","E00000550","Total",134,105,38,67,0,9,5,4,20,17,0,2,1,0
"2011","E00000552","E00000552","Total",129,99,41,58,0,4,1,3,25,25,0,0,0,1
"2011","E00000553","E00000553","Total",149,76,37,39,2,13,9,4,53,51,0,1,1,5
"2011","E00000557","E00000557","Total",101,73,32,41,0,6,5,1,21,21,0,0,0,1
"2011","E00000558","E00000558","Total",119,47,24,23,10,24,24,0,36,33,0,3,0,2
"2011","E00000168","E00000168","Total",149,87,35,52,0,47,43,4,13,11,0,2,0,2
"2011","E00000169","E00000169","Total",129,41,20,21,0,84,77,7,4,3,0,0,1,0
"2011","E00000172","E00000172","Total",156,86,30,56,0,57,52,5,12,12,0,0,0,1
"2011","E00000198","E00000198","Total",99,7,2,5,0,89,80,9,2,2,0,0,0,1
"2011","E00000299","E00000299","Total",116,75,34,41,0,28,27,1,9,8,0,0,1,4
"2011","E00000300","E00000300","Total",121,50,18,32,0,54,51,3,16,14,0,2,0,1
"2011","E00000301","E00000301","Total",132,62,25,37,0,55,52,3,13,12,0,1,0,2
"2011","E00000304","E00000304","Total",122,18,7,11,4,85,85,0,15,15,0,0,0,0
"2011","E00000308","E00000308","Total",165,105,40,65,13,34,18,16,12,12,0,0,0,1
"2011","E00000309","E00000309","Total",114,10,2,8,0,99,99,0,5,5,0,0,0,0
"2011","E00000305","E00000305","Total",136,16,1,15,2,111,110,1,5,4,1,0,0,2
"2011","E00000327","E00000327","Total",133,19,4,15,0,110,109,1,4,3,0,0,1,0
"2011","E00000328","E00000328","Total",140,17,3,14,0,112,111,1,10,10,0,0,0,1
"2011","E00000329","E00000329","Total",132,5,2,3,0,124,122,2,3,3,0,0,0,0
"2011","E00000330","E00000330","Total",127,13,1,12,1,110,109,1,3,3,0,0,0,0
"2011","E00000312","E00000312","Total",123,65,27,38,0,44,36,8,12,12,0,0,0,2
"2011","E00000313","E00000313","Total",144,104,56,48,2,15,14,1,23,16,2,4,1,0
"2011","E00000317","E00000317","Total",103,15,5,10,0,84,82,2,3,3,0,0,0,1
"2011","E00000319","E00000319","Total",125,50,21,29,1,62,60,2,11,11,0,0,0,1
"2011","E00000320","E00000320","Total",137,113,43,70,0,7,5,2,17,17,0,0,0,0
"2011","E00000322","E00000322","Total",129,58,25,33,1,43,41,2,24,21,0,3,0,3
"2011","E00000307","E00000307","Total",146,82,32,50,0,46,39,7,17,16,0,0,1,1
"2011","E00000310","E00000310","Total",139,41,13,28,8,69,64,5,20,17,0,3,0,1
"2011","E00000311","E00000311","Total",135,93,37,56,0,24,22,2,18,17,0,0,1,0
"2011","E00000314","E00000314","Total",136,69,35,34,0,48,48,0,18,17,0,1,0,1
"2011","E00000326","E00000326","Total",153,78,40,38,0,22,14,8,44,41,0,2,1,9
"2011","E00000316","E00000316","Total",134,67,20,47,0,27,26,1,38,34,0,3,1,2
"2011","E00000318","E00000318","Total",112,25,8,17,0,70,68,2,15,14,0,1,0,2
"2011","E00000321","E00000321","Total",123,54,23,31,0,55,53,2,13,11,0,2,0,1
"2011","E00000323","E00000323","Total",126,31,6,25,0,80,79,1,14,13,0,1,0,1
"2011","E00000324","E00000324","Total",147,49,20,29,1,78,57,21,19,16,0,1,2,0
"2011","E00000325","E00000325","Total",132,64,27,37,0,47,44,3,19,17,0,2,0,2
"2011","E00000390","E00000390","Total",136,69,24,45,0,47,36,11,18,16,0,1,1,2
"2011","E00000391","E00000391","Total",127,60,19,41,0,55,49,6,10,9,0,0,1,2
"2011","E00000392","E00000392","Total",125,46,17,29,2,45,39,6,32,28,1,3,0,0
"2011","E00000397","E00000397","Total",144,51,18,33,1,70,48,22,18,14,0,1,3,4
"2011","E00000402","E00000402","Total",117,58,20,38,0,39,30,9,16,15,0,1,0,4
"2011","E00000401","E00000401","Total",124,55,20,35,0,49,42,7,19,19,0,0,0,1
"2011","E00000405","E00000405","Total",112,50,18,32,0,45,41,4,17,17,0,0,0,0
"2011","E00000407","E00000407","Total",133,63,22,41,1,44,40,4,23,19,0,4,0,2
"2011","E00000408","E00000408","Total",118,66,19,47,0,38,34,4,14,14,0,0,0,0
"2011","E00000411","E00000411","Total",107,54,20,34,0,37,33,4,15,14,0,1,0,1
"2011","E00000398","E00000398","Total",129,77,30,47,0,38,37,1,14,13,0,1,0,0
"2011","E00000399","E00000399","Total",119,53,15,38,0,45,43,2,20,19,0,1,0,1
"2011","E00000400","E00000400","Total",125,75,20,55,0,36,36,0,13,12,0,1,0,1
"2011","E00000403","E00000403","Total",144,81,27,54,3,37,37,0,22,21,0,1,0,1
"2011","E00000404","E00000404","Total",131,65,21,44,0,43,38,5,23,21,0,2,0,0
"2011","E00000393","E00000393","Total",142,79,19,60,1,52,47,5,10,10,0,0,0,0
"2011","E00000396","E00000396","Total",128,55,23,32,1,50,50,0,21,19,0,1,1,1
"2011","E00000414","E00000414","Total",110,51,15,36,0,39,37,2,20,19,0,1,0,0
"2011","E00000415","E00000415","Total",122,57,22,35,2,40,39,1,21,21,0,0,0,2
"2011","E00000416","E00000416","Total",170,36,4,32,33,86,67,19,13,13,0,0,0,2
"2011","E00000394","E00000394","Total",115,64,26,38,0,37,34,3,14,13,0,1,0,0
"2011","E00000395","E00000395","Total",139,72,26,46,0,37,36,1,28,26,0,1,1,2
"2011","E00000417","E00000417","Total",118,56,20,36,1,47,41,6,14,13,0,0,1,0
"2011","E00000418","E00000418","Total",138,59,22,37,0,59,51,8,19,17,0,2,0,1
"2011","E00000419","E00000419","Total",119,56,21,35,2,42,37,5,19,18,0,1,0,0
"2011","E00000502","E00000502","Total",120,65,23,42,0,39,34,5,16,16,0,0,0,0
"2011","E00000505","E00000505","Total",126,75,27,48,1,38,36,2,12,11,0,1,0,0
"2011","E00000507","E00000507","Total",139,67,22,45,0,53,49,4,17,15,0,2,0,2
"2011","E00000508","E00000508","Total",113,56,14,42,0,42,41,1,14,13,0,0,1,1
"2011","E00000509","E00000509","Total",127,38,10,28,0,76,70,6,11,9,0,2,0,2
"2011","E00000112","E00000112","Total",118,53,12,41,0,16,16,0,47,46,0,1,0,2
"2011","E00000117","E00000117","Total",108,11,2,9,0,55,30,25,42,41,0,0,1,0
"2011","E00000118","E00000118","Total",112,66,21,45,0,22,22,0,21,20,0,1,0,3
"2011","E00000119","E00000119","Total",121,48,15,33,3,41,36,5,20,18,0,2,0,9
"2011","E00000121","E00000121","Total",134,55,22,33,12,29,24,5,37,37,0,0,0,1
"2011","E00000116","E00000116","Total",116,62,25,37,7,29,26,3,15,15,0,0,0,3
"2011","E00000120","E00000120","Total",118,62,23,39,1,33,31,2,20,19,0,0,1,2
"2011","E00000122","E00000122","Total",117,66,22,44,14,21,20,1,13,12,0,1,0,3
"2011","E00000124","E00000124","Total",123,50,13,37,5,40,37,3,25,23,0,1,1,3
"2011","E00000125","E00000125","Total",143,52,19,33,1,63,60,3,21,19,0,2,0,6
"2011","E00000126","E00000126","Total",133,50,15,35,11,6,4,2,63,60,0,3,0,3
"2011","E00000127","E00000127","Total",224,102,28,74,5,67,62,5,45,44,0,0,1,5
"2011","E00000101","E00000101","Total",113,75,27,48,0,23,23,0,12,12,0,0,0,3
"2011","E00000102","E00000102","Total",110,58,23,35,1,29,26,3,20,19,0,1,0,2
"2011","E00000128","E00000128","Total",101,52,17,35,0,28,27,1,21,18,0,3,0,0
"2011","E00000130","E00000130","Total",132,58,16,42,0,51,45,6,22,21,0,0,1,1
"2011","E00000129","E00000129","Total",138,53,16,37,0,58,47,11,26,24,0,1,1,1
"2011","E00000131","E00000131","Total",118,63,33,30,2,38,25,13,14,14,0,0,0,1
"2011","E00000132","E00000132","Total",128,52,14,38,3,59,25,34,14,13,0,1,0,0
"2011","E00000133","E00000133","Total",119,55,18,37,8,42,31,11,14,14,0,0,0,0
"2011","E00000134","E00000134","Total",126,79,31,48,2,30,26,4,15,14,0,1,0,0
"2011","E00000364","E00000364","Total",103,38,12,26,3,48,24,24,12,11,0,1,0,2
"2011","E00000365","E00000365","Total",96,26,5,21,0,31,21,10,34,32,1,1,0,5
"2011","E00000366","E00000366","Total",104,50,15,35,0,35,30,5,19,17,0,1,1,0
"2011","E00000367","E00000367","Total",141,79,24,55,1,46,39,7,14,14,0,0,0,1
"2011","E00000369","E00000369","Total",116,60,20,40,0,42,40,2,13,12,0,1,0,1
"2011","E00000071","E00000071","Total",115,51,20,31,1,40,35,5,22,22,0,0,0,1
"2011","E00000080","E00000080","Total",206,80,13,67,12,44,36,8,69,64,0,4,1,1
"2011","E00000084","E00000084","Total",114,41,17,24,0,53,43,10,20,19,0,0,1,0
"2011","E00000091","E00000091","Total",203,58,15,43,2,80,49,31,60,57,0,3,0,3
"2011","E00000095","E00000095","Total",198,75,18,57,35,52,51,1,35,31,0,4,0,1
"2011","E00000070","E00000070","Total",150,66,20,46,0,64,60,4,18,18,0,0,0,2
"2011","E00000074","E00000074","Total",100,55,15,40,0,34,30,4,11,10,0,1,0,0
"2011","E00000076","E00000076","Total",106,53,11,42,1,36,32,4,15,12,1,2,0,1
"2011","E00000081","E00000081","Total",121,56,23,33,1,44,42,2,19,19,0,0,0,1
"2011","E00000100","E00000100","Total",149,74,26,48,0,48,43,5,26,21,0,3,2,1
"2011","E00000072","E00000072","Total",120,63,22,41,0,41,39,2,16,16,0,0,0,0
"2011","E00000073","E00000073","Total",116,46,15,31,0,44,41,3,24,22,0,1,1,2
"2011","E00000075","E00000075","Total",129,64,27,37,0,51,43,8,14,14,0,0,0,0
"2011","E00000077","E00000077","Total",130,63,13,50,0,57,54,3,9,8,0,1,0,1
"2011","E00000078","E00000078","Total",114,57,13,44,0,46,43,3,10,10,0,0,0,1
"2011","E00000079","E00000079","Total",130,73,21,52,1,48,42,6,7,7,0,0,0,1
"2011","E00000082","E00000082","Total",124,67,19,48,2,34,29,5,19,18,0,1,0,2
"2011","E00000083","E00000083","Total",117,50,16,34,0,52,50,2,15,15,0,0,0,0
"2011","E00000088","E00000088","Total",114,55,15,40,0,46,43,3,11,10,0,1,0,2
"2011","E00000089","E00000089","Total",127,57,15,42,0,54,52,2,15,14,0,1,0,1
"2011","E00000406","E00000406","Total",124,59,21,38,1,44,41,3,19,17,0,2,0,1
"2011","E00000409","E00000409","Total",128,68,32,36,1,44,41,3,13,11,0,2,0,2
"2011","E00000410","E00000410","Total",111,54,22,32,4,34,32,2,18,17,0,1,0,1
"2011","E00000412","E00000412","Total",132,54,16,38,0,65,35,30,12,8,0,3,1,1
"2011","E00000413","E00000413","Total",114,52,18,34,1,40,33,7,20,18,0,2,0,1
"2011","E00000167","E00000167","Total",103,81,43,38,0,10,1,9,11,11,0,0,0,1
"2011","E00000173","E00000173","Total",139,79,31,48,0,38,24,14,19,16,1,2,0,3
"2011","E00000175","E00000175","Total",121,60,20,40,1,30,28,2,30,26,0,4,0,0
"2011","E00000176","E00000176","Total",120,102,55,47,0,3,1,2,14,13,0,1,0,1
"2011","E00000177","E00000177","Total",84,33,17,16,1,28,28,0,21,20,0,1,0,1
"2011","E00000174","E00000174","Total",127,102,46,56,1,3,2,1,21,19,0,2,0,0
"2011","E00000178","E00000178","Total",132,96,37,59,0,10,9,1,24,23,0,0,1,2
"2011","E00000179","E00000179","Total",110,83,34,49,1,2,2,0,23,21,0,1,1,1
"2011","E00000180","E00000180","Total",100,82,31,51,0,4,3,1,14,14,0,0,0,0
"2011","E00000513","E00000513","Total",142,117,52,65,0,9,8,1,15,15,0,0,0,1
"2011","E00000514","E00000514","Total",109,65,28,37,2,24,21,3,18,17,0,1,0,0
"2011","E00000519","E00000519","Total",126,76,45,31,0,35,30,5,14,12,1,1,0,1
"2011","E00000527","E00000527","Total",120,93,45,48,0,8,4,4,18,16,0,2,0,1
"2011","E00000538","E00000538","Total",104,70,24,46,1,12,9,3,19,19,0,0,0,2
"2011","E00000539","E00000539","Total",116,90,43,47,2,5,2,3,17,17,0,0,0,2
"2011","E00000540","E00000540","Total",121,97,48,49,0,4,4,0,19,17,0,1,1,1
"2011","E00000541","E00000541","Total",143,41,14,27,0,26,8,18,73,70,1,2,0,3
"2011","E00000543","E00000543","Total",132,86,39,47,1,12,9,3,28,28,0,0,0,5
"2011","E00000544","E00000544","Total",140,68,20,48,2,26,10,16,42,42,0,0,0,2
"2011","E00000331","E00000331","Total",138,61,17,44,0,56,55,1,20,19,0,1,0,1
"2011","E00000341","E00000341","Total",134,83,32,51,0,31,30,1,17,16,0,1,0,3
"2011","E00000354","E00000354","Total",132,60,22,38,1,55,48,7,14,13,0,1,0,2
"2011","E00000356","E00000356","Total",128,94,37,57,0,21,21,0,10,10,0,0,0,3
"2011","E00000357","E00000357","Total",151,107,41,66,0,28,28,0,16,16,0,0,0,0
"2011","E00000332","E00000332","Total",143,128,58,70,1,1,1,0,11,8,0,3,0,2
"2011","E00000333","E00000333","Total",124,108,40,68,0,1,1,0,13,11,1,1,0,2
"2011","E00000335","E00000335","Total",121,99,43,56,2,4,1,3,16,15,0,0,1,0
"2011","E00000355","E00000355","Total",156,88,38,50,0,41,39,2,23,21,0,1,1,4
"2011","E00000358","E00000358","Total",135,28,12,16,0,82,82,0,22,21,0,1,0,3
"2011","E00000334","E00000334","Total",122,104,38,66,0,3,3,0,13,13,0,0,0,2
"2011","E00000336","E00000336","Total",136,125,50,75,0,0,0,0,11,11,0,0,0,0
"2011","E00000339","E00000339","Total",118,101,43,58,0,0,0,0,15,14,0,1,0,2
"2011","E00000343","E00000343","Total",137,112,47,65,2,3,2,1,19,19,0,0,0,1
"2011","E00000337","E00000337","Total",117,62,26,36,0,21,20,1,31,31,0,0,0,3
"2011","E00000338","E00000338","Total",118,103,46,57,0,3,2,1,11,11,0,0,0,1
"2011","E00000340","E00000340","Total",113,91,43,48,0,7,6,1,13,13,0,0,0,2
"2011","E00000342","E00000342","Total",109,89,51,38,0,2,2,0,18,18,0,0,0,0
"2011","E00000345","E00000345","Total",141,122,60,62,1,3,1,2,14,14,0,0,0,1
"2011","E00000347","E00000347","Total",123,108,55,53,0,1,1,0,13,11,0,2,0,1
"2011","E00000348","E00000348","Total",212,94,29,65,0,61,24,37,53,51,0,1,1,4
"2011","E00000349","E00000349","Total",127,113,43,70,0,1,0,1,12,12,0,0,0,1
"2011","E00000351","E00000351","Total",136,102,46,56,5,6,5,1,23,21,0,0,2,0
"2011","E00000352","E00000352","Total",187,72,18,54,0,44,2,42,68,66,0,2,0,3
"2011","E00000274","E00000274","Total",109,53,12,41,0,41,40,1,14,14,0,0,0,1
"2011","E00000287","E00000287","Total",133,49,17,32,2,57,52,5,24,24,0,0,0,1
"2011","E00000288","E00000288","Total",179,59,19,40,28,69,44,25,23,20,0,2,1,0
"2011","E00000290","E00000290","Total",116,57,22,35,0,48,46,2,11,11,0,0,0,0
"2011","E00000368","E00000368","Total",114,59,19,40,0,36,36,0,17,14,0,3,0,2
"2011","E00000370","E00000370","Total",124,63,27,36,0,35,34,1,23,22,0,1,0,3
"2011","E00000374","E00000374","Total",129,65,19,46,1,46,43,3,16,16,0,0,0,1
"2011","E00000382","E00000382","Total",126,66,17,49,0,37,34,3,23,21,0,2,0,0
"2011","E00000384","E00000384","Total",134,66,23,43,0,41,39,2,23,22,0,1,0,4
"2011","E00000371","E00000371","Total",123,56,18,38,0,54,49,5,13,13,0,0,0,0
"2011","E00000372","E00000372","Total",135,47,9,38,0,64,61,3,21,21,0,0,0,3
"2011","E00000375","E00000375","Total",107,45,18,27,1,39,38,1,22,22,0,0,0,0
"2011","E00000377","E00000377","Total",113,55,19,36,0,45,42,3,12,11,0,1,0,1
"2011","E00000380","E00000380","Total",151,61,19,42,0,64,64,0,23,23,0,0,0,3
"2011","E00000362","E00000362","Total",111,52,15,37,0,41,40,1,18,16,0,2,0,0
"2011","E00000376","E00000376","Total",127,90,44,46,1,33,30,3,2,2,0,0,0,1
"2011","E00000379","E00000379","Total",140,66,27,39,0,56,54,2,16,16,0,0,0,2
"2011","E00000386","E00000386","Total",128,91,35,56,1,24,23,1,11,10,1,0,0,1
"2011","E00000387","E00000387","Total",116,47,10,37,0,47,47,0,20,14,1,5,0,2
"2011","E00000360","E00000360","Total",115,45,11,34,0,46,42,4,24,19,0,5,0,0
"2011","E00000361","E00000361","Total",131,57,15,42,0,55,52,3,13,12,0,1,0,6
"2011","E00000363","E00000363","Total",104,35,12,23,0,44,39,5,24,21,0,2,1,1
"2011","E00000383","E00000383","Total",114,44,20,24,0,56,52,4,14,12,0,1,1,0
"2011","E00000388","E00000388","Total",117,49,15,34,2,51,45,6,14,13,0,1,0,1
"2011","E00000389","E00000389","Total",129,62,17,45,1,52,47,5,14,13,0,1,0,0
"2011","E00000090","E00000090","Total",115,62,26,36,0,39,33,6,12,11,0,0,1,2
"2011","E00000093","E00000093","Total",144,46,15,31,2,58,36,22,38,37,0,0,1,0
"2011","E00000094","E00000094","Total",140,57,25,32,0,61,54,7,20,19,0,1,0,2
"2011","E00000096","E00000096","Total",127,57,25,32,0,53,52,1,16,15,0,0,1,1
"2011","E00000097","E00000097","Total",124,68,26,42,0,43,42,1,13,12,1,0,0,0
"2011","E00000085","E00000085","Total",114,51,20,31,1,49,45,4,12,11,0,1,0,1
"2011","E00000086","E00000086","Total",123,65,25,40,0,37,37,0,20,19,0,1,0,1
"2011","E00000087","E00000087","Total",77,30,14,16,0,29,27,2,17,16,0,1,0,1
"2011","E00000092","E00000092","Total",142,73,31,42,0,46,44,2,22,20,0,2,0,1
"2011","E00000098","E00000098","Total",111,61,17,44,0,36,35,1,14,14,0,0,0,0
"2011","E00000099","E00000099","Total",71,17,6,11,0,43,43,0,11,11,0,0,0,0
"2011","E00000266","E00000266","Total",128,64,26,38,0,52,43,9,12,12,0,0,0,0
"2011","E00000268","E00000268","Total",136,59,19,40,2,54,42,12,21,21,0,0,0,0
"2011","E00000285","E00000285","Total",92,55,13,42,0,24,22,2,13,12,1,0,0,0
"2011","E00000289","E00000289","Total",118,58,25,33,0,45,38,7,12,11,0,0,1,3
"2011","E00000293","E00000293","Total",104,40,7,33,1,49,46,3,13,11,1,1,0,1
"2011","E00000439","E00000439","Total",102,51,19,32,0,36,29,7,15,13,0,0,2,0
"2011","E00000440","E00000440","Total",146,55,17,38,0,65,61,4,24,23,0,1,0,2
"2011","E00000441","E00000441","Total",138,60,20,40,2,51,44,7,25,23,0,1,1,0
"2011","E00000446","E00000446","Total",131,45,15,30,0,62,56,6,22,22,0,0,0,2
"2011","E00000442","E00000442","Total",129,40,17,23,0,67,50,17,19,18,0,1,0,3
"2011","E00000443","E00000443","Total",119,51,17,34,0,46,40,6,21,20,1,0,0,1
"2011","E00000445","E00000445","Total",133,65,27,38,0,55,50,5,13,12,0,0,1,0
"2011","E00000447","E00000447","Total",106,20,8,12,1,76,37,39,9,9,0,0,0,0
"2011","E00000449","E00000449","Total",153,54,18,36,0,42,33,9,53,51,0,1,1,4
"2011","E00000422","E00000422","Total",145,65,16,49,6,58,45,13,16,15,0,1,0,0
"2011","E00000423","E00000423","Total",127,61,20,41,1,47,41,6,18,17,0,1,0,0
"2011","E00000444","E00000444","Total",113,54,21,33,0,39,36,3,18,18,0,0,0,2
"2011","E00000448","E00000448","Total",123,64,22,42,0,51,50,1,8,8,0,0,0,0
"2011","E00000532","E00000532","Total",137,62,21,41,0,51,2,49,24,24,0,0,0,0
"2011","E00000534","E00000534","Total",114,65,34,31,0,39,5,34,8,7,0,0,1,2
"2011","E00000535","E00000535","Total",98,40,13,27,0,40,7,33,15,15,0,0,0,3
"2011","E00000536","E00000536","Total",113,17,0,17,0,68,68,0,28,26,0,2,0,0
"2011","E00000537","E00000537","Total",138,82,12,70,1,19,11,8,34,32,0,1,1,2
"2011","E00000518","E00000518","Total",115,72,41,31,0,28,25,3,15,15,0,0,0,0
"2011","E00000522","E00000522","Total",148,18,3,15,6,105,98,7,18,17,0,1,0,1
"2011","E00000523","E00000523","Total",122,65,28,37,0,39,38,1,17,16,0,1,0,1
"2011","E00000524","E00000524","Total",123,20,8,12,1,92,84,8,10,10,0,0,0,0
"2011","E00000530","E00000530","Total",115,14,4,10,0,90,81,9,11,10,1,0,0,0
"2011","E00000531","E00000531","Total",116,21,11,10,13,71,32,39,11,11,0,0,0,0
"2011","E00000511","E00000511","Total",159,10,4,6,0,134,134,0,15,15,0,0,0,0
"2011","E00000517","E00000517","Total",129,59,28,31,2,48,45,3,19,18,0,1,0,1
"2011","E00000520","E00000520","Total",199,71,20,51,22,74,59,15,32,31,0,1,0,0
"2011","E00000521","E00000521","Total",134,52,24,28,1,60,48,12,20,20,0,0,0,1
"2011","E00000528","E00000528","Total",124,22,10,12,7,83,70,13,12,10,0,1,1,0
"2011","E00000533","E00000533","Total",170,27,9,18,0,132,83,49,8,7,1,0,0,3
"2011","E00000512","E00000512","Total",136,56,23,33,2,60,54,6,18,16,0,2,0,0
"2011","E00000515","E00000515","Total",135,36,3,33,1,18,13,5,78,77,0,1,0,2
"2011","E00000516","E00000516","Total",117,19,10,9,0,80,66,14,17,15,0,2,0,1
"2011","E00000525","E00000525","Total",182,41,18,23,0,129,104,25,12,12,0,0,0,0
"2011","E00000526","E00000526","Total",142,52,20,32,4,60,54,6,25,23,0,1,1,1
"2011","E00000529","E00000529","Total",84,41,22,19,0,36,34,2,7,6,0,0,1,0
"2011","E00000542","E00000542","Total",120,18,3,15,0,48,46,2,51,50,0,0,1,3
"2011","E00000040","E00000040","Total",67,16,4,12,0,11,11,0,40,39,1,0,0,0
"2011","E00000046","E00000046","Total",147,25,6,19,16,60,11,49,43,41,0,0,2,3
"2011","E00000052","E00000052","Total",157,42,12,30,0,74,72,2,40,36,0,2,2,1
"2011","E00175106","E00175106","Total",241,36,3,33,0,104,37,67,99,80,0,10,9,2
"2011","E00000043","E00000043","Total",123,13,5,8,1,93,91,2,13,12,0,1,0,3
"2011","E00000048","E00000048","Total",145,17,10,7,0,114,107,7,13,13,0,0,0,1
"2011","E00000050","E00000050","Total",140,29,2,27,0,82,80,2,28,25,0,1,2,1
"2011","E00000056","E00000056","Total",113,29,7,22,0,58,55,3,25,25,0,0,0,1
"2011","E00000057","E00000057","Total",123,14,6,8,0,73,72,1,34,27,2,3,2,2
"2011","E00000061","E00000061","Total",105,23,3,20,0,61,57,4,21,20,0,1,0,0
"2011","E00000062","E00000062","Total",204,24,12,12,6,36,16,20,136,132,0,1,3,2
"2011","E00000063","E00000063","Total",82,42,17,25,1,9,4,5,30,22,0,1,7,0
"2011","E00175102","E00175102","Total",63,33,11,22,1,6,4,2,22,20,0,2,0,1
"2011","E00175103","E00175103","Total",158,77,9,68,2,15,12,3,64,62,0,1,1,0
"2011","E00175104","E00175104","Total",132,13,1,12,6,83,2,81,30,26,0,0,4,0
"2011","E00175105","E00175105","Total",236,23,2,21,2,5,0,5,206,205,1,0,0,0
"2011","E00000039","E00000039","Total",141,37,9,28,0,15,15,0,87,84,1,2,0,2
"2011","E00000045","E00000045","Total",102,37,4,33,0,21,6,15,44,44,0,0,0,0
"2011","E00000065","E00000065","Total",191,55,13,42,4,56,9,47,76,73,0,3,0,0
"2011","E00000067","E00000067","Total",133,60,21,39,1,7,5,2,64,62,0,1,1,1
"2011","E00000069","E00000069","Total",131,18,3,15,0,55,24,31,57,57,0,0,0,1
"2011","E00000049","E00000049","Total",119,83,32,51,0,4,0,4,31,23,0,8,0,1
"2011","E00000053","E00000053","Total",121,80,32,48,0,2,0,2,38,33,0,5,0,1
"2011","E00000055","E00000055","Total",119,91,35,56,0,2,1,1,26,25,0,1,0,0
"2011","E00000059","E00000059","Total",112,39,7,32,0,8,8,0,65,65,0,0,0,0
"2011","E00000060","E00000060","Total",72,52,30,22,0,2,2,0,18,17,0,0,1,0
"2011","E00000037","E00000037","Total",110,46,20,26,0,23,15,8,40,35,0,3,2,1
"2011","E00000041","E00000041","Total",89,42,18,24,0,1,0,1,46,37,0,7,2,0
"2011","E00000042","E00000042","Total",144,20,5,15,2,90,90,0,30,29,0,1,0,2
"2011","E00000051","E00000051","Total",178,79,36,43,0,7,6,1,91,90,0,1,0,1
"2011","E00000054","E00000054","Total",117,69,37,32,2,10,8,2,36,30,0,5,1,0
"2011","E00000038","E00000038","Total",116,64,27,37,3,11,7,4,36,28,0,7,1,2
"2011","E00000064","E00000064","Total",99,53,18,35,1,6,3,3,37,35,0,1,1,2
"2011","E00000066","E00000066","Total",131,56,18,38,2,10,8,2,59,57,0,2,0,4
"2011","E00000068","E00000068","Total",111,57,24,33,1,8,7,1,41,40,0,1,0,4
"2011","E00000201","E00000201","Total",119,63,26,37,1,16,13,3,38,36,0,2,0,1
"2011","E00000220","E00000220","Total",104,58,17,41,1,18,2,16,27,25,0,2,0,0
"2011","E00000222","E00000222","Total",143,80,32,48,2,16,10,6,44,43,0,1,0,1
"2011","E00000228","E00000228","Total",133,86,40,46,2,11,9,2,34,31,0,3,0,0
"2011","E00000229","E00000229","Total",130,84,29,55,2,11,8,3,30,29,0,1,0,3
"2011","E00000344","E00000344","Total",123,97,45,52,0,4,4,0,21,19,0,2,0,1
"2011","E00000346","E00000346","Total",107,70,33,37,1,1,1,0,32,31,0,1,0,3
"2011","E00000350","E00000350","Total",108,88,43,45,1,5,3,2,14,12,0,1,1,0
"2011","E00000353","E00000353","Total",124,95,37,58,0,1,1,0,26,25,0,1,0,2
"2011","E00000200","E00000200","Total",126,57,11,46,1,58,57,1,9,7,0,1,1,1
"2011","E00000202","E00000202","Total",130,62,22,40,0,48,46,2,20,19,0,0,1,0
"2011","E00000203","E00000203","Total",128,73,24,49,1,36,27,9,18,16,0,2,0,0
"2011","E00000207","E00000207","Total",105,44,8,36,1,43,41,2,16,15,0,1,0,1
"2011","E00000209","E00000209","Total",118,67,27,40,0,35,33,2,15,13,0,2,0,1
"2011","E00000205","E00000205","Total",141,39,13,26,0,76,44,32,24,24,0,0,0,2
"2011","E00000206","E00000206","Total",128,34,7,27,1,66,53,13,23,21,0,1,1,4
"2011","E00000210","E00000210","Total",127,48,11,37,0,47,44,3,31,31,0,0,0,1
"2011","E00000211","E00000211","Total",129,43,9,34,1,63,56,7,21,19,0,2,0,1
"2011","E00000212","E00000212","Total",154,18,9,9,1,118,92,26,17,15,0,1,1,0
"2011","E00000199","E00000199","Total",153,48,10,38,4,57,51,6,44,40,0,2,2,0
"2011","E00000215","E00000215","Total",104,45,12,33,0,34,33,1,25,23,0,2,0,0
"2011","E00000217","E00000217","Total",114,48,18,30,1,50,43,7,15,13,0,2,0,0
"2011","E00000224","E00000224","Total",121,56,16,40,0,41,41,0,24,24,0,0,0,0
"2011","E00000226","E00000226","Total",110,44,18,26,0,52,49,3,14,14,0,0,0,0
"2011","E00000204","E00000204","Total",123,55,18,37,7,45,42,3,14,14,0,0,0,2
"2011","E00000208","E00000208","Total",145,76,28,48,3,48,42,6,18,16,0,1,1,0
"2011","E00000214","E00000214","Total",127,71,19,52,4,31,23,8,21,18,0,1,2,0
"2011","E00000219","E00000219","Total",118,56,20,36,0,44,37,7,18,15,0,3,0,0
"2011","E00000221","E00000221","Total",141,59,26,33,0,62,47,15,19,19,0,0,0,1
"2011","E00000373","E00000373","Total",125,47,12,35,0,50,46,4,27,25,0,2,0,1
"2011","E00000378","E00000378","Total",126,17,8,9,1,81,74,7,26,24,0,2,0,1
"2011","E00000381","E00000381","Total",129,55,20,35,0,54,38,16,18,18,0,0,0,2
"2011","E00000385","E00000385","Total",139,48,16,32,10,71,47,24,8,8,0,0,0,2
"2011","E00175118","E00175118","Total",109,47,14,33,1,43,38,5,18,17,0,0,1,0
"2011","E00175119","E00175119","Total",78,19,7,12,0,46,16,30,13,13,0,0,0,0
"2011","E00175120","E00175120","Total",78,15,0,15,7,6,3,3,49,49,0,0,0,1
"2011","E00000272","E00000272","Total",132,78,33,45,1,38,35,3,15,13,0,2,0,0
"2011","E00000286","E00000286","Total",131,59,15,44,0,53,50,3,19,19,0,0,0,0
"2011","E00000292","E00000292","Total",109,47,22,25,0,46,42,4,15,15,0,0,0,1
"2011","E00000294","E00000294","Total",140,63,22,41,0,51,47,4,24,23,0,1,0,2
"2011","E00000297","E00000297","Total",126,62,22,40,0,48,42,6,11,11,0,0,0,5
"2011","E00000267","E00000267","Total",110,65,19,46,0,30,28,2,12,12,0,0,0,3
"2011","E00000271","E00000271","Total",111,52,14,38,0,33,30,3,25,24,0,1,0,1
"2011","E00000273","E00000273","Total",109,57,11,46,4,38,33,5,9,8,1,0,0,1
"2011","E00000291","E00000291","Total",105,52,14,38,1,39,38,1,13,10,0,2,1,0
"2011","E00000296","E00000296","Total",125,60,21,39,0,50,45,5,14,14,0,0,0,1
"2011","E00000269","E00000269","Total",135,70,17,53,0,43,40,3,20,19,0,1,0,2
"2011","E00000270","E00000270","Total",124,60,21,39,1,42,35,7,20,19,0,1,0,1
"2011","E00000276","E00000276","Total",193,21,4,17,15,116,10,106,38,38,0,0,0,3
"2011","E00000295","E00000295","Total",121,64,25,39,2,41,39,2,12,12,0,0,0,2
"2011","E00000280","E00000280","Total",100,42,13,29,0,35,32,3,22,21,0,1,0,1
"2011","E00000282","E00000282","Total",114,44,9,35,0,50,47,3,19,18,0,1,0,1
"2011","E00000283","E00000283","Total",111,54,23,31,2,42,33,9,13,13,0,0,0,0
"2011","E00000284","E00000284","Total",127,54,19,35,0,49,42,7,23,23,0,0,0,1
"2011","E00175113","E00175113","Total",95,39,5,34,29,11,11,0,15,15,0,0,0,1
"2011","E00175114","E00175114","Total",143,66,16,50,9,43,32,11,23,22,0,1,0,2
"2011","E00000455","E00000455","Total",133,89,16,73,2,11,8,3,31,28,0,2,1,0
"2011","E00000463","E00000463","Total",138,66,20,46,0,58,55,3,11,11,0,0,0,3
"2011","E00000464","E00000464","Total",138,54,18,36,1,70,64,6,13,12,0,1,0,0
"2011","E00000469","E00000469","Total",140,75,5,70,1,8,6,2,55,53,0,2,0,1
"2011","E00000213","E00000213","Total",143,44,19,25,0,80,73,7,18,18,0,0,0,1
"2011","E00000216","E00000216","Total",118,45,13,32,0,60,57,3,13,12,0,1,0,0
"2011","E00000218","E00000218","Total",114,61,24,37,0,44,39,5,9,7,0,1,1,0
"2011","E00000223","E00000223","Total",136,26,2,24,1,75,69,6,34,34,0,0,0,0
"2011","E00000225","E00000225","Total",129,50,18,32,0,58,53,5,21,21,0,0,0,0
"2011","E00000227","E00000227","Total",121,76,29,47,1,24,24,0,18,18,0,0,0,2
"2011","E00000230","E00000230","Total",114,63,23,40,1,34,32,2,15,14,0,1,0,1
"2011","E00000231","E00000231","Total",104,47,16,31,0,45,42,3,12,12,0,0,0,0
"2011","E00000232","E00000232","Total",122,51,17,34,0,52,51,1,18,18,0,0,0,1
"2011","E00000246","E00000246","Total",109,53,28,25,0,21,17,4,33,29,0,4,0,2
"2011","E00000247","E00000247","Total",121,69,28,41,0,24,19,5,28,27,0,1,0,0
"2011","E00000249","E00000249","Total",140,29,9,20,8,68,67,1,31,28,0,2,1,4
"2011","E00000257","E00000257","Total",133,54,27,27,2,60,56,4,14,13,0,1,0,3
"2011","E00000260","E00000260","Total",112,30,8,22,0,66,64,2,15,13,0,1,1,1
"2011","E00000234","E00000234","Total",151,65,28,37,0,53,51,2,32,31,0,1,0,1
"2011","E00000237","E00000237","Total",156,57,21,36,1,62,58,4,34,31,0,3,0,2
"2011","E00000252","E00000252","Total",127,84,32,52,0,15,10,5,26,26,0,0,0,2
"2011","E00000255","E00000255","Total",125,69,14,55,1,23,19,4,31,27,0,3,1,1
"2011","E00000259","E00000259","Total",105,61,23,38,0,19,15,4,23,22,0,1,0,2
"2011","E00000261","E00000261","Total",105,47,19,28,0,38,34,4,20,20,0,0,0,0
"2011","E00000453","E00000453","Total",129,51,16,35,0,62,58,4,14,12,2,0,0,2
"2011","E00000466","E00000466","Total",119,36,11,25,1,70,69,1,11,11,0,0,0,1
"2011","E00000470","E00000470","Total",123,84,35,49,0,16,16,0,23,20,1,2,0,0
"2011","E00000478","E00000478","Total",116,78,30,48,1,18,13,5,17,12,0,5,0,2
"2011","E00175107","E00175107","Total",133,49,12,37,13,38,16,22,32,27,1,3,1,1
"2011","E00175115","E00175115","Total",87,47,4,43,7,6,6,0,27,27,0,0,0,0
"2011","E00175116","E00175116","Total",98,20,1,19,1,38,2,36,38,22,0,15,1,1
"2011","E00175117","E00175117","Total",79,7,1,6,15,37,6,31,20,20,0,0,0,0
"2011","E00175123","E00175123","Total",91,29,13,16,0,54,14,40,6,5,0,0,1,2
"2011","E00000265","E00000265","Total",133,46,11,35,4,55,43,12,28,28,0,0,0,0
"2011","E00000275","E00000275","Total",165,57,23,34,1,96,57,39,10,10,0,0,0,1
"2011","E00000277","E00000277","Total",136,44,9,35,6,47,5,42,36,36,0,0,0,3
"2011","E00000278","E00000278","Total",106,40,12,28,0,25,23,2,39,36,0,2,1,2
"2011","E00000279","E00000279","Total",105,29,12,17,11,16,6,10,48,46,0,2,0,1
"2011","E00000420","E00000420","Total",93,55,23,32,0,31,31,0,6,5,0,1,0,1
"2011","E00000425","E00000425","Total",139,51,13,38,6,57,45,12,25,23,1,1,0,0
"2011","E00000426","E00000426","Total",104,61,21,40,0,16,11,5,25,23,0,2,0,2
"2011","E00000431","E00000431","Total",167,56,13,43,7,60,55,5,44,44,0,0,0,0
"2011","E00000424","E00000424","Total",142,72,20,52,5,14,5,9,50,50,0,0,0,1
"2011","E00000427","E00000427","Total",115,82,40,42,0,4,0,4,29,27,0,1,1,0
"2011","E00000428","E00000428","Total",128,87,38,49,1,5,2,3,33,32,0,0,1,2
"2011","E00000430","E00000430","Total",110,77,25,52,0,7,7,0,26,24,0,1,1,0
"2011","E00000450","E00000450","Total",145,66,27,39,0,44,12,32,35,34,0,0,1,0
"2011","E00000429","E00000429","Total",121,82,27,55,0,11,10,1,28,27,0,1,0,0
"2011","E00000432","E00000432","Total",125,87,36,51,1,6,5,1,26,24,0,2,0,5
"2011","E00000433","E00000433","Total",112,75,26,49,1,8,6,2,27,25,1,1,0,1
"2011","E00000435","E00000435","Total",134,80,21,59,0,15,7,8,37,36,0,0,1,2
"2011","E00000436","E00000436","Total",120,93,35,58,0,8,6,2,19,19,0,0,0,0
"2011","E00000421","E00000421","Total",127,82,33,49,1,7,7,0,34,33,0,0,1,3
"2011","E00000434","E00000434","Total",133,82,36,46,0,14,11,3,34,33,1,0,0,3
"2011","E00000437","E00000437","Total",138,98,46,52,0,7,7,0,29,26,0,2,1,4
"2011","E00000438","E00000438","Total",151,90,35,55,0,12,11,1,49,46,0,2,1,0
"2011","E00000235","E00000235","Total",121,15,5,10,0,99,99,0,7,6,0,1,0,0
"2011","E00000239","E00000239","Total",141,7,0,7,0,112,112,0,21,20,0,1,0,1
"2011","E00000241","E00000241","Total",132,11,1,10,0,103,101,2,17,15,0,0,2,1
"2011","E00000254","E00000254","Total",124,4,2,2,1,104,101,3,14,12,0,1,1,1
"2011","E00000264","E00000264","Total",126,7,1,6,1,107,106,1,9,8,0,1,0,2
"2011","E00000236","E00000236","Total",116,57,30,27,0,44,42,2,14,11,0,1,2,1
"2011","E00000238","E00000238","Total",120,10,3,7,0,95,94,1,14,13,0,0,1,1
"2011","E00000243","E00000243","Total",153,17,2,15,7,117,117,0,11,11,0,0,0,1
"2011","E00000244","E00000244","Total",133,31,17,14,1,91,88,3,8,8,0,0,0,2
"2011","E00000245","E00000245","Total",121,20,4,16,4,82,80,2,15,13,0,0,2,0
"2011","E00000248","E00000248","Total",131,13,2,11,2,101,97,4,11,11,0,0,0,4
"2011","E00000250","E00000250","Total",161,30,5,25,2,101,100,1,26,21,1,2,2,2
"2011","E00000251","E00000251","Total",162,6,3,3,4,140,122,18,10,10,0,0,0,2
"2011","E00000256","E00000256","Total",147,17,3,14,14,103,103,0,8,7,0,1,0,5
"2011","E00000258","E00000258","Total",124,7,2,5,2,107,107,0,6,6,0,0,0,2
"2011","E00000240","E00000240","Total",156,30,6,24,1,104,103,1,17,17,0,0,0,4
"2011","E00000253","E00000253","Total",136,35,10,25,0,51,50,1,49,48,0,1,0,1
"2011","E00175108","E00175108","Total",132,33,3,30,0,48,37,11,50,46,0,4,0,1
"2011","E00175109","E00175109","Total",126,16,3,13,14,22,18,4,74,72,0,1,1,0
"2011","E00175111","E00175111","Total",81,18,1,17,14,21,7,14,28,25,0,3,0,0
"2011","E00000242","E00000242","Total",107,21,4,17,0,67,67,0,19,15,0,3,1,0
"2011","E00000263","E00000263","Total",215,31,11,20,22,128,96,32,34,32,0,1,1,0
"2011","E00175110","E00175110","Total",117,15,5,10,11,34,8,26,56,48,0,5,3,1
"2011","E00175112","E00175112","Total",47,9,1,8,3,27,25,2,8,8,0,0,0,0
"2011","E00175121","E00175121","Total",53,6,2,4,16,6,5,1,24,24,0,0,0,1
"2011","E00175122","E00175122","Total",79,16,3,13,2,47,44,3,13,13,0,0,0,1
"2011","E00000451","E00000451","Total",90,39,13,26,0,35,32,3,16,15,0,1,0,0
"2011","E00000456","E00000456","Total",146,30,9,21,0,92,89,3,22,21,0,1,0,2
"2011","E00000467","E00000467","Total",131,50,25,25,1,57,55,2,23,22,0,1,0,0
"2011","E00000471","E00000471","Total",138,41,17,24,0,77,73,4,19,18,0,0,1,1
"2011","E00000475","E00000475","Total",128,24,5,19,1,89,88,1,13,11,0,2,0,1
"2011","E00000454","E00000454","Total",124,22,8,14,1,81,81,0,19,17,0,2,0,1
"2011","E00000462","E00000462","Total",109,37,13,24,0,53,50,3,18,17,0,1,0,1
"2011","E00000465","E00000465","Total",152,48,8,40,2,76,73,3,22,21,0,1,0,4
"2011","E00000472","E00000472","Total",117,25,5,20,1,76,75,1,15,15,0,0,0,0
"2011","E00000480","E00000480","Total",140,33,8,25,1,84,82,2,22,21,0,1,0,0
"2011","E00000452","E00000452","Total",218,98,20,78,16,58,13,45,44,43,0,0,1,2
"2011","E00000457","E00000457","Total",109,53,11,42,3,7,6,1,46,41,0,5,0,0
"2011","E00000468","E00000468","Total",89,21,2,19,0,57,50,7,9,9,0,0,0,2
"2011","E00000477","E00000477","Total",50,29,9,20,0,3,3,0,18,17,0,1,0,0
"2011","E00000479","E00000479","Total",51,24,4,20,1,3,2,1,23,21,0,2,0,0
"2011","E00000458","E00000458","Total",94,8,2,6,0,78,78,0,8,8,0,0,0,0
"2011","E00000459","E00000459","Total",91,5,3,2,0,81,80,1,4,2,0,2,0,1
"2011","E00000460","E00000460","Total",93,5,2,3,3,83,83,0,2,2,0,0,0,0
"2011","E00000461","E00000461","Total",90,45,20,25,0,30,25,5,14,11,0,3,0,1
"2011","E00000474","E00000474","Total",133,58,17,41,1,54,49,5,20,20,0,0,0,0
"2011","E00000476","E00000476","Total",138,22,2,20,0,97,95,2,19,19,0,0,0,0
"2011","E00000104","E00000104","Total",127,71,31,40,0,35,32,3,19,17,0,2,0,2
"2011","E00000108","E00000108","Total",118,64,17,47,0,25,23,2,27,22,0,5,0,2
"2011","E00000109","E00000109","Total",133,78,37,41,0,29,26,3,26,23,0,1,2,0
"2011","E00000115","E00000115","Total",126,69,27,42,0,37,34,3,19,17,1,1,0,1
"2011","E00000110","E00000110","Total",117,43,9,34,0,53,38,15,20,15,0,4,1,1
"2011","E00000111","E00000111","Total",152,83,28,55,3,40,35,5,24,23,0,0,1,2
"2011","E00000113","E00000113","Total",133,84,23,61,6,26,24,2,16,16,0,0,0,1
"2011","E00000114","E00000114","Total",111,63,19,44,3,25,21,4,20,20,0,0,0,0
"2011","E00000123","E00000123","Total",137,55,17,38,0,63,57,6,14,14,0,0,0,5
"2011","E00000482","E00000482","Total",127,62,30,32,1,40,38,2,24,20,0,2,2,0
"2011","E00000484","E00000484","Total",159,52,22,30,1,84,58,26,20,16,0,4,0,2
"2011","E00000485","E00000485","Total",134,60,22,38,0,46,43,3,27,25,0,0,2,1
"2011","E00000487","E00000487","Total",119,46,10,36,2,61,56,5,10,10,0,0,0,0
"2011","E00000510","E00000510","Total",169,60,19,41,0,90,38,52,16,15,0,1,0,3
"2011","E00000481","E00000481","Total",137,46,15,31,2,66,65,1,21,19,0,0,2,2
"2011","E00000483","E00000483","Total",126,75,26,49,0,35,31,4,15,15,0,0,0,1
"2011","E00000489","E00000489","Total",135,60,19,41,0,45,38,7,30,28,2,0,0,0
"2011","E00000491","E00000491","Total",133,54,20,34,1,58,56,2,18,16,0,2,0,2
"2011","E00000504","E00000504","Total",94,34,12,22,0,17,15,2,42,40,0,1,1,1
"2011","E00000486","E00000486","Total",132,58,22,36,6,44,35,9,24,21,0,2,1,0
"2011","E00000488","E00000488","Total",140,72,25,47,0,49,43,6,18,16,0,2,0,1
"2011","E00000490","E00000490","Total",144,71,25,46,2,51,46,5,18,16,0,2,0,2
"2011","E00000492","E00000492","Total",121,66,19,47,5,39,34,5,10,9,0,0,1,1
"2011","E00000499","E00000499","Total",129,69,25,44,0,38,30,8,21,20,0,1,0,1
"2011","E00000103","E00000103","Total",139,37,12,25,7,70,21,49,25,24,0,1,0,0
"2011","E00000106","E00000106","Total",120,66,32,34,0,20,13,7,33,31,0,2,0,1
"2011","E00000107","E00000107","Total",134,58,20,38,0,48,43,5,27,23,0,3,1,1
"2011","E00165805","E00165805","Total",78,6,0,6,0,6,3,3,64,60,3,1,0,2
"2011","E00001224","E00001224","Total",125,88,46,42,1,2,2,0,32,29,1,2,0,2
"2011","E00001228","E00001228","Total",133,107,48,59,0,2,1,1,24,22,0,0,2,0
"2011","E00001230","E00001230","Total",152,78,28,50,0,34,4,30,38,34,0,2,2,2
"2011","E00001233","E00001233","Total",144,122,49,73,0,2,1,1,18,16,0,2,0,2
"2011","E00001234","E00001234","Total",112,80,32,48,0,8,0,8,22,22,0,0,0,2
"2011","E00001217","E00001217","Total",126,98,33,65,5,0,0,0,23,20,0,3,0,0
"2011","E00001218","E00001218","Total",108,106,67,39,0,1,0,1,0,0,0,0,0,1
"2011","E00001221","E00001221","Total",111,107,59,48,0,3,3,0,0,0,0,0,0,1
"2011","E00001226","E00001226","Total",118,91,39,52,0,2,1,1,24,21,0,3,0,1
"2011","E00001237","E00001237","Total",109,101,53,48,0,0,0,0,6,5,0,0,1,2
"2011","E00001211","E00001211","Total",221,83,29,54,1,40,18,22,93,90,1,2,0,4
"2011","E00001214","E00001214","Total",131,83,59,24,1,24,24,0,17,15,1,1,0,6
"2011","E00001220","E00001220","Total",158,90,34,56,27,9,0,9,32,32,0,0,0,0
"2011","E00001223","E00001223","Total",152,95,53,42,1,2,2,0,50,50,0,0,0,4
"2011","E00001229","E00001229","Total",129,126,56,70,0,0,0,0,3,3,0,0,0,0
"2011","E00001235","E00001235","Total",188,94,39,55,2,16,5,11,73,71,0,2,0,3
"2011","E00001209","E00001209","Total",130,115,63,52,0,3,1,2,7,7,0,0,0,5
"2011","E00001213","E00001213","Total",120,102,52,50,0,0,0,0,15,14,0,0,1,3
"2011","E00001215","E00001215","Total",131,105,60,45,1,9,2,7,11,9,0,2,0,5
"2011","E00001219","E00001219","Total",117,91,36,55,0,1,1,0,24,24,0,0,0,1
"2011","E00001222","E00001222","Total",124,107,43,64,0,1,0,1,15,15,0,0,0,1
"2011","E00001405","E00001405","Total",118,86,41,45,0,11,11,0,21,17,1,2,1,0
"2011","E00001425","E00001425","Total",137,97,57,40,0,7,1,6,30,28,0,2,0,3
"2011","E00001426","E00001426","Total",152,88,62,26,2,23,2,21,38,37,1,0,0,1
"2011","E00001431","E00001431","Total",114,86,54,32,0,6,6,0,20,20,0,0,0,2
"2011","E00001438","E00001438","Total",108,100,50,50,1,0,0,0,6,6,0,0,0,1
"2011","E00001424","E00001424","Total",130,119,61,58,0,0,0,0,11,10,0,1,0,0
"2011","E00001429","E00001429","Total",131,61,25,36,0,4,1,3,62,60,0,2,0,4
"2011","E00001430","E00001430","Total",120,109,64,45,1,0,0,0,10,10,0,0,0,0
"2011","E00001432","E00001432","Total",137,113,54,59,0,4,1,3,19,17,0,2,0,1
"2011","E00001434","E00001434","Total",124,113,61,52,0,0,0,0,9,8,0,1,0,2
"2011","E00000865","E00000865","Total",146,87,32,55,1,51,47,4,6,6,0,0,0,1
"2011","E00000867","E00000867","Total",122,71,24,47,1,44,43,1,6,6,0,0,0,0
"2011","E00000868","E00000868","Total",121,68,22,46,1,39,38,1,12,12,0,0,0,1
"2011","E00000869","E00000869","Total",133,82,36,46,1,38,25,13,11,11,0,0,0,1
"2011","E00001216","E00001216","Total",129,107,67,40,0,2,1,1,20,19,0,1,0,0
"2011","E00001236","E00001236","Total",135,101,47,54,1,6,6,0,22,22,0,0,0,5
"2011","E00001238","E00001238","Total",132,103,59,44,0,3,0,3,24,24,0,0,0,2
"2011","E00001241","E00001241","Total",125,105,57,48,1,1,0,1,17,17,0,0,0,1
"2011","E00001244","E00001244","Total",133,116,80,36,0,4,4,0,10,10,0,0,0,3
"2011","E00001210","E00001210","Total",133,93,37,56,3,9,5,4,28,25,0,1,2,0
"2011","E00001227","E00001227","Total",127,103,48,55,1,6,0,6,17,16,1,0,0,0
"2011","E00001231","E00001231","Total",128,78,46,32,1,4,2,2,45,44,0,1,0,0
"2011","E00001232","E00001232","Total",98,58,19,39,0,5,1,4,34,34,0,0,0,1
"2011","E00001240","E00001240","Total",139,86,33,53,4,8,3,5,41,38,1,1,1,0
"2011","E00001242","E00001242","Total",121,95,36,59,2,6,3,3,18,17,0,1,0,0
"2011","E00001206","E00001206","Total",178,95,48,47,1,22,4,18,56,53,0,3,0,4
"2011","E00001212","E00001212","Total",130,90,38,52,0,2,2,0,35,35,0,0,0,3
"2011","E00001239","E00001239","Total",126,78,32,46,5,8,5,3,35,35,0,0,0,0
"2011","E00001246","E00001246","Total",132,49,13,36,0,23,20,3,59,56,0,2,1,1
"2011","E00001248","E00001248","Total",205,91,47,44,0,60,14,46,47,46,0,0,1,7
"2011","E00001251","E00001251","Total",176,92,46,46,0,25,1,24,56,53,0,3,0,3
"2011","E00001207","E00001207","Total",123,87,37,50,0,9,1,8,25,25,0,0,0,2
"2011","E00001243","E00001243","Total",124,78,29,49,0,12,12,0,31,30,1,0,0,3
"2011","E00001245","E00001245","Total",119,51,12,39,1,43,26,17,24,24,0,0,0,0
"2011","E00001247","E00001247","Total",135,93,58,35,7,13,1,12,19,17,0,1,1,3
"2011","E00001250","E00001250","Total",118,73,30,43,2,2,2,0,40,37,0,3,0,1
"2011","E00001252","E00001252","Total",134,42,17,25,0,67,10,57,25,24,0,1,0,0
"2011","E00000824","E00000824","Total",108,62,33,29,0,25,21,4,18,17,0,1,0,3
"2011","E00000826","E00000826","Total",119,90,40,50,0,8,7,1,21,20,0,1,0,0
"2011","E00000827","E00000827","Total",128,95,47,48,0,15,9,6,15,13,0,2,0,3
"2011","E00000864","E00000864","Total",136,103,43,60,0,22,22,0,10,10,0,0,0,1
"2011","E00000866","E00000866","Total",157,119,66,53,1,0,0,0,35,34,0,0,1,2
"2011","E00000832","E00000832","Total",116,98,45,53,0,1,1,0,14,14,0,0,0,3
"2011","E00000834","E00000834","Total",108,93,49,44,0,2,0,2,13,11,0,1,1,0
"2011","E00000835","E00000835","Total",119,108,66,42,0,1,1,0,9,8,0,1,0,1
"2011","E00000836","E00000836","Total",122,107,65,42,1,3,3,0,11,9,0,1,1,0
"2011","E00000839","E00000839","Total",111,97,49,48,1,1,0,1,12,12,0,0,0,0
"2011","E00000821","E00000821","Total",107,41,13,28,1,5,4,1,59,59,0,0,0,1
"2011","E00000822","E00000822","Total",99,69,21,48,0,7,0,7,22,19,0,2,1,1
"2011","E00000828","E00000828","Total",110,77,50,27,13,0,0,0,20,20,0,0,0,0
"2011","E00000829","E00000829","Total",131,97,39,58,5,10,0,10,17,15,0,1,1,2
"2011","E00000831","E00000831","Total",123,95,35,60,0,4,1,3,22,20,0,1,1,2
"2011","E00000837","E00000837","Total",100,62,33,29,2,3,2,1,31,30,0,0,1,2
"2011","E00000844","E00000844","Total",116,106,58,48,0,5,3,2,4,3,0,1,0,1
"2011","E00000847","E00000847","Total",120,109,49,60,0,1,0,1,10,10,0,0,0,0
"2011","E00000850","E00000850","Total",113,99,58,41,0,2,2,0,10,10,0,0,0,2
"2011","E00000854","E00000854","Total",120,102,56,46,0,2,0,2,15,11,0,4,0,1
"2011","E00000857","E00000857","Total",133,69,36,33,0,16,3,13,36,29,0,1,6,12
"2011","E00001404","E00001404","Total",120,70,23,47,9,36,6,30,3,3,0,0,0,2
"2011","E00001419","E00001419","Total",117,89,53,36,1,14,13,1,12,12,0,0,0,1
"2011","E00001437","E00001437","Total",121,96,57,39,1,18,17,1,6,6,0,0,0,0
"2011","E00001442","E00001442","Total",120,94,38,56,0,7,4,3,19,18,0,1,0,0
"2011","E00001445","E00001445","Total",132,66,30,36,4,38,3,35,23,22,0,1,0,1
"2011","E00001406","E00001406","Total",122,80,32,48,3,35,31,4,4,4,0,0,0,0
"2011","E00001412","E00001412","Total",137,49,16,33,0,71,36,35,14,13,0,1,0,3
"2011","E00001413","E00001413","Total",111,76,37,39,1,27,15,12,4,4,0,0,0,3
"2011","E00001415","E00001415","Total",131,80,22,58,3,34,18,16,11,10,0,1,0,3
"2011","E00001420","E00001420","Total",121,56,22,34,0,53,39,14,11,11,0,0,0,1
"2011","E00001397","E00001397","Total",120,66,25,41,3,28,25,3,22,18,2,2,0,1
"2011","E00001401","E00001401","Total",116,55,28,27,1,43,40,3,14,12,1,1,0,3
"2011","E00001410","E00001410","Total",124,110,54,56,1,1,1,0,12,10,0,2,0,0
"2011","E00001418","E00001418","Total",96,88,36,52,1,1,1,0,4,3,0,1,0,2
"2011","E00001443","E00001443","Total",112,90,42,48,0,15,1,14,3,1,0,1,1,4
"2011","E00001398","E00001398","Total",116,42,17,25,0,57,51,6,15,13,0,0,2,2
"2011","E00001403","E00001403","Total",126,53,23,30,2,55,36,19,13,13,0,0,0,3
"2011","E00001409","E00001409","Total",141,25,11,14,0,110,105,5,5,4,0,1,0,1
"2011","E00001414","E00001414","Total",109,19,9,10,1,83,77,6,6,6,0,0,0,0
"2011","E00001417","E00001417","Total",139,46,18,28,9,68,58,10,14,14,0,0,0,2
"2011","E00001399","E00001399","Total",115,75,41,34,2,30,29,1,6,5,1,0,0,2
"2011","E00001407","E00001407","Total",146,14,6,8,37,91,51,40,3,2,0,0,1,1
"2011","E00001408","E00001408","Total",122,16,8,8,0,94,91,3,10,8,0,2,0,2
"2011","E00001411","E00001411","Total",93,13,7,6,0,72,68,4,7,7,0,0,0,1
"2011","E00001416","E00001416","Total",126,77,43,34,2,36,26,10,11,10,0,1,0,0
"2011","E00001396","E00001396","Total",153,75,29,46,0,45,5,40,31,30,0,0,1,2
"2011","E00001402","E00001402","Total",144,128,50,78,1,2,2,0,12,11,0,1,0,1
"2011","E00001427","E00001427","Total",132,75,42,33,0,21,19,2,34,33,0,1,0,2
"2011","E00001428","E00001428","Total",113,56,23,33,0,26,24,2,31,29,1,1,0,0
"2011","E00001433","E00001433","Total",130,72,37,35,0,48,28,20,9,8,0,0,1,1
"2011","E00001310","E00001310","Total",101,46,11,35,1,3,0,3,51,50,0,1,0,0
"2011","E00001343","E00001343","Total",116,87,44,43,0,7,6,1,21,18,0,2,1,1
"2011","E00001344","E00001344","Total",110,99,55,44,0,1,1,0,9,8,0,1,0,1
"2011","E00001345","E00001345","Total",127,120,62,58,0,2,2,0,5,5,0,0,0,0
"2011","E00001347","E00001347","Total",113,107,56,51,0,0,0,0,6,6,0,0,0,0
"2011","E00001303","E00001303","Total",122,98,59,39,0,0,0,0,23,23,0,0,0,1
"2011","E00001332","E00001332","Total",209,64,19,45,0,12,9,3,125,120,0,5,0,8
"2011","E00001333","E00001333","Total",137,95,50,45,1,3,1,2,37,32,0,4,1,1
"2011","E00001334","E00001334","Total",134,63,30,33,1,8,0,8,58,57,0,1,0,4
"2011","E00001335","E00001335","Total",143,69,30,39,8,4,0,4,61,59,0,2,0,1
"2011","E00001336","E00001336","Total",129,113,65,48,0,0,0,0,16,16,0,0,0,0
"2011","E00001337","E00001337","Total",131,98,47,51,0,20,13,7,11,10,0,1,0,2
"2011","E00001340","E00001340","Total",134,121,53,68,0,1,0,1,11,10,1,0,0,1
"2011","E00001346","E00001346","Total",141,115,54,61,3,3,2,1,19,19,0,0,0,1
"2011","E00001302","E00001302","Total",127,107,59,48,0,1,0,1,18,16,0,2,0,1
"2011","E00001304","E00001304","Total",144,100,61,39,0,18,0,18,26,23,0,3,0,0
"2011","E00001338","E00001338","Total",127,110,52,58,0,0,0,0,17,17,0,0,0,0
"2011","E00001339","E00001339","Total",107,94,41,53,0,1,1,0,11,11,0,0,0,1
"2011","E00001342","E00001342","Total",121,67,30,37,0,5,3,2,49,46,0,2,1,0
"2011","E00000823","E00000823","Total",152,80,29,51,0,29,27,2,43,42,0,1,0,0
"2011","E00000841","E00000841","Total",113,98,55,43,0,8,8,0,7,7,0,0,0,0
"2011","E00000842","E00000842","Total",122,72,24,48,0,10,8,2,36,35,0,1,0,4
"2011","E00000845","E00000845","Total",132,103,55,48,2,5,0,5,21,19,1,1,0,1
"2011","E00000846","E00000846","Total",137,55,22,33,1,66,62,4,13,12,0,1,0,2
"2011","E00000825","E00000825","Total",121,47,14,33,3,3,3,0,65,64,0,1,0,3
"2011","E00000830","E00000830","Total",171,75,35,40,1,9,5,4,80,79,0,1,0,6
"2011","E00000833","E00000833","Total",125,72,32,40,0,12,11,1,38,36,0,2,0,3
"2011","E00000838","E00000838","Total",124,51,10,41,0,5,5,0,67,66,0,1,0,1
"2011","E00000840","E00000840","Total",144,61,17,44,0,10,0,10,70,67,0,2,1,3
"2011","E00000843","E00000843","Total",171,91,29,62,0,27,10,17,51,44,0,7,0,2
"2011","E00000848","E00000848","Total",121,118,56,62,0,0,0,0,2,1,1,0,0,1
"2011","E00000849","E00000849","Total",135,72,33,39,0,35,4,31,27,26,0,1,0,1
"2011","E00000852","E00000852","Total",106,95,38,57,0,0,0,0,11,7,2,2,0,0
"2011","E00000856","E00000856","Total",129,114,50,64,1,3,1,2,11,9,0,2,0,0
"2011","E00000860","E00000860","Total",126,107,48,59,0,2,2,0,17,16,0,1,0,0
"2011","E00000819","E00000819","Total",161,80,42,38,1,71,23,48,9,7,0,1,1,0
"2011","E00000851","E00000851","Total",171,93,42,51,0,15,9,6,63,62,0,0,1,0
"2011","E00000853","E00000853","Total",127,30,6,24,1,3,2,1,92,88,0,3,1,1
"2011","E00000855","E00000855","Total",161,92,30,62,0,5,1,4,64,63,0,1,0,0
"2011","E00000858","E00000858","Total",146,126,45,81,1,4,4,0,12,12,0,0,0,3
"2011","E00000820","E00000820","Total",115,101,51,50,0,2,1,1,11,11,0,0,0,1
"2011","E00000859","E00000859","Total",104,49,16,33,2,1,0,1,50,47,0,3,0,2
"2011","E00000861","E00000861","Total",115,106,55,51,0,1,1,0,6,5,0,1,0,2
"2011","E00000862","E00000862","Total",163,136,73,63,1,10,1,9,13,13,0,0,0,3
"2011","E00000863","E00000863","Total",121,109,54,55,0,0,0,0,11,10,0,1,0,1
"2011","E00001108","E00001108","Total",124,105,43,62,0,8,8,0,11,11,0,0,0,0
"2011","E00001117","E00001117","Total",107,80,36,44,0,10,9,1,15,12,2,0,1,2
"2011","E00001118","E00001118","Total",128,86,31,55,1,24,23,1,14,14,0,0,0,3
"2011","E00001122","E00001122","Total",116,86,31,55,0,17,15,2,11,11,0,0,0,2
"2011","E00001208","E00001208","Total",133,120,68,52,0,2,1,1,8,6,0,1,1,3
"2011","E00001225","E00001225","Total",127,118,73,45,0,1,1,0,5,5,0,0,0,3
"2011","E00001249","E00001249","Total",128,115,77,38,0,1,1,0,11,11,0,0,0,1
"2011","E00001253","E00001253","Total",92,81,45,36,0,2,1,1,8,6,0,2,0,1
"2011","E00001254","E00001254","Total",117,100,56,44,0,0,0,0,12,11,0,0,1,5
"2011","E00001368","E00001368","Total",115,87,54,33,0,1,1,0,25,22,0,2,1,2
"2011","E00001370","E00001370","Total",128,110,67,43,2,1,1,0,14,14,0,0,0,1
"2011","E00001372","E00001372","Total",131,122,70,52,0,3,2,1,4,4,0,0,0,2
"2011","E00001380","E00001380","Total",139,119,70,49,0,1,0,1,13,13,0,0,0,6
"2011","E00001367","E00001367","Total",124,109,64,45,1,0,0,0,10,10,0,0,0,4
"2011","E00001369","E00001369","Total",130,110,69,41,0,3,2,1,13,12,1,0,0,4
"2011","E00001374","E00001374","Total",118,109,71,38,0,3,3,0,5,5,0,0,0,1
"2011","E00001375","E00001375","Total",125,118,70,48,0,1,1,0,5,4,0,1,0,1
"2011","E00001435","E00001435","Total",128,98,44,54,0,17,12,5,10,9,0,1,0,3
"2011","E00001436","E00001436","Total",135,79,37,42,1,37,36,1,17,17,0,0,0,1
"2011","E00001439","E00001439","Total",133,62,28,34,0,57,31,26,10,10,0,0,0,4
"2011","E00001440","E00001440","Total",121,67,20,47,1,25,20,5,26,25,0,1,0,2
"2011","E00001444","E00001444","Total",137,67,25,42,0,54,49,5,14,14,0,0,0,2
"2011","E00001400","E00001400","Total",125,62,35,27,2,53,51,2,8,8,0,0,0,0
"2011","E00001421","E00001421","Total",112,80,29,51,0,23,20,3,5,5,0,0,0,4
"2011","E00001422","E00001422","Total",161,147,139,8,2,5,4,1,5,5,0,0,0,2
"2011","E00001423","E00001423","Total",147,134,65,69,0,2,2,0,8,7,0,1,0,3
"2011","E00001441","E00001441","Total",129,78,33,45,0,34,34,0,16,16,0,0,0,1
"2011","E00001308","E00001308","Total",133,89,56,33,0,1,1,0,41,41,0,0,0,2
"2011","E00001309","E00001309","Total",113,79,52,27,3,2,2,0,28,26,0,1,1,1
"2011","E00001341","E00001341","Total",109,91,54,37,0,3,2,1,14,14,0,0,0,1
"2011","E00001348","E00001348","Total",108,103,48,55,0,1,0,1,2,1,0,1,0,2
"2011","E00001349","E00001349","Total",119,107,72,35,1,2,1,1,7,6,0,0,1,2
"2011","E00001305","E00001305","Total",110,94,47,47,0,2,1,1,13,13,0,0,0,1
"2011","E00001307","E00001307","Total",116,105,64,41,0,2,0,2,7,6,0,0,1,2
"2011","E00001311","E00001311","Total",120,109,62,47,0,2,1,1,8,8,0,0,0,1
"2011","E00001313","E00001313","Total",122,99,56,43,0,0,0,0,21,20,0,0,1,2
"2011","E00001306","E00001306","Total",130,78,41,37,1,1,1,0,50,48,0,1,1,0
"2011","E00001312","E00001312","Total",144,120,70,50,0,0,0,0,19,17,0,1,1,5
"2011","E00001314","E00001314","Total",127,95,62,33,1,1,0,1,30,28,0,0,2,0
"2011","E00001315","E00001315","Total",112,26,14,12,0,58,35,23,28,28,0,0,0,0
"2011","E00001318","E00001318","Total",135,46,21,25,5,55,25,30,27,26,0,1,0,2
"2011","E00001373","E00001373","Total",157,80,42,38,0,7,3,4,64,59,2,3,0,6
"2011","E00001377","E00001377","Total",94,55,39,16,7,16,2,14,15,13,0,1,1,1
"2011","E00001378","E00001378","Total",79,20,9,11,2,10,4,6,46,9,24,0,13,1
"2011","E00001379","E00001379","Total",150,17,9,8,1,51,10,41,81,81,0,0,0,0
"2011","E00001353","E00001353","Total",145,108,52,56,0,8,0,8,29,27,0,2,0,0
"2011","E00001371","E00001371","Total",127,87,58,29,0,2,1,1,37,36,0,1,0,1
"2011","E00001376","E00001376","Total",134,99,52,47,0,5,5,0,28,27,0,1,0,2
"2011","E00001382","E00001382","Total",116,93,52,41,0,1,0,1,22,22,0,0,0,0
"2011","E00001385","E00001385","Total",117,99,46,53,0,1,0,1,16,16,0,0,0,1
"2011","E00000610","E00000610","Total",131,124,76,48,0,0,0,0,7,5,0,2,0,0
"2011","E00000611","E00000611","Total",112,103,55,48,0,0,0,0,9,7,0,2,0,0
"2011","E00000613","E00000613","Total",128,112,50,62,0,6,0,6,10,8,0,0,2,0
"2011","E00000614","E00000614","Total",114,107,56,51,0,0,0,0,7,7,0,0,0,0
"2011","E00000584","E00000584","Total",127,114,49,65,0,2,2,0,11,9,0,1,1,0
"2011","E00000587","E00000587","Total",127,117,55,62,1,1,1,0,8,8,0,0,0,0
"2011","E00000612","E00000612","Total",111,106,51,55,0,0,0,0,5,5,0,0,0,0
"2011","E00000616","E00000616","Total",129,87,32,55,0,2,2,0,39,39,0,0,0,1
"2011","E00000618","E00000618","Total",129,78,32,46,0,36,0,36,7,7,0,0,0,8
"2011","E00000576","E00000576","Total",118,98,42,56,0,7,5,2,12,10,0,2,0,1
"2011","E00000578","E00000578","Total",135,118,62,56,0,1,1,0,12,12,0,0,0,4
"2011","E00000582","E00000582","Total",234,191,100,91,1,15,0,15,25,22,0,3,0,2
"2011","E00000591","E00000591","Total",120,102,60,42,0,1,0,1,15,15,0,0,0,2
"2011","E00000580","E00000580","Total",131,120,64,56,0,0,0,0,11,11,0,0,0,0
"2011","E00000585","E00000585","Total",122,108,57,51,0,0,0,0,13,13,0,0,0,1
"2011","E00000588","E00000588","Total",128,106,50,56,0,2,2,0,19,18,1,0,0,1
"2011","E00000619","E00000619","Total",124,117,66,51,0,0,0,0,7,5,2,0,0,0
"2011","E00000593","E00000593","Total",125,111,49,62,0,0,0,0,13,13,0,0,0,1
"2011","E00000596","E00000596","Total",132,98,46,52,1,2,2,0,31,30,0,1,0,0
"2011","E00000598","E00000598","Total",134,120,46,74,1,4,2,2,8,8,0,0,0,1
"2011","E00000601","E00000601","Total",131,116,65,51,0,2,0,2,11,11,0,0,0,2
"2011","E00000581","E00000581","Total",240,166,97,69,15,1,1,0,56,51,0,5,0,2
"2011","E00000586","E00000586","Total",127,118,67,51,0,1,1,0,6,6,0,0,0,2
"2011","E00000589","E00000589","Total",139,113,65,48,0,1,1,0,23,22,0,1,0,2
"2011","E00000615","E00000615","Total",126,114,60,54,0,1,1,0,10,9,1,0,0,1
"2011","E00000617","E00000617","Total",130,100,42,58,3,3,1,2,23,23,0,0,0,1
"2011","E00000579","E00000579","Total",127,112,53,59,1,1,1,0,11,11,0,0,0,2
"2011","E00000583","E00000583","Total",190,129,54,75,13,4,0,4,43,42,0,1,0,1
"2011","E00000590","E00000590","Total",119,95,42,53,1,8,6,2,14,13,0,1,0,1
"2011","E00000594","E00000594","Total",136,116,67,49,2,6,5,1,10,8,0,2,0,2
"2011","E00000620","E00000620","Total",137,129,60,69,1,0,0,0,6,6,0,0,0,1
"2011","E00000592","E00000592","Total",123,72,30,42,0,39,19,20,11,9,0,1,1,1
"2011","E00000595","E00000595","Total",135,24,11,13,5,103,17,86,1,0,0,0,1,2
"2011","E00000597","E00000597","Total",117,88,41,47,11,5,4,1,13,11,0,2,0,0
"2011","E00000599","E00000599","Total",126,23,9,14,0,93,6,87,10,9,0,1,0,0
"2011","E00000600","E00000600","Total",137,116,55,61,1,10,8,2,10,10,0,0,0,0
"2011","E00000602","E00000602","Total",134,83,22,61,21,2,0,2,26,25,1,0,0,2
"2011","E00000603","E00000603","Total",137,91,35,56,0,10,3,7,34,32,0,2,0,2
"2011","E00000604","E00000604","Total",140,99,34,65,7,3,1,2,30,27,1,2,0,1
"2011","E00000605","E00000605","Total",137,109,51,58,1,2,1,1,22,22,0,0,0,3
"2011","E00000577","E00000577","Total",100,44,21,23,1,34,30,4,20,20,0,0,0,1
"2011","E00000606","E00000606","Total",134,74,33,41,1,28,6,22,31,29,0,0,2,0
"2011","E00000607","E00000607","Total",122,50,13,37,0,42,32,10,28,27,0,1,0,2
"2011","E00000608","E00000608","Total",122,97,45,52,1,3,2,1,21,20,0,1,0,0
"2011","E00000609","E00000609","Total",182,54,16,38,0,66,54,12,61,55,0,6,0,1
"2011","E00001324","E00001324","Total",133,94,38,56,0,3,2,1,33,30,0,3,0,3
"2011","E00001325","E00001325","Total",108,56,16,40,0,2,0,2,50,50,0,0,0,0
"2011","E00001327","E00001327","Total",123,80,36,44,0,3,0,3,38,37,0,0,1,2
"2011","E00001328","E00001328","Total",131,99,38,61,0,2,0,2,30,29,1,0,0,0
"2011","E00001329","E00001329","Total",162,75,27,48,0,13,7,6,68,64,0,4,0,6
"2011","E00001331","E00001331","Total",134,48,23,25,1,61,27,34,21,18,0,2,1,3
"2011","E00001320","E00001320","Total",122,108,59,49,1,1,0,1,11,9,1,1,0,1
"2011","E00001323","E00001323","Total",133,118,51,67,0,1,1,0,10,9,0,0,1,4
"2011","E00001326","E00001326","Total",122,110,55,55,0,1,1,0,9,8,0,1,0,2
"2011","E00001330","E00001330","Total",134,125,68,57,0,2,0,2,6,4,0,1,1,1
"2011","E00001316","E00001316","Total",121,59,25,34,0,42,40,2,14,13,0,1,0,6
"2011","E00001317","E00001317","Total",124,77,31,46,0,26,26,0,17,16,0,1,0,4
"2011","E00001319","E00001319","Total",136,85,34,51,0,25,20,5,26,24,1,1,0,0
"2011","E00001321","E00001321","Total",124,112,50,62,0,3,0,3,7,7,0,0,0,2
"2011","E00001322","E00001322","Total",194,97,34,63,0,46,24,22,47,46,1,0,0,4
"2011","E00001573","E00001573","Total",148,79,34,45,1,7,1,6,60,59,0,1,0,1
"2011","E00001574","E00001574","Total",125,93,52,41,0,11,1,10,21,20,0,0,1,0
"2011","E00001575","E00001575","Total",117,85,61,24,0,5,2,3,23,19,0,2,2,4
"2011","E00001576","E00001576","Total",121,94,46,48,1,3,0,3,22,22,0,0,0,1
"2011","E00001578","E00001578","Total",117,104,62,42,0,5,4,1,7,7,0,0,0,1
"2011","E00001543","E00001543","Total",139,88,44,44,0,12,2,10,35,35,0,0,0,4
"2011","E00001580","E00001580","Total",119,69,36,33,0,3,0,3,45,43,0,1,1,2
"2011","E00001582","E00001582","Total",136,32,13,19,0,18,5,13,86,85,0,1,0,0
"2011","E00001586","E00001586","Total",125,68,26,42,0,6,5,1,50,48,0,1,1,1
"2011","E00001587","E00001587","Total",128,55,26,29,0,27,24,3,46,46,0,0,0,0
"2011","E00001588","E00001588","Total",127,79,34,45,10,6,0,6,29,26,0,2,1,3
"2011","E00001352","E00001352","Total",134,52,28,24,7,7,1,6,67,67,0,0,0,1
"2011","E00001355","E00001355","Total",123,103,52,51,0,2,1,1,16,15,0,1,0,2
"2011","E00001356","E00001356","Total",134,65,35,30,0,18,11,7,49,46,0,2,1,2
"2011","E00001383","E00001383","Total",118,82,44,38,0,8,5,3,28,28,0,0,0,0
"2011","E00001393","E00001393","Total",135,96,44,52,0,14,11,3,24,21,0,3,0,1
"2011","E00001351","E00001351","Total",119,21,12,9,0,76,12,64,18,17,0,0,1,4
"2011","E00001354","E00001354","Total",132,54,35,19,1,32,0,32,42,39,0,0,3,3
"2011","E00001357","E00001357","Total",116,55,27,28,1,6,1,5,53,50,0,3,0,1
"2011","E00001358","E00001358","Total",145,71,34,37,1,2,0,2,69,69,0,0,0,2
"2011","E00001359","E00001359","Total",126,57,36,21,1,36,20,16,30,29,0,1,0,2
"2011","E00001361","E00001361","Total",139,43,23,20,1,55,4,51,40,36,0,1,3,0
"2011","E00001381","E00001381","Total",120,113,66,47,0,0,0,0,6,6,0,0,0,1
"2011","E00001386","E00001386","Total",123,109,58,51,0,3,1,2,9,9,0,0,0,2
"2011","E00001389","E00001389","Total",115,94,60,34,0,3,3,0,16,16,0,0,0,2
"2011","E00001391","E00001391","Total",122,102,55,47,0,1,0,1,19,18,0,1,0,0
"2011","E00001350","E00001350","Total",135,78,37,41,0,12,9,3,44,41,1,2,0,1
"2011","E00001384","E00001384","Total",120,60,30,30,1,26,14,12,32,30,0,1,1,1
"2011","E00001387","E00001387","Total",136,66,27,39,3,39,36,3,27,27,0,0,0,1
"2011","E00001388","E00001388","Total",129,57,24,33,1,32,30,2,35,32,1,2,0,4
"2011","E00001390","E00001390","Total",118,74,37,37,1,3,1,2,35,33,0,2,0,5
"2011","E00001392","E00001392","Total",142,74,44,30,6,13,11,2,47,43,3,0,1,2
"2011","E00001571","E00001571","Total",134,64,29,35,1,22,17,5,45,43,1,1,0,2
"2011","E00001572","E00001572","Total",149,81,30,51,0,1,0,1,66,65,0,0,1,1
"2011","E00001577","E00001577","Total",145,93,41,52,1,9,6,3,42,37,2,1,2,0
"2011","E00001579","E00001579","Total",148,76,23,53,2,2,0,2,67,64,3,0,0,1
"2011","E00001581","E00001581","Total",124,40,18,22,1,15,5,10,65,63,1,1,0,3
"2011","E00000924","E00000924","Total",117,70,27,43,1,32,24,8,13,13,0,0,0,1
"2011","E00000961","E00000961","Total",186,44,14,30,23,56,15,41,60,57,0,3,0,3
"2011","E00000962","E00000962","Total",111,51,17,34,4,41,33,8,12,11,0,1,0,3
"2011","E00000963","E00000963","Total",123,45,12,33,1,59,37,22,17,17,0,0,0,1
"2011","E00000964","E00000964","Total",160,57,11,46,7,8,5,3,87,84,0,1,2,1
"2011","E00001119","E00001119","Total",115,70,23,47,0,13,7,6,32,32,0,0,0,0
"2011","E00001121","E00001121","Total",122,69,27,42,0,31,10,21,20,20,0,0,0,2
"2011","E00001126","E00001126","Total",113,60,21,39,0,31,29,2,20,18,0,2,0,2
"2011","E00001129","E00001129","Total",125,75,29,46,3,29,19,10,17,15,1,1,0,1
"2011","E00001133","E00001133","Total",125,71,33,38,0,34,21,13,20,17,1,2,0,0
"2011","E00001120","E00001120","Total",130,103,53,50,0,3,3,0,23,23,0,0,0,1
"2011","E00001124","E00001124","Total",136,111,54,57,0,4,3,1,19,18,0,1,0,2
"2011","E00001125","E00001125","Total",121,104,48,56,0,1,1,0,13,13,0,0,0,3
"2011","E00001132","E00001132","Total",134,92,56,36,1,6,6,0,31,27,0,4,0,4
"2011","E00001134","E00001134","Total",129,117,75,42,0,2,2,0,9,9,0,0,0,1
"2011","E00001123","E00001123","Total",147,86,22,64,1,14,12,2,45,44,0,1,0,1
"2011","E00001127","E00001127","Total",124,84,32,52,0,7,5,2,33,33,0,0,0,0
"2011","E00001128","E00001128","Total",145,114,47,67,2,2,1,1,27,21,0,5,1,0
"2011","E00001130","E00001130","Total",126,104,46,58,1,3,3,0,16,15,0,1,0,2
"2011","E00001131","E00001131","Total",112,92,36,56,0,6,6,0,13,12,1,0,0,1
"2011","E00001136","E00001136","Total",186,145,59,86,0,11,1,10,29,24,0,5,0,1
"2011","E00001137","E00001137","Total",146,88,37,51,1,33,3,30,21,18,0,3,0,3
"2011","E00001138","E00001138","Total",122,91,44,47,1,4,0,4,26,25,0,1,0,0
"2011","E00001139","E00001139","Total",138,100,54,46,1,1,1,0,32,28,0,2,2,4
"2011","E00001140","E00001140","Total",114,63,30,33,0,39,1,38,12,9,0,3,0,0
"2011","E00001141","E00001141","Total",127,62,21,41,1,12,1,11,46,45,1,0,0,6
"2011","E00001142","E00001142","Total",132,95,37,58,1,4,0,4,30,28,0,2,0,2
"2011","E00001150","E00001150","Total",134,121,51,70,1,3,0,3,8,8,0,0,0,1
"2011","E00001151","E00001151","Total",114,88,38,50,2,4,1,3,15,15,0,0,0,5
"2011","E00001153","E00001153","Total",128,99,43,56,0,5,1,4,24,23,0,1,0,0
"2011","E00000929","E00000929","Total",128,111,49,62,0,4,3,1,12,12,0,0,0,1
"2011","E00000930","E00000930","Total",125,115,51,64,0,3,2,1,7,7,0,0,0,0
"2011","E00000934","E00000934","Total",122,97,41,56,0,4,3,1,19,19,0,0,0,2
"2011","E00000936","E00000936","Total",126,116,57,59,0,5,4,1,5,5,0,0,0,0
"2011","E00000923","E00000923","Total",114,28,15,13,0,68,6,62,14,14,0,0,0,4
"2011","E00000927","E00000927","Total",110,88,30,58,0,2,2,0,19,18,0,1,0,1
"2011","E00000928","E00000928","Total",126,110,55,55,0,3,2,1,11,11,0,0,0,2
"2011","E00000931","E00000931","Total",132,115,57,58,0,2,2,0,15,15,0,0,0,0
"2011","E00000965","E00000965","Total",111,23,11,12,1,56,5,51,30,30,0,0,0,1
"2011","E00000922","E00000922","Total",123,112,50,62,1,2,1,1,6,6,0,0,0,2
"2011","E00000925","E00000925","Total",119,105,44,61,0,1,1,0,13,13,0,0,0,0
"2011","E00000926","E00000926","Total",117,103,50,53,0,2,2,0,11,10,0,0,1,1
"2011","E00000932","E00000932","Total",157,130,73,57,0,2,1,1,15,15,0,0,0,10
"2011","E00000933","E00000933","Total",146,25,8,17,12,71,23,48,37,36,0,1,0,1
"2011","E00000937","E00000937","Total",162,17,5,12,12,121,79,42,11,10,0,1,0,1
"2011","E00000942","E00000942","Total",122,10,1,9,1,96,91,5,11,11,0,0,0,4
"2011","E00000943","E00000943","Total",130,21,12,9,0,73,71,2,33,31,0,1,1,3
"2011","E00000946","E00000946","Total",151,14,7,7,0,121,117,4,14,12,0,1,1,2
"2011","E00000938","E00000938","Total",132,100,54,46,1,6,6,0,24,24,0,0,0,1
"2011","E00000944","E00000944","Total",137,105,44,61,2,15,13,2,14,13,0,1,0,1
"2011","E00000947","E00000947","Total",150,105,61,44,0,22,3,19,20,19,0,1,0,3
"2011","E00000948","E00000948","Total",127,124,66,58,0,1,0,1,2,2,0,0,0,0
"2011","E00000935","E00000935","Total",156,127,67,60,2,1,1,0,26,26,0,0,0,0
"2011","E00000939","E00000939","Total",124,108,56,52,0,0,0,0,13,13,0,0,0,3
"2011","E00000940","E00000940","Total",123,106,65,41,0,3,3,0,11,9,0,2,0,3
"2011","E00000945","E00000945","Total",127,105,59,46,0,2,1,1,18,15,0,3,0,2
"2011","E00000777","E00000777","Total",136,87,37,50,2,15,11,4,30,25,0,5,0,2
"2011","E00000806","E00000806","Total",112,88,42,46,0,3,1,2,21,21,0,0,0,0
"2011","E00000809","E00000809","Total",93,21,7,14,1,53,51,2,16,15,0,1,0,2
"2011","E00000810","E00000810","Total",103,66,21,45,1,8,1,7,27,27,0,0,0,1
"2011","E00000815","E00000815","Total",120,82,33,49,1,12,1,11,24,21,0,3,0,1
"2011","E00000807","E00000807","Total",107,34,9,25,1,61,48,13,9,9,0,0,0,2
"2011","E00000808","E00000808","Total",128,55,14,41,1,18,15,3,52,49,0,3,0,2
"2011","E00000811","E00000811","Total",134,126,68,58,0,1,1,0,7,7,0,0,0,0
"2011","E00000812","E00000812","Total",147,131,72,59,0,0,0,0,14,14,0,0,0,2
"2011","E00000817","E00000817","Total",129,109,48,61,0,4,4,0,15,14,0,1,0,1
"2011","E00000769","E00000769","Total",166,117,52,65,0,1,1,0,48,45,1,2,0,0
"2011","E00000813","E00000813","Total",166,68,15,53,1,25,14,11,69,67,1,1,0,3
"2011","E00000814","E00000814","Total",104,70,29,41,0,1,1,0,32,31,1,0,0,1
"2011","E00000816","E00000816","Total",121,90,30,60,1,3,1,2,25,23,0,2,0,2
"2011","E00174889","E00174889","Total",293,147,38,109,2,2,1,1,140,135,0,4,1,2
"2011","E00174897","E00174897","Total",73,59,18,41,0,0,0,0,13,12,0,1,0,1
"2011","E00000771","E00000771","Total",96,31,8,23,0,1,1,0,21,18,0,3,0,43
"2011","E00000776","E00000776","Total",187,82,30,52,0,43,25,18,59,59,0,0,0,3
"2011","E00000778","E00000778","Total",154,80,23,57,0,16,4,12,50,49,0,1,0,8
"2011","E00000779","E00000779","Total",136,110,50,60,0,7,1,6,18,14,0,4,0,1
"2011","E00000818","E00000818","Total",137,69,34,35,0,7,1,6,61,53,1,6,1,0
"2011","E00000780","E00000780","Total",112,96,40,56,0,6,0,6,10,10,0,0,0,0
"2011","E00000781","E00000781","Total",147,73,32,41,0,41,7,34,32,28,0,4,0,1
"2011","E00000782","E00000782","Total",145,81,39,42,2,4,1,3,56,56,0,0,0,2
"2011","E00000785","E00000785","Total",148,133,66,67,0,0,0,0,15,13,0,2,0,0
"2011","E00001545","E00001545","Total",138,90,36,54,0,28,23,5,19,19,0,0,0,1
"2011","E00001546","E00001546","Total",151,109,52,57,0,5,2,3,36,35,0,1,0,1
"2011","E00001583","E00001583","Total",122,62,25,37,1,20,3,17,38,36,0,2,0,1
"2011","E00001585","E00001585","Total",125,107,53,54,0,3,1,2,15,15,0,0,0,0
"2011","E00001589","E00001589","Total",119,97,45,52,0,3,1,2,17,17,0,0,0,2
"2011","E00001257","E00001257","Total",127,119,61,58,0,1,0,1,6,6,0,0,0,1
"2011","E00001277","E00001277","Total",119,95,45,50,0,4,4,0,19,19,0,0,0,1
"2011","E00001282","E00001282","Total",121,82,28,54,2,23,22,1,13,12,0,1,0,1
"2011","E00001283","E00001283","Total",167,113,40,73,0,1,0,1,53,48,0,4,1,0
"2011","E00001284","E00001284","Total",122,87,33,54,1,2,2,0,30,29,1,0,0,2
"2011","E00001261","E00001261","Total",135,97,49,48,0,6,4,2,32,32,0,0,0,0
"2011","E00001265","E00001265","Total",138,90,45,45,0,7,2,5,40,36,0,3,1,1
"2011","E00001268","E00001268","Total",134,105,51,54,0,2,2,0,23,21,0,2,0,4
"2011","E00001274","E00001274","Total",141,114,64,50,0,4,0,4,23,23,0,0,0,0
"2011","E00001275","E00001275","Total",148,102,54,48,1,2,2,0,41,38,0,3,0,2
"2011","E00001262","E00001262","Total",131,118,63,55,0,1,0,1,11,11,0,0,0,1
"2011","E00001298","E00001298","Total",127,120,64,56,0,0,0,0,7,6,0,1,0,0
"2011","E00001300","E00001300","Total",119,111,39,72,0,1,0,1,5,4,1,0,0,2
"2011","E00001301","E00001301","Total",122,115,53,62,0,3,2,1,4,4,0,0,0,0
"2011","E00001255","E00001255","Total",133,106,54,52,0,2,1,1,24,24,0,0,0,1
"2011","E00001259","E00001259","Total",114,60,27,33,0,2,1,1,48,48,0,0,0,4
"2011","E00001269","E00001269","Total",125,79,33,46,0,17,16,1,29,29,0,0,0,0
"2011","E00001270","E00001270","Total",138,25,14,11,0,7,3,4,99,93,2,1,3,7
"2011","E00001299","E00001299","Total",124,73,32,41,0,16,16,0,35,32,0,2,1,0
"2011","E00001256","E00001256","Total",123,86,38,48,1,21,18,3,13,12,0,0,1,2
"2011","E00001263","E00001263","Total",158,112,68,44,0,9,2,7,31,18,11,1,1,6
"2011","E00001278","E00001278","Total",117,66,23,43,1,33,29,4,17,16,0,0,1,0
"2011","E00001280","E00001280","Total",129,53,19,34,1,63,53,10,10,10,0,0,0,2
"2011","E00001260","E00001260","Total",146,43,21,22,1,67,25,42,34,30,0,3,1,1
"2011","E00001272","E00001272","Total",114,30,11,19,0,67,30,37,15,12,1,1,1,2
"2011","E00001279","E00001279","Total",108,6,4,2,6,84,8,76,12,9,0,1,2,0
"2011","E00001281","E00001281","Total",219,95,69,26,0,51,33,18,45,41,0,4,0,28
"2011","E00001286","E00001286","Total",137,68,32,36,1,31,29,2,34,31,0,3,0,3
"2011","E00001266","E00001266","Total",136,58,28,30,0,64,1,63,13,11,1,0,1,1
"2011","E00001267","E00001267","Total",125,90,44,46,1,8,0,8,21,21,0,0,0,5
"2011","E00001295","E00001295","Total",143,104,76,28,0,3,1,2,19,7,9,2,1,17
"2011","E00001296","E00001296","Total",129,116,66,50,0,2,2,0,11,11,0,0,0,0
"2011","E00001297","E00001297","Total",113,103,51,52,0,2,1,1,6,5,0,1,0,2
"2011","E00001271","E00001271","Total",166,122,71,51,0,11,6,5,22,21,1,0,0,11
"2011","E00001273","E00001273","Total",139,100,42,58,0,18,14,4,18,17,0,1,0,3
"2011","E00001276","E00001276","Total",130,110,65,45,0,2,1,1,15,15,0,0,0,3
"2011","E00174896","E00174896","Total",105,50,20,30,3,41,8,33,6,6,0,0,0,5
"2011","E00174900","E00174900","Total",106,14,6,8,0,78,9,69,13,12,0,0,1,1
"2011","E00174915","E00174915","Total",106,68,12,56,0,5,2,3,33,31,0,2,0,0
"2011","E00000941","E00000941","Total",135,87,42,45,0,12,6,6,35,35,0,0,0,1
"2011","E00000949","E00000949","Total",142,103,75,28,1,3,2,1,30,25,0,5,0,5
"2011","E00000950","E00000950","Total",125,96,50,46,1,1,0,1,26,26,0,0,0,1
"2011","E00000952","E00000952","Total",111,92,49,43,0,1,0,1,15,14,0,1,0,3
"2011","E00000953","E00000953","Total",170,21,6,15,2,3,0,3,140,137,1,1,1,4
"2011","E00000951","E00000951","Total",130,99,43,56,0,0,0,0,31,29,2,0,0,0
"2011","E00000954","E00000954","Total",128,112,53,59,0,2,0,2,12,12,0,0,0,2
"2011","E00000956","E00000956","Total",144,100,62,38,0,2,1,1,41,41,0,0,0,1
"2011","E00000957","E00000957","Total",192,86,43,43,0,21,4,17,79,73,1,4,1,6
"2011","E00000955","E00000955","Total",147,82,44,38,0,3,1,2,58,57,0,0,1,4
"2011","E00000958","E00000958","Total",170,37,24,13,0,8,5,3,115,112,1,2,0,10
"2011","E00000959","E00000959","Total",156,112,49,63,0,6,2,4,38,38,0,0,0,0
"2011","E00000960","E00000960","Total",137,99,49,50,0,3,1,2,33,31,0,1,1,2
"2011","E00001110","E00001110","Total",131,70,22,48,1,37,29,8,22,20,0,1,1,1
"2011","E00001112","E00001112","Total",124,63,25,38,2,46,37,9,11,10,0,1,0,2
"2011","E00001113","E00001113","Total",127,54,19,35,0,58,48,10,13,11,0,1,1,2
"2011","E00001115","E00001115","Total",127,62,19,43,1,47,39,8,17,17,0,0,0,0
"2011","E00001116","E00001116","Total",121,27,8,19,0,75,57,18,15,14,0,1,0,4
"2011","E00001145","E00001145","Total",120,94,47,47,0,4,0,4,21,19,1,1,0,1
"2011","E00001146","E00001146","Total",124,103,46,57,0,4,1,3,16,16,0,0,0,1
"2011","E00001147","E00001147","Total",118,90,41,49,0,4,2,2,23,23,0,0,0,1
"2011","E00001148","E00001148","Total",121,99,51,48,0,0,0,0,22,21,0,1,0,0
"2011","E00001154","E00001154","Total",120,98,42,56,0,3,3,0,18,17,0,1,0,1
"2011","E00001447","E00001447","Total",154,93,29,64,0,8,5,3,53,52,0,1,0,0
"2011","E00001468","E00001468","Total",124,68,26,42,0,1,0,1,55,55,0,0,0,0
"2011","E00001469","E00001469","Total",94,37,15,22,1,27,1,26,25,23,0,2,0,4
"2011","E00001479","E00001479","Total",124,80,58,22,1,3,1,2,35,29,0,5,1,5
"2011","E00174905","E00174905","Total",133,38,15,23,1,0,0,0,92,87,5,0,0,2
"2011","E00174906","E00174906","Total",153,30,8,22,0,5,4,1,118,117,0,1,0,0
"2011","E00001467","E00001467","Total",136,75,37,38,2,12,0,12,44,44,0,0,0,3
"2011","E00001470","E00001470","Total",125,44,14,30,0,56,51,5,23,22,0,0,1,2
"2011","E00001471","E00001471","Total",147,113,51,62,0,1,1,0,31,28,0,3,0,2
"2011","E00001474","E00001474","Total",129,96,42,54,0,2,1,1,29,28,0,1,0,2
"2011","E00001475","E00001475","Total",130,91,30,61,3,2,1,1,31,26,0,5,0,3
"2011","E00001477","E00001477","Total",108,45,25,20,0,6,6,0,52,51,0,1,0,5
"2011","E00001478","E00001478","Total",224,63,24,39,0,72,63,9,78,75,0,2,1,11
"2011","E00001480","E00001480","Total",143,74,38,36,1,6,5,1,59,59,0,0,0,3
"2011","E00001482","E00001482","Total",125,43,20,23,1,54,38,16,21,17,0,1,3,6
"2011","E00001484","E00001484","Total",125,48,30,18,0,0,0,0,75,74,0,0,1,2
"2011","E00001485","E00001485","Total",115,49,29,20,0,4,4,0,60,55,0,4,1,2
"2011","E00001554","E00001554","Total",115,76,39,37,0,15,15,0,22,21,0,0,1,2
"2011","E00001558","E00001558","Total",128,79,38,41,0,12,1,11,35,32,1,2,0,2
"2011","E00001561","E00001561","Total",136,68,18,50,0,13,10,3,54,54,0,0,0,1
"2011","E00001563","E00001563","Total",128,84,38,46,2,5,5,0,33,33,0,0,0,4
"2011","E00001565","E00001565","Total",150,86,45,41,0,5,3,2,50,50,0,0,0,9
"2011","E00001550","E00001550","Total",133,104,45,59,0,5,1,4,24,24,0,0,0,0
"2011","E00001551","E00001551","Total",149,103,49,54,0,22,19,3,21,20,0,0,1,3
"2011","E00001556","E00001556","Total",99,86,45,41,0,0,0,0,11,11,0,0,0,2
"2011","E00001557","E00001557","Total",118,101,65,36,0,5,3,2,11,11,0,0,0,1
"2011","E00001560","E00001560","Total",111,71,30,41,1,5,3,2,31,31,0,0,0,3
"2011","E00001540","E00001540","Total",143,76,38,38,1,14,8,6,51,51,0,0,0,1
"2011","E00001544","E00001544","Total",139,48,13,35,1,8,2,6,81,79,1,1,0,1
"2011","E00001547","E00001547","Total",164,87,36,51,1,5,2,3,67,62,0,5,0,4
"2011","E00001549","E00001549","Total",148,69,39,30,1,4,3,1,68,65,2,1,0,6
"2011","E00001584","E00001584","Total",119,68,49,19,0,4,1,3,44,44,0,0,0,3
"2011","E00001590","E00001590","Total",152,53,25,28,0,3,2,1,91,86,2,2,1,5
"2011","E00001360","E00001360","Total",134,104,48,56,0,0,0,0,30,30,0,0,0,0
"2011","E00001362","E00001362","Total",135,102,55,47,0,0,0,0,32,32,0,0,0,1
"2011","E00001394","E00001394","Total",127,112,63,49,0,0,0,0,15,14,0,0,1,0
"2011","E00001395","E00001395","Total",110,102,56,46,0,0,0,0,8,8,0,0,0,0
"2011","E00001363","E00001363","Total",116,93,52,41,0,2,2,0,21,21,0,0,0,0
"2011","E00001364","E00001364","Total",124,99,53,46,1,2,0,2,21,21,0,0,0,1
"2011","E00001365","E00001365","Total",129,103,68,35,0,0,0,0,23,23,0,0,0,3
"2011","E00001366","E00001366","Total",129,102,54,48,0,2,2,0,25,24,0,0,1,0
"2011","E00001446","E00001446","Total",125,92,50,42,1,1,1,0,31,31,0,0,0,0
"2011","E00001472","E00001472","Total",124,99,45,54,0,0,0,0,22,21,0,1,0,3
"2011","E00001476","E00001476","Total",140,93,52,41,0,2,2,0,39,39,0,0,0,6
"2011","E00001488","E00001488","Total",139,90,51,39,0,1,0,1,47,46,0,1,0,1
"2011","E00001481","E00001481","Total",139,104,55,49,0,15,4,11,19,18,0,1,0,1
"2011","E00001483","E00001483","Total",119,92,50,42,1,0,0,0,25,25,0,0,0,1
"2011","E00001489","E00001489","Total",138,91,47,44,1,1,1,0,44,44,0,0,0,1
"2011","E00001490","E00001490","Total",144,96,50,46,1,2,0,2,43,42,1,0,0,2
"2011","E00001448","E00001448","Total",132,55,20,35,1,14,13,1,60,60,0,0,0,2
"2011","E00001450","E00001450","Total",111,60,24,36,5,17,14,3,29,29,0,0,0,0
"2011","E00001452","E00001452","Total",112,69,23,46,0,0,0,0,42,42,0,0,0,1
"2011","E00001487","E00001487","Total",130,86,43,43,0,1,1,0,42,39,0,3,0,1
"2011","E00001493","E00001493","Total",136,68,25,43,0,5,3,2,61,59,0,1,1,2
"2011","E00000648","E00000648","Total",116,51,17,34,0,50,44,6,12,12,0,0,0,3
"2011","E00000651","E00000651","Total",95,33,4,29,1,48,4,44,12,12,0,0,0,1
"2011","E00000654","E00000654","Total",117,51,21,30,1,54,51,3,9,7,0,1,1,2
"2011","E00000655","E00000655","Total",121,51,9,42,24,18,15,3,26,23,0,3,0,2
"2011","E00000656","E00000656","Total",121,33,8,25,23,32,4,28,32,29,0,2,1,1
"2011","E00000631","E00000631","Total",117,53,16,37,1,43,34,9,19,19,0,0,0,1
"2011","E00000633","E00000633","Total",126,40,13,27,0,63,44,19,21,19,0,2,0,2
"2011","E00000634","E00000634","Total",133,61,21,40,1,52,41,11,17,16,0,1,0,2
"2011","E00000637","E00000637","Total",119,41,14,27,0,50,48,2,26,25,0,0,1,2
"2011","E00000632","E00000632","Total",116,49,26,23,0,52,39,13,15,15,0,0,0,0
"2011","E00000635","E00000635","Total",101,45,13,32,1,35,29,6,19,18,1,0,0,1
"2011","E00000640","E00000640","Total",121,44,15,29,1,59,48,11,16,15,0,1,0,1
"2011","E00000641","E00000641","Total",118,42,13,29,1,64,54,10,10,10,0,0,0,1
"2011","E00000645","E00000645","Total",109,39,12,27,1,60,60,0,9,8,0,1,0,0
"2011","E00001135","E00001135","Total",135,110,57,53,0,2,2,0,22,20,0,2,0,1
"2011","E00001143","E00001143","Total",132,76,36,40,0,5,1,4,50,47,0,3,0,1
"2011","E00001144","E00001144","Total",126,76,34,42,0,6,2,4,42,42,0,0,0,2
"2011","E00001149","E00001149","Total",126,84,32,52,2,2,0,2,38,38,0,0,0,0
"2011","E00001152","E00001152","Total",131,94,42,52,0,5,2,3,30,30,0,0,0,2
"2011","E00001107","E00001107","Total",144,49,15,34,1,53,37,16,40,39,0,0,1,1
"2011","E00001109","E00001109","Total",135,54,18,36,0,57,44,13,21,20,0,1,0,3
"2011","E00001111","E00001111","Total",132,65,22,43,1,53,40,13,13,13,0,0,0,0
"2011","E00001114","E00001114","Total",171,106,54,52,1,19,4,15,43,40,1,1,1,2
"2011","E00000775","E00000775","Total",155,83,40,43,0,10,10,0,56,56,0,0,0,6
"2011","E00000799","E00000799","Total",136,83,36,47,0,11,5,6,41,34,0,6,1,1
"2011","E00000800","E00000800","Total",151,79,36,43,1,11,8,3,56,51,0,4,1,4
"2011","E00000804","E00000804","Total",165,104,42,62,1,12,9,3,44,44,0,0,0,4
"2011","E00000805","E00000805","Total",144,78,20,58,1,3,2,1,59,54,1,3,1,3
"2011","E00000793","E00000793","Total",155,92,35,57,0,19,9,10,42,36,1,5,0,2
"2011","E00000797","E00000797","Total",137,74,33,41,0,32,19,13,28,27,0,1,0,3
"2011","E00000798","E00000798","Total",127,71,27,44,0,16,13,3,40,39,0,1,0,0
"2011","E00000801","E00000801","Total",150,84,32,52,1,18,14,4,46,44,0,2,0,1
"2011","E00000803","E00000803","Total",120,78,29,49,0,3,3,0,38,38,0,0,0,1
"2011","E00000773","E00000773","Total",141,21,8,13,5,86,42,44,26,22,0,4,0,3
"2011","E00000774","E00000774","Total",139,57,22,35,0,57,56,1,24,24,0,0,0,1
"2011","E00000783","E00000783","Total",117,52,14,38,12,4,0,4,48,43,0,5,0,1
"2011","E00000789","E00000789","Total",126,34,6,28,0,74,69,5,17,17,0,0,0,1
"2011","E00000790","E00000790","Total",117,60,14,46,0,2,2,0,51,51,0,0,0,4
"2011","E00000792","E00000792","Total",119,56,11,45,0,22,14,8,39,36,0,3,0,2
"2011","E00000791","E00000791","Total",121,44,13,31,0,6,3,3,70,63,0,3,4,1
"2011","E00000794","E00000794","Total",131,61,27,34,0,48,37,11,19,18,0,1,0,3
"2011","E00000795","E00000795","Total",145,73,23,50,0,22,7,15,46,46,0,0,0,4
"2011","E00000796","E00000796","Total",123,38,8,30,0,68,60,8,14,14,0,0,0,3
"2011","E00000802","E00000802","Total",128,58,25,33,2,46,46,0,21,20,1,0,0,1
"2011","E00000770","E00000770","Total",138,104,42,62,0,6,5,1,16,16,0,0,0,12
"2011","E00000772","E00000772","Total",126,59,21,38,1,6,4,2,56,54,0,1,1,4
"2011","E00000786","E00000786","Total",180,121,50,71,1,8,4,4,24,22,0,2,0,26
"2011","E00000787","E00000787","Total",140,95,33,62,1,4,3,1,40,38,0,2,0,0
"2011","E00000788","E00000788","Total",123,87,50,37,2,4,3,1,27,25,0,2,0,3
"2011","E00001548","E00001548","Total",125,27,12,15,2,84,39,45,11,11,0,0,0,1
"2011","E00001552","E00001552","Total",103,27,10,17,0,66,64,2,10,10,0,0,0,0
"2011","E00001553","E00001553","Total",122,78,33,45,1,31,28,3,9,9,0,0,0,3
"2011","E00001555","E00001555","Total",143,38,8,30,14,77,18,59,12,11,1,0,0,2
"2011","E00001559","E00001559","Total",121,77,33,44,0,37,31,6,7,7,0,0,0,0
"2011","E00000968","E00000968","Total",156,109,52,57,0,4,4,0,42,40,0,0,2,1
"2011","E00000973","E00000973","Total",140,60,35,25,0,0,0,0,78,78,0,0,0,2
"2011","E00000992","E00000992","Total",147,50,20,30,0,3,0,3,93,90,0,3,0,1
"2011","E00000995","E00000995","Total",128,50,27,23,0,4,0,4,74,72,0,2,0,0
"2011","E00001004","E00001004","Total",136,97,38,59,0,1,0,1,35,31,1,1,2,3
"2011","E00001456","E00001456","Total",133,81,51,30,0,6,6,0,44,41,0,2,1,2
"2011","E00001457","E00001457","Total",156,88,32,56,1,1,0,1,63,62,0,0,1,3
"2011","E00001459","E00001459","Total",135,70,34,36,0,10,2,8,53,53,0,0,0,2
"2011","E00001461","E00001461","Total",121,88,58,30,0,1,0,1,30,30,0,0,0,2
"2011","E00001465","E00001465","Total",141,72,38,34,0,4,0,4,63,61,1,1,0,2
"2011","E00001449","E00001449","Total",145,69,39,30,0,6,0,6,69,64,0,3,2,1
"2011","E00001453","E00001453","Total",156,94,46,48,1,4,1,3,57,54,1,2,0,0
"2011","E00001455","E00001455","Total",135,51,22,29,1,8,0,8,71,67,1,0,3,4
"2011","E00001458","E00001458","Total",148,43,18,25,1,22,1,21,80,77,0,2,1,2
"2011","E00001486","E00001486","Total",150,67,37,30,1,1,0,1,80,78,0,1,1,1
"2011","E00001451","E00001451","Total",133,98,64,34,0,2,1,1,29,28,0,1,0,4
"2011","E00001454","E00001454","Total",119,45,24,21,2,26,5,21,44,40,0,3,1,2
"2011","E00001460","E00001460","Total",154,98,46,52,0,11,4,7,45,43,0,2,0,0
"2011","E00001491","E00001491","Total",164,75,24,51,0,11,0,11,77,71,0,1,5,1
"2011","E00001492","E00001492","Total",163,33,16,17,0,6,1,5,122,120,1,1,0,2
"2011","E00000646","E00000646","Total",117,54,21,33,1,46,41,5,14,13,0,1,0,2
"2011","E00000652","E00000652","Total",119,31,8,23,2,3,2,1,83,83,0,0,0,0
"2011","E00000658","E00000658","Total",144,60,16,44,1,55,44,11,28,26,0,2,0,0
"2011","E00000664","E00000664","Total",132,19,2,17,0,97,34,63,11,11,0,0,0,5
"2011","E00174904","E00174904","Total",117,34,10,24,2,22,14,8,57,50,6,0,1,2
"2011","E00174914","E00174914","Total",161,79,7,72,33,10,5,5,39,39,0,0,0,0
"2011","E00174917","E00174917","Total",99,42,19,23,1,40,36,4,13,10,1,2,0,3
"2011","E00174920","E00174920","Total",126,24,5,19,0,43,6,37,56,55,0,0,1,3
"2011","E00000638","E00000638","Total",139,51,13,38,1,68,60,8,16,15,0,0,1,3
"2011","E00000642","E00000642","Total",115,48,15,33,0,48,44,4,18,17,0,1,0,1
"2011","E00000650","E00000650","Total",131,49,10,39,2,59,55,4,20,19,0,0,1,1
"2011","E00000653","E00000653","Total",129,58,23,35,0,47,44,3,22,22,0,0,0,2
"2011","E00000628","E00000628","Total",129,68,32,36,2,32,31,1,23,22,1,0,0,4
"2011","E00000660","E00000660","Total",114,55,17,38,2,40,37,3,14,14,0,0,0,3
"2011","E00000661","E00000661","Total",127,89,41,48,2,8,6,2,28,26,0,2,0,0
"2011","E00000662","E00000662","Total",117,56,21,35,1,48,44,4,12,11,1,0,0,0
"2011","E00000667","E00000667","Total",137,51,22,29,1,59,55,4,24,22,0,2,0,2
"2011","E00000625","E00000625","Total",126,59,18,41,0,50,43,7,16,15,0,0,1,1
"2011","E00000627","E00000627","Total",128,30,10,20,0,51,48,3,45,45,0,0,0,2
"2011","E00000659","E00000659","Total",126,41,15,26,0,64,55,9,17,17,0,0,0,4
"2011","E00000663","E00000663","Total",119,22,10,12,0,80,69,11,17,17,0,0,0,0
"2011","E00000666","E00000666","Total",125,17,3,14,3,18,1,17,81,75,3,2,1,6
"2011","E00000623","E00000623","Total",140,108,58,50,0,3,2,1,28,26,0,1,1,1
"2011","E00000624","E00000624","Total",119,45,9,36,0,4,4,0,69,65,0,3,1,1
"2011","E00000626","E00000626","Total",131,47,20,27,0,42,38,4,40,38,0,2,0,2
"2011","E00000629","E00000629","Total",131,98,56,42,0,4,2,2,28,27,0,0,1,1
"2011","E00000630","E00000630","Total",113,50,24,26,1,25,21,4,34,33,0,1,0,3
"2011","E00000636","E00000636","Total",121,55,13,42,0,37,32,5,28,26,0,2,0,1
"2011","E00000643","E00000643","Total",120,64,20,44,0,26,24,2,28,21,2,2,3,2
"2011","E00000644","E00000644","Total",125,48,22,26,1,60,52,8,15,14,1,0,0,1
"2011","E00000647","E00000647","Total",132,59,21,38,1,54,51,3,18,18,0,0,0,0
"2011","E00000649","E00000649","Total",127,34,15,19,1,14,7,7,76,75,0,1,0,2
"2011","E00000970","E00000970","Total",124,98,40,58,0,0,0,0,24,23,0,1,0,2
"2011","E00000997","E00000997","Total",151,98,36,62,1,1,1,0,51,48,0,3,0,0
"2011","E00001002","E00001002","Total",143,119,48,71,0,0,0,0,22,20,0,2,0,2
"2011","E00001003","E00001003","Total",141,107,46,61,1,1,1,0,30,30,0,0,0,2
"2011","E00001006","E00001006","Total",126,103,37,66,0,1,0,1,20,19,0,1,0,2
"2011","E00000972","E00000972","Total",130,111,63,48,1,0,0,0,18,16,0,2,0,0
"2011","E00000985","E00000985","Total",130,98,59,39,0,3,3,0,27,23,3,1,0,2
"2011","E00000993","E00000993","Total",129,110,66,44,0,2,1,1,15,14,0,1,0,2
"2011","E00000998","E00000998","Total",143,102,67,35,0,0,0,0,39,36,0,2,1,2
"2011","E00001001","E00001001","Total",139,102,66,36,0,1,1,0,34,33,0,1,0,2
"2011","E00000984","E00000984","Total",168,120,51,69,1,3,0,3,42,42,0,0,0,2
"2011","E00000986","E00000986","Total",126,62,25,37,0,4,0,4,59,56,1,2,0,1
"2011","E00000987","E00000987","Total",140,96,59,37,0,3,1,2,39,35,0,4,0,2
"2011","E00000988","E00000988","Total",131,89,42,47,0,22,17,5,18,17,0,1,0,2
"2011","E00000990","E00000990","Total",122,59,39,20,0,38,21,17,21,21,0,0,0,4
"2011","E00001285","E00001285","Total",122,96,57,39,1,1,1,0,23,19,1,3,0,1
"2011","E00001289","E00001289","Total",125,107,58,49,0,2,0,2,16,16,0,0,0,0
"2011","E00001291","E00001291","Total",229,113,43,70,1,36,2,34,76,73,0,3,0,3
"2011","E00001292","E00001292","Total",110,85,41,44,1,3,0,3,17,16,0,1,0,4
"2011","E00174898","E00174898","Total",133,55,15,40,0,27,3,24,49,44,0,5,0,2
"2011","E00174899","E00174899","Total",130,94,30,64,0,0,0,0,34,33,0,1,0,2
"2011","E00174903","E00174903","Total",131,94,33,61,0,2,1,1,34,33,0,1,0,1
"2011","E00001258","E00001258","Total",130,94,24,70,0,3,1,2,31,29,0,2,0,2
"2011","E00001288","E00001288","Total",222,134,48,86,2,6,2,4,78,77,0,1,0,2
"2011","E00001290","E00001290","Total",127,82,42,40,1,18,1,17,25,24,0,1,0,1
"2011","E00001293","E00001293","Total",139,110,51,59,0,4,2,2,25,24,0,1,0,0
"2011","E00001294","E00001294","Total",143,57,23,34,1,19,8,11,66,60,0,6,0,0
"2011","E00000622","E00000622","Total",125,25,9,16,3,77,4,73,16,14,0,2,0,4
"2011","E00000657","E00000657","Total",139,21,6,15,0,91,9,82,22,22,0,0,0,5
"2011","E00000665","E00000665","Total",181,45,15,30,18,66,7,59,48,47,0,1,0,4
"2011","E00174908","E00174908","Total",96,23,8,15,9,46,7,39,17,17,0,0,0,1
"2011","E00174916","E00174916","Total",105,17,6,11,41,16,4,12,30,30,0,0,0,1
"2011","E00174919","E00174919","Total",80,22,8,14,3,38,6,32,17,17,0,0,0,0
"2011","E00000745","E00000745","Total",112,4,2,2,1,99,84,15,6,6,0,0,0,2
"2011","E00000747","E00000747","Total",113,7,1,6,1,101,93,8,4,4,0,0,0,0
"2011","E00000748","E00000748","Total",141,58,14,44,6,57,36,21,20,18,1,0,1,0
"2011","E00000749","E00000749","Total",130,10,4,6,0,111,98,13,7,5,0,0,2,2
"2011","E00000750","E00000750","Total",121,14,6,8,1,95,94,1,9,7,0,1,1,2
"2011","E00000736","E00000736","Total",100,29,10,19,8,42,9,33,21,21,0,0,0,0
"2011","E00000737","E00000737","Total",102,5,2,3,1,88,82,6,7,6,0,1,0,1
"2011","E00000739","E00000739","Total",111,37,12,25,4,51,40,11,17,16,0,1,0,2
"2011","E00000742","E00000742","Total",116,12,4,8,0,92,90,2,11,10,0,1,0,1
"2011","E00000746","E00000746","Total",135,8,2,6,0,119,110,9,5,5,0,0,0,3
"2011","E00000723","E00000723","Total",141,88,39,49,3,16,4,12,33,31,0,2,0,1
"2011","E00000738","E00000738","Total",129,4,2,2,1,114,11,103,8,6,0,0,2,2
"2011","E00000740","E00000740","Total",107,15,5,10,0,88,39,49,4,3,0,1,0,0
"2011","E00000743","E00000743","Total",117,11,3,8,1,94,79,15,9,9,0,0,0,2
"2011","E00000744","E00000744","Total",126,7,1,6,1,114,32,82,3,2,0,1,0,1
"2011","E00000751","E00000751","Total",123,30,9,21,0,74,68,6,15,15,0,0,0,4
"2011","E00000752","E00000752","Total",117,40,14,26,0,46,44,2,30,28,0,2,0,1
"2011","E00000754","E00000754","Total",114,12,5,7,0,79,67,12,19,14,0,1,4,4
"2011","E00174893","E00174893","Total",147,43,15,28,1,72,64,8,26,17,0,1,8,5
"2011","E00000880","E00000880","Total",139,32,10,22,1,98,60,38,5,4,0,0,1,3
"2011","E00000884","E00000884","Total",126,50,21,29,2,52,3,49,18,16,0,2,0,4
"2011","E00000890","E00000890","Total",102,80,30,50,2,3,1,2,17,17,0,0,0,0
"2011","E00000894","E00000894","Total",137,32,13,19,14,72,3,69,18,16,0,2,0,1
"2011","E00000897","E00000897","Total",97,5,4,1,0,88,4,84,4,3,0,0,1,0
"2011","E00000904","E00000904","Total",97,10,3,7,1,75,2,73,10,10,0,0,0,1
"2011","E00000883","E00000883","Total",123,88,39,49,2,8,6,2,23,22,0,1,0,2
"2011","E00000895","E00000895","Total",135,97,55,42,1,3,2,1,31,30,0,1,0,3
"2011","E00000898","E00000898","Total",167,135,88,47,4,10,4,6,18,18,0,0,0,0
"2011","E00000902","E00000902","Total",137,22,5,17,0,71,58,13,42,40,0,2,0,2
"2011","E00000907","E00000907","Total",133,82,42,40,1,9,2,7,39,39,0,0,0,2
"2011","E00000872","E00000872","Total",120,17,9,8,1,87,9,78,11,11,0,0,0,4
"2011","E00000878","E00000878","Total",108,64,26,38,0,21,8,13,21,21,0,0,0,2
"2011","E00000879","E00000879","Total",146,35,8,27,0,98,13,85,13,12,0,0,1,0
"2011","E00000882","E00000882","Total",129,50,26,24,9,52,41,11,17,17,0,0,0,1
"2011","E00001462","E00001462","Total",142,97,49,48,1,5,5,0,38,34,0,4,0,1
"2011","E00001463","E00001463","Total",106,59,21,38,1,15,11,4,30,28,0,2,0,1
"2011","E00001464","E00001464","Total",140,101,51,50,1,8,2,6,29,27,0,1,1,1
"2011","E00001466","E00001466","Total",166,84,36,48,2,17,5,12,61,55,2,2,2,2
"2011","E00001541","E00001541","Total",115,80,36,44,0,7,5,2,27,27,0,0,0,1
"2011","E00001562","E00001562","Total",131,36,11,25,0,11,5,6,83,82,0,1,0,1
"2011","E00001564","E00001564","Total",119,86,43,43,0,8,0,8,23,22,0,1,0,2
"2011","E00001567","E00001567","Total",214,97,31,66,1,30,2,28,83,80,0,3,0,3
"2011","E00174907","E00174907","Total",151,97,40,57,5,9,2,7,39,39,0,0,0,1
"2011","E00174909","E00174909","Total",144,39,14,25,9,49,5,44,47,44,0,2,1,0
"2011","E00001542","E00001542","Total",144,109,48,61,1,5,2,3,25,24,0,1,0,4
"2011","E00001566","E00001566","Total",129,95,44,51,1,4,2,2,29,28,0,1,0,0
"2011","E00001568","E00001568","Total",134,103,43,60,0,4,0,4,26,23,0,3,0,1
"2011","E00001570","E00001570","Total",122,68,28,40,1,36,32,4,15,15,0,0,0,2
"2011","E00000989","E00000989","Total",158,32,10,22,1,14,13,1,107,105,1,0,1,4
"2011","E00000991","E00000991","Total",156,82,68,14,0,0,0,0,65,63,0,2,0,9
"2011","E00000994","E00000994","Total",133,76,62,14,0,3,2,1,51,47,0,1,3,3
"2011","E00000996","E00000996","Total",133,33,13,20,1,1,0,1,97,97,0,0,0,1
"2011","E00001005","E00001005","Total",163,79,40,39,0,1,1,0,82,78,0,1,3,1
"2011","E00001009","E00001009","Total",153,53,34,19,2,0,0,0,92,88,1,3,0,6
"2011","E00000966","E00000966","Total",142,66,50,16,0,10,1,9,58,53,1,3,1,8
"2011","E00000969","E00000969","Total",138,116,74,42,0,2,1,1,17,14,1,1,1,3
"2011","E00000975","E00000975","Total",126,78,43,35,0,0,0,0,46,42,0,3,1,2
"2011","E00000999","E00000999","Total",172,120,82,38,1,2,2,0,41,39,0,2,0,8
"2011","E00001000","E00001000","Total",144,74,49,25,0,23,18,5,43,38,1,2,2,4
"2011","E00001008","E00001008","Total",141,99,57,42,0,2,2,0,35,33,0,2,0,5
"2011","E00000971","E00000971","Total",129,94,59,35,0,2,0,2,31,31,0,0,0,2
"2011","E00000979","E00000979","Total",133,108,62,46,1,2,0,2,19,18,0,1,0,3
"2011","E00000981","E00000981","Total",128,106,58,48,0,1,1,0,16,13,1,1,1,5
"2011","E00000982","E00000982","Total",127,113,70,43,1,2,0,2,9,8,0,1,0,2
"2011","E00000974","E00000974","Total",119,58,17,41,0,4,3,1,57,56,0,1,0,0
"2011","E00000978","E00000978","Total",121,71,32,39,0,1,0,1,46,45,0,1,0,3
"2011","E00001007","E00001007","Total",137,99,46,53,0,9,8,1,29,29,0,0,0,0
"2011","E00001010","E00001010","Total",132,88,48,40,0,3,3,0,31,29,0,2,0,10
"2011","E00001011","E00001011","Total",139,112,55,57,0,1,0,1,24,24,0,0,0,2
"2011","E00000967","E00000967","Total",117,62,29,33,0,39,38,1,14,14,0,0,0,2
"2011","E00000976","E00000976","Total",128,43,9,34,0,60,57,3,24,23,0,1,0,1
"2011","E00000977","E00000977","Total",104,64,33,31,0,10,5,5,27,25,0,0,2,3
"2011","E00000980","E00000980","Total",129,62,48,14,0,14,9,5,44,42,0,2,0,9
"2011","E00000983","E00000983","Total",135,89,49,40,1,12,9,3,27,26,0,1,0,6
"2011","E00000871","E00000871","Total",129,96,50,46,0,5,2,3,26,23,0,2,1,2
"2011","E00000892","E00000892","Total",137,90,46,44,0,14,4,10,31,30,0,1,0,2
"2011","E00000893","E00000893","Total",154,90,40,50,0,4,4,0,60,59,1,0,0,0
"2011","E00000899","E00000899","Total",141,97,42,55,1,2,0,2,41,41,0,0,0,0
"2011","E00000901","E00000901","Total",129,71,30,41,2,3,3,0,51,49,0,2,0,2
"2011","E00000870","E00000870","Total",112,73,29,44,0,2,0,2,36,36,0,0,0,1
"2011","E00000886","E00000886","Total",120,83,38,45,0,4,0,4,32,32,0,0,0,1
"2011","E00000888","E00000888","Total",119,74,25,49,0,1,1,0,44,44,0,0,0,0
"2011","E00000891","E00000891","Total",162,82,16,66,0,8,3,5,71,64,0,4,3,1
"2011","E00000900","E00000900","Total",136,98,37,61,0,12,12,0,25,24,0,1,0,1
"2011","E00000906","E00000906","Total",114,67,17,50,1,2,2,0,44,42,0,2,0,0
"2011","E00000874","E00000874","Total",115,38,27,11,0,64,21,43,9,9,0,0,0,4
"2011","E00000876","E00000876","Total",109,82,46,36,0,5,2,3,20,18,0,1,1,2
"2011","E00000903","E00000903","Total",113,47,21,26,1,8,7,1,56,55,0,1,0,1
"2011","E00000912","E00000912","Total",134,24,9,15,1,87,84,3,22,18,1,3,0,0
"2011","E00000917","E00000917","Total",93,40,22,18,1,35,2,33,15,13,0,1,1,2
"2011","E00000921","E00000921","Total",125,49,21,28,0,46,42,4,28,26,0,2,0,2
"2011","E00000905","E00000905","Total",118,93,36,57,0,5,2,3,19,19,0,0,0,1
"2011","E00000909","E00000909","Total",141,111,63,48,0,2,0,2,26,26,0,0,0,2
"2011","E00000910","E00000910","Total",136,86,36,50,2,4,1,3,42,42,0,0,0,2
"2011","E00000911","E00000911","Total",138,25,12,13,2,3,2,1,108,108,0,0,0,0
"2011","E00000916","E00000916","Total",136,80,51,29,0,5,4,1,47,47,0,0,0,4
"2011","E00000877","E00000877","Total",147,117,65,52,0,1,1,0,27,26,0,1,0,2
"2011","E00000915","E00000915","Total",136,61,27,34,2,7,1,6,62,61,0,1,0,4
"2011","E00000918","E00000918","Total",145,60,45,15,1,4,1,3,78,75,0,2,1,2
"2011","E00000919","E00000919","Total",155,109,59,50,0,1,1,0,45,44,0,1,0,0
"2011","E00000920","E00000920","Total",163,74,39,35,0,12,0,12,73,70,0,2,1,4
"2011","E00000881","E00000881","Total",128,32,8,24,2,70,56,14,20,20,0,0,0,4
"2011","E00000885","E00000885","Total",122,28,9,19,0,61,57,4,31,30,0,1,0,2
"2011","E00000887","E00000887","Total",106,29,9,20,0,54,51,3,19,18,0,1,0,4
"2011","E00000889","E00000889","Total",132,27,10,17,0,79,45,34,23,22,0,1,0,3
"2011","E00000896","E00000896","Total",118,18,3,15,0,72,58,14,27,25,0,2,0,1
"2011","E00000726","E00000726","Total",142,105,57,48,0,1,1,0,36,35,0,0,1,0
"2011","E00000727","E00000727","Total",133,98,51,47,1,2,2,0,28,25,0,2,1,4
"2011","E00000728","E00000728","Total",127,98,58,40,0,4,3,1,23,21,0,1,1,2
"2011","E00000730","E00000730","Total",142,98,53,45,1,3,1,2,38,35,0,3,0,2
"2011","E00000763","E00000763","Total",117,30,12,18,1,72,67,5,12,11,0,1,0,2
"2011","E00000765","E00000765","Total",131,68,29,39,2,19,9,10,41,38,0,3,0,1
"2011","E00000766","E00000766","Total",221,87,38,49,1,52,14,38,74,71,0,2,1,7
"2011","E00000767","E00000767","Total",126,49,21,28,1,56,53,3,20,19,0,1,0,0
"2011","E00000768","E00000768","Total",130,44,24,20,1,58,1,57,22,21,0,1,0,5
"2011","E00000724","E00000724","Total",97,35,17,18,1,17,8,9,42,42,0,0,0,2
"2011","E00000755","E00000755","Total",120,37,13,24,1,4,1,3,78,75,1,2,0,0
"2011","E00000756","E00000756","Total",131,27,8,19,3,38,4,34,63,60,0,2,1,0
"2011","E00000757","E00000757","Total",142,45,14,31,1,2,2,0,90,85,0,5,0,4
"2011","E00000758","E00000758","Total",105,34,14,20,1,5,3,2,64,63,0,1,0,1
"2011","E00000760","E00000760","Total",94,24,5,19,1,29,10,19,40,38,0,2,0,0
"2011","E00000761","E00000761","Total",108,28,7,21,1,4,1,3,75,74,0,1,0,0
"2011","E00000725","E00000725","Total",121,96,49,47,0,4,2,2,17,17,0,0,0,4
"2011","E00000732","E00000732","Total",139,89,47,42,1,4,2,2,45,41,1,1,2,0
"2011","E00000762","E00000762","Total",93,52,25,27,5,3,1,2,29,22,5,1,1,4
"2011","E00000764","E00000764","Total",135,74,37,37,0,13,2,11,48,47,0,1,0,0
"2011","E00174890","E00174890","Total",83,23,7,16,0,12,1,11,46,45,0,0,1,2
"2011","E00174892","E00174892","Total",127,32,6,26,2,22,1,21,70,67,0,2,1,1
"2011","E00174910","E00174910","Total",122,33,12,21,2,1,0,1,85,82,0,1,2,1
"2011","E00174913","E00174913","Total",112,45,8,37,7,1,0,1,59,58,1,0,0,0
"2011","E00174921","E00174921","Total",140,44,3,41,36,10,2,8,49,48,0,0,1,1
"2011","E00174922","E00174922","Total",106,4,0,4,24,66,4,62,12,11,0,0,1,0
"2011","E00001164","E00001164","Total",128,54,17,37,0,14,0,14,59,58,0,1,0,1
"2011","E00001180","E00001180","Total",107,44,11,33,1,1,0,1,60,55,0,4,1,1
"2011","E00001191","E00001191","Total",147,92,51,41,0,2,1,1,53,51,1,1,0,0
"2011","E00001203","E00001203","Total",116,43,19,24,0,2,0,2,70,67,0,3,0,1
"2011","E00001204","E00001204","Total",135,75,27,48,0,23,1,22,37,36,0,1,0,0
"2011","E00174912","E00174912","Total",142,36,11,25,3,35,1,34,66,63,1,2,0,2
"2011","E00174918","E00174918","Total",102,26,4,22,2,6,0,6,66,65,0,0,1,2
"2011","E00001178","E00001178","Total",136,80,28,52,2,7,3,4,46,45,0,1,0,1
"2011","E00001179","E00001179","Total",141,89,38,51,0,7,3,4,43,38,1,4,0,2
"2011","E00001181","E00001181","Total",159,113,51,62,0,7,3,4,35,34,0,1,0,4
"2011","E00001185","E00001185","Total",146,99,47,52,4,2,0,2,39,39,0,0,0,2
"2011","E00001182","E00001182","Total",118,87,40,47,0,0,0,0,29,26,0,2,1,2
"2011","E00001183","E00001183","Total",134,115,68,47,0,0,0,0,18,18,0,0,0,1
"2011","E00001184","E00001184","Total",168,74,25,49,1,8,6,2,85,83,0,2,0,0
"2011","E00001194","E00001194","Total",159,53,21,32,0,43,2,41,61,56,1,2,2,2
"2011","E00001197","E00001197","Total",117,83,45,38,0,1,1,0,33,32,0,0,1,0
"2011","E00001494","E00001494","Total",136,76,47,29,2,1,1,0,57,55,1,1,0,0
"2011","E00001521","E00001521","Total",103,50,21,29,0,11,10,1,41,37,1,3,0,1
"2011","E00001522","E00001522","Total",111,71,33,38,0,2,0,2,36,36,0,0,0,2
"2011","E00001524","E00001524","Total",107,87,41,46,0,1,1,0,17,16,0,1,0,2
"2011","E00001525","E00001525","Total",162,51,33,18,18,16,2,14,76,73,2,1,0,1
"2011","E00001157","E00001157","Total",152,69,40,29,2,2,1,1,77,74,0,1,2,2
"2011","E00001163","E00001163","Total",127,54,21,33,0,4,3,1,69,67,0,2,0,0
"2011","E00001167","E00001167","Total",109,72,40,32,0,1,0,1,31,31,0,0,0,5
"2011","E00001174","E00001174","Total",203,88,54,34,0,3,1,2,106,97,1,7,1,6
"2011","E00001177","E00001177","Total",149,62,40,22,4,1,1,0,82,80,0,1,1,0
"2011","E00001155","E00001155","Total",115,63,36,27,0,3,1,2,41,36,0,5,0,8
"2011","E00001156","E00001156","Total",107,37,26,11,0,60,2,58,10,10,0,0,0,0
"2011","E00001186","E00001186","Total",114,95,55,40,0,0,0,0,13,13,0,0,0,6
"2011","E00001193","E00001193","Total",149,98,38,60,0,3,1,2,45,42,0,3,0,3
"2011","E00001195","E00001195","Total",112,65,33,32,0,36,4,32,10,7,0,3,0,1
"2011","E00001160","E00001160","Total",155,74,35,39,1,7,3,4,71,70,0,1,0,2
"2011","E00001188","E00001188","Total",124,53,14,39,0,7,0,7,64,64,0,0,0,0
"2011","E00001192","E00001192","Total",141,74,49,25,0,17,16,1,46,42,0,3,1,4
"2011","E00001196","E00001196","Total",138,68,27,41,0,1,0,1,69,67,0,2,0,0
"2011","E00001198","E00001198","Total",127,95,72,23,1,2,1,1,27,24,0,3,0,2
"2011","E00001199","E00001199","Total",106,17,5,12,0,5,2,3,81,79,1,0,1,3
"2011","E00001161","E00001161","Total",150,51,23,28,3,14,6,8,82,80,0,1,1,0
"2011","E00001187","E00001187","Total",143,107,57,50,2,3,2,1,29,28,0,1,0,2
"2011","E00001189","E00001189","Total",132,51,26,25,1,34,26,8,39,35,1,1,2,7
"2011","E00001205","E00001205","Total",157,75,43,32,1,30,5,25,49,37,1,2,9,2
"2011","E00001159","E00001159","Total",129,30,10,20,1,70,63,7,26,24,0,1,1,2
"2011","E00001162","E00001162","Total",125,10,6,4,0,92,91,1,19,18,0,0,1,4
"2011","E00001165","E00001165","Total",130,70,40,30,2,12,8,4,42,38,0,4,0,4
"2011","E00001166","E00001166","Total",166,25,7,18,0,53,46,7,84,79,1,3,1,4
"2011","E00001170","E00001170","Total",128,11,9,2,0,93,90,3,21,21,0,0,0,3
"2011","E00001171","E00001171","Total",133,61,34,27,0,36,34,2,29,27,1,0,1,7
"2011","E00001495","E00001495","Total",132,84,54,30,0,0,0,0,42,42,0,0,0,6
"2011","E00001523","E00001523","Total",139,77,41,36,0,1,1,0,60,57,0,3,0,1
"2011","E00001534","E00001534","Total",121,82,52,30,0,5,5,0,29,27,0,1,1,5
"2011","E00001536","E00001536","Total",137,29,15,14,1,6,2,4,98,98,0,0,0,3
"2011","E00001539","E00001539","Total",129,67,31,36,0,0,0,0,62,62,0,0,0,0
"2011","E00000873","E00000873","Total",123,101,64,37,0,2,1,1,19,19,0,0,0,1
"2011","E00000875","E00000875","Total",103,78,45,33,0,1,1,0,21,21,0,0,0,3
"2011","E00000908","E00000908","Total",122,64,22,42,2,6,3,3,48,44,0,4,0,2
"2011","E00000913","E00000913","Total",126,56,27,29,0,37,16,21,30,28,1,1,0,3
"2011","E00000914","E00000914","Total",110,80,40,40,0,2,1,1,28,28,0,0,0,0
"2011","E00001014","E00001014","Total",178,106,70,36,0,12,0,12,56,52,1,3,0,4
"2011","E00001015","E00001015","Total",118,96,65,31,0,2,0,2,14,11,1,0,2,6
"2011","E00001017","E00001017","Total",99,70,50,20,1,2,1,1,18,14,0,2,2,8
"2011","E00001057","E00001057","Total",119,93,64,29,0,0,0,0,17,15,0,1,1,9
"2011","E00001034","E00001034","Total",117,31,9,22,1,8,5,3,74,68,2,2,2,3
"2011","E00001037","E00001037","Total",126,87,60,27,0,7,2,5,27,27,0,0,0,5
"2011","E00001043","E00001043","Total",125,116,66,50,0,0,0,0,8,7,0,0,1,1
"2011","E00001051","E00001051","Total",119,80,56,24,0,21,1,20,13,13,0,0,0,5
"2011","E00001052","E00001052","Total",121,89,55,34,0,2,2,0,27,24,0,2,1,3
"2011","E00001028","E00001028","Total",148,106,79,27,0,1,0,1,37,35,1,1,0,4
"2011","E00001030","E00001030","Total",120,86,50,36,0,4,3,1,28,28,0,0,0,2
"2011","E00001031","E00001031","Total",120,108,59,49,0,0,0,0,9,9,0,0,0,3
"2011","E00001035","E00001035","Total",113,63,30,33,0,4,1,3,43,39,0,4,0,3
"2011","E00001038","E00001038","Total",118,94,53,41,1,1,0,1,17,17,0,0,0,5
"2011","E00001018","E00001018","Total",118,66,33,33,0,6,5,1,42,40,0,2,0,4
"2011","E00001019","E00001019","Total",111,61,29,32,0,2,0,2,46,43,0,3,0,2
"2011","E00001024","E00001024","Total",131,104,54,50,0,0,0,0,25,25,0,0,0,2
"2011","E00001025","E00001025","Total",122,107,55,52,0,2,1,1,12,9,2,0,1,1
"2011","E00001027","E00001027","Total",118,81,34,47,0,2,0,2,33,33,0,0,0,2
"2011","E00001012","E00001012","Total",95,31,26,5,0,54,1,53,8,6,0,0,2,2
"2011","E00001046","E00001046","Total",117,99,57,42,0,0,0,0,14,13,0,1,0,4
"2011","E00001047","E00001047","Total",131,115,67,48,0,2,0,2,14,13,0,1,0,0
"2011","E00001049","E00001049","Total",122,102,61,41,0,3,1,2,15,15,0,0,0,2
"2011","E00001169","E00001169","Total",136,88,57,31,0,1,0,1,46,44,0,2,0,1
"2011","E00001172","E00001172","Total",121,44,19,25,0,3,1,2,70,69,1,0,0,4
"2011","E00001173","E00001173","Total",134,73,39,34,0,6,3,3,50,48,1,1,0,5
"2011","E00001175","E00001175","Total",133,75,47,28,0,1,1,0,53,52,0,1,0,4
"2011","E00001176","E00001176","Total",150,48,21,27,1,44,43,1,53,52,0,1,0,4
"2011","E00001158","E00001158","Total",152,55,25,30,0,30,3,27,64,64,0,0,0,3
"2011","E00001168","E00001168","Total",116,61,27,34,1,5,2,3,46,45,0,1,0,3
"2011","E00001200","E00001200","Total",117,89,33,56,0,2,0,2,25,25,0,0,0,1
"2011","E00001201","E00001201","Total",110,83,41,42,0,3,1,2,23,23,0,0,0,1
"2011","E00001202","E00001202","Total",120,60,26,34,0,0,0,0,56,54,0,2,0,4
"2011","E00001501","E00001501","Total",138,85,53,32,1,0,0,0,51,48,0,3,0,1
"2011","E00001506","E00001506","Total",127,65,37,28,1,3,1,2,55,51,0,4,0,3
"2011","E00001512","E00001512","Total",117,64,27,37,0,31,28,3,20,18,0,2,0,2
"2011","E00001532","E00001532","Total",140,94,60,34,0,2,1,1,40,37,0,3,0,4
"2011","E00001533","E00001533","Total",179,27,19,8,1,13,1,12,137,135,0,1,1,1
"2011","E00001505","E00001505","Total",117,90,45,45,1,4,3,1,21,19,1,0,1,1
"2011","E00001526","E00001526","Total",125,78,47,31,0,0,0,0,45,40,0,5,0,2
"2011","E00001527","E00001527","Total",107,83,43,40,1,1,0,1,20,18,0,2,0,2
"2011","E00001531","E00001531","Total",121,89,51,38,0,0,0,0,27,25,0,2,0,5
"2011","E00001020","E00001020","Total",120,97,49,48,0,6,6,0,13,13,0,0,0,4
"2011","E00001022","E00001022","Total",125,100,51,49,0,1,1,0,23,21,0,2,0,1
"2011","E00001023","E00001023","Total",123,108,48,60,0,1,1,0,13,13,0,0,0,1
"2011","E00001032","E00001032","Total",130,112,50,62,0,1,1,0,16,14,0,2,0,1
"2011","E00001036","E00001036","Total",121,99,49,50,0,1,0,1,20,20,0,0,0,1
"2011","E00001029","E00001029","Total",131,95,59,36,3,3,0,3,28,28,0,0,0,2
"2011","E00001040","E00001040","Total",133,103,73,30,1,1,1,0,27,26,0,1,0,1
"2011","E00001041","E00001041","Total",106,11,6,5,0,91,2,89,3,3,0,0,0,1
"2011","E00001042","E00001042","Total",119,101,64,37,0,0,0,0,17,17,0,0,0,1
"2011","E00001044","E00001044","Total",130,106,69,37,0,0,0,0,21,20,0,1,0,3
"2011","E00001045","E00001045","Total",128,119,81,38,0,0,0,0,9,9,0,0,0,0
"2011","E00001021","E00001021","Total",139,66,24,42,2,4,0,4,64,61,0,3,0,3
"2011","E00001026","E00001026","Total",150,65,34,31,0,8,2,6,73,72,1,0,0,4
"2011","E00001033","E00001033","Total",127,64,29,35,0,25,24,1,35,34,0,1,0,3
"2011","E00001039","E00001039","Total",136,71,51,20,1,6,5,1,52,50,0,2,0,6
"2011","E00001048","E00001048","Total",160,33,16,17,0,3,0,3,124,119,0,4,1,0
"2011","E00001050","E00001050","Total",149,55,35,20,0,3,2,1,90,86,0,3,1,1
"2011","E00001053","E00001053","Total",132,114,87,27,0,1,1,0,16,16,0,0,0,1
"2011","E00001054","E00001054","Total",129,120,86,34,0,0,0,0,9,7,0,2,0,0
"2011","E00001055","E00001055","Total",128,75,46,29,0,1,0,1,51,50,1,0,0,1
"2011","E00001056","E00001056","Total",140,50,28,22,3,12,10,2,75,69,3,1,2,0
"2011","E00001063","E00001063","Total",145,90,42,48,1,2,0,2,50,46,0,2,2,2
"2011","E00001064","E00001064","Total",129,80,53,27,0,1,1,0,46,44,0,1,1,2
"2011","E00001067","E00001067","Total",159,69,36,33,0,19,0,19,67,66,1,0,0,4
"2011","E00001101","E00001101","Total",127,58,31,27,0,25,24,1,42,41,0,1,0,2
"2011","E00001105","E00001105","Total",124,68,34,34,2,1,0,1,50,50,0,0,0,3
"2011","E00001095","E00001095","Total",138,75,42,33,1,2,0,2,59,58,0,0,1,1
"2011","E00001098","E00001098","Total",130,99,56,43,0,2,1,1,25,24,0,1,0,4
"2011","E00001099","E00001099","Total",129,62,33,29,0,1,0,1,64,63,0,1,0,2
"2011","E00001103","E00001103","Total",124,97,56,41,1,1,1,0,25,22,0,3,0,0
"2011","E00000729","E00000729","Total",128,104,52,52,1,7,6,1,14,13,0,1,0,2
"2011","E00000731","E00000731","Total",133,63,39,24,1,19,4,15,49,44,1,2,2,1
"2011","E00000733","E00000733","Total",114,79,34,45,1,5,4,1,29,28,0,1,0,0
"2011","E00000734","E00000734","Total",126,93,47,46,0,12,7,5,21,20,0,1,0,0
"2011","E00174891","E00174891","Total",121,35,11,24,5,36,4,32,41,38,0,3,0,4
"2011","E00174911","E00174911","Total",122,76,39,37,1,24,17,7,21,20,0,1,0,0
"2011","E00001510","E00001510","Total",177,49,27,22,0,26,17,9,100,100,0,0,0,2
"2011","E00001515","E00001515","Total",185,32,12,20,0,130,116,14,19,19,0,0,0,4
"2011","E00001517","E00001517","Total",151,109,76,33,0,2,2,0,38,35,0,3,0,2
"2011","E00001520","E00001520","Total",124,76,43,33,2,0,0,0,45,45,0,0,0,1
"2011","E00001499","E00001499","Total",126,88,55,33,1,6,5,1,29,29,0,0,0,2
"2011","E00001500","E00001500","Total",142,71,36,35,10,6,2,4,54,54,0,0,0,1
"2011","E00001502","E00001502","Total",143,87,48,39,0,16,2,14,39,37,0,2,0,1
"2011","E00001516","E00001516","Total",147,86,42,44,0,5,5,0,55,55,0,0,0,1
"2011","E00001503","E00001503","Total",122,56,25,31,0,43,40,3,21,21,0,0,0,2
"2011","E00001504","E00001504","Total",126,43,22,21,0,72,71,1,9,9,0,0,0,2
"2011","E00001507","E00001507","Total",233,27,11,16,0,181,168,13,21,19,0,1,1,4
"2011","E00001513","E00001513","Total",88,5,4,1,0,74,68,6,9,8,0,1,0,0
"2011","E00001514","E00001514","Total",100,22,12,10,0,65,59,6,11,10,0,1,0,2
"2011","E00001498","E00001498","Total",141,66,30,36,1,10,7,3,63,61,1,0,1,1
"2011","E00001529","E00001529","Total",163,65,24,41,0,81,62,19,15,14,0,0,1,2
"2011","E00001530","E00001530","Total",151,58,17,41,0,33,30,3,56,55,0,1,0,4
"2011","E00001535","E00001535","Total",131,57,15,42,5,22,19,3,46,44,0,2,0,1
"2011","E00001538","E00001538","Total",124,66,19,47,0,6,3,3,51,47,1,3,0,1
"2011","E00001497","E00001497","Total",143,35,10,25,0,29,24,5,77,75,0,1,1,2
"2011","E00001508","E00001508","Total",121,69,34,35,0,6,2,4,46,43,1,1,1,0
"2011","E00001509","E00001509","Total",147,53,20,33,0,15,5,10,77,76,1,0,0,2
"2011","E00001528","E00001528","Total",134,64,32,32,1,10,9,1,54,51,0,0,3,5
"2011","E00001537","E00001537","Total",127,79,48,31,0,1,1,0,41,39,0,1,1,6
"2011","E00000689","E00000689","Total",98,56,28,28,1,0,0,0,40,40,0,0,0,1
"2011","E00000690","E00000690","Total",109,74,39,35,0,1,0,1,31,28,0,1,2,3
"2011","E00000692","E00000692","Total",116,59,30,29,2,2,0,2,53,50,1,2,0,0
"2011","E00000695","E00000695","Total",121,87,50,37,0,0,0,0,30,30,0,0,0,4
"2011","E00001097","E00001097","Total",136,83,45,38,0,1,0,1,49,47,0,1,1,3
"2011","E00001100","E00001100","Total",137,97,63,34,0,1,0,1,35,35,0,0,0,4
"2011","E00001102","E00001102","Total",135,57,37,20,0,4,2,2,69,68,0,1,0,5
"2011","E00001104","E00001104","Total",133,53,32,21,0,51,4,47,29,29,0,0,0,0
"2011","E00001106","E00001106","Total",139,67,43,24,0,2,0,2,67,64,0,1,2,3
"2011","E00001062","E00001062","Total",181,69,41,28,2,6,5,1,102,100,0,1,1,2
"2011","E00001065","E00001065","Total",126,72,52,20,0,4,2,2,45,40,1,4,0,5
"2011","E00001068","E00001068","Total",137,83,46,37,0,2,1,1,51,50,0,1,0,1
"2011","E00001071","E00001071","Total",129,45,32,13,2,0,0,0,77,74,2,1,0,5
"2011","E00001066","E00001066","Total",155,52,31,21,0,8,0,8,93,90,0,1,2,2
"2011","E00001070","E00001070","Total",130,71,37,34,2,3,1,2,52,51,0,1,0,2
"2011","E00001072","E00001072","Total",152,64,31,33,1,3,1,2,83,82,0,1,0,1
"2011","E00001075","E00001075","Total",144,63,34,29,2,1,0,1,71,66,0,4,1,7
"2011","E00001069","E00001069","Total",198,43,26,17,2,66,0,66,85,79,0,1,5,2
"2011","E00001073","E00001073","Total",132,55,30,25,2,5,1,4,66,64,0,2,0,4
"2011","E00001074","E00001074","Total",145,63,38,25,0,0,0,0,76,69,2,3,2,6
"2011","E00001077","E00001077","Total",118,48,20,28,0,4,2,2,65,64,0,0,1,1
"2011","E00001092","E00001092","Total",148,102,45,57,1,4,2,2,40,37,0,3,0,1
"2011","E00001093","E00001093","Total",143,103,52,51,0,1,1,0,36,34,0,1,1,3
"2011","E00001094","E00001094","Total",135,95,45,50,0,4,0,4,34,32,0,1,1,2
"2011","E00001096","E00001096","Total",103,14,5,9,0,77,1,76,11,11,0,0,0,1
"2011","E00000697","E00000697","Total",132,106,65,41,1,0,0,0,21,20,0,1,0,4
"2011","E00000698","E00000698","Total",155,98,48,50,0,8,1,7,46,37,0,7,2,3
"2011","E00000706","E00000706","Total",124,65,45,20,0,0,0,0,59,58,0,1,0,0
"2011","E00000708","E00000708","Total",130,89,57,32,1,2,0,2,35,34,0,1,0,3
"2011","E00000700","E00000700","Total",158,80,49,31,6,2,0,2,63,58,1,4,0,7
"2011","E00000703","E00000703","Total",138,116,93,23,0,0,0,0,17,17,0,0,0,5
"2011","E00000705","E00000705","Total",128,89,65,24,0,0,0,0,34,32,1,1,0,5
"2011","E00000707","E00000707","Total",139,98,64,34,0,1,0,1,40,39,1,0,0,0
"2011","E00000687","E00000687","Total",125,59,34,25,0,7,0,7,58,55,0,3,0,1
"2011","E00000688","E00000688","Total",114,56,36,20,1,2,2,0,52,50,0,1,1,3
"2011","E00000691","E00000691","Total",114,33,23,10,0,0,0,0,75,70,2,0,3,6
"2011","E00000693","E00000693","Total",125,33,16,17,1,1,1,0,88,85,0,2,1,2
"2011","E00000694","E00000694","Total",129,49,28,21,1,2,0,2,76,73,1,2,0,1
"2011","E00000696","E00000696","Total",188,15,4,11,0,14,8,6,158,154,0,2,2,1
"2011","E00000699","E00000699","Total",133,70,44,26,1,9,3,6,48,44,1,3,0,5
"2011","E00000701","E00000701","Total",126,65,42,23,2,19,19,0,34,31,0,3,0,6
"2011","E00000702","E00000702","Total",175,35,19,16,0,22,9,13,114,110,3,0,1,4
"2011","E00000704","E00000704","Total",122,59,46,13,1,4,0,4,55,55,0,0,0,3
"2011","E00001013","E00001013","Total",180,113,64,49,0,0,0,0,63,63,0,0,0,4
"2011","E00001016","E00001016","Total",144,58,17,41,0,1,0,1,81,80,0,0,1,4
"2011","E00001058","E00001058","Total",137,87,59,28,1,1,1,0,45,44,0,1,0,3
"2011","E00001059","E00001059","Total",143,106,60,46,0,1,1,0,32,29,0,3,0,4
"2011","E00001060","E00001060","Total",113,30,14,16,0,1,0,1,78,74,0,4,0,4
"2011","E00000668","E00000668","Total",137,45,16,29,1,53,6,47,35,32,0,3,0,3
"2011","E00000676","E00000676","Total",143,78,34,44,1,8,3,5,56,55,0,1,0,0
"2011","E00000677","E00000677","Total",137,28,5,23,1,18,4,14,89,84,3,1,1,1
"2011","E00000681","E00000681","Total",153,33,6,27,1,31,10,21,86,84,0,2,0,2
"2011","E00000685","E00000685","Total",168,33,14,19,1,33,17,16,97,93,0,4,0,4
"2011","E00000686","E00000686","Total",126,30,14,16,0,9,1,8,82,75,0,2,5,5
"2011","E00001061","E00001061","Total",143,50,21,29,11,68,22,46,13,13,0,0,0,1
"2011","E00001076","E00001076","Total",128,21,13,8,1,74,3,71,27,27,0,0,0,5
"2011","E00001078","E00001078","Total",105,18,14,4,0,66,65,1,19,18,0,1,0,2
"2011","E00001079","E00001079","Total",109,15,6,9,0,79,73,6,14,14,0,0,0,1
"2011","E00001083","E00001083","Total",111,51,14,37,2,36,34,2,21,19,0,2,0,1
"2011","E00001084","E00001084","Total",106,51,19,32,1,39,38,1,15,15,0,0,0,0
"2011","E00001088","E00001088","Total",142,56,14,42,4,59,54,5,22,21,0,1,0,1
"2011","E00001090","E00001090","Total",119,49,31,18,2,28,27,1,37,37,0,0,0,3
"2011","E00001496","E00001496","Total",142,89,48,41,2,16,13,3,33,32,1,0,0,2
"2011","E00001511","E00001511","Total",120,67,33,34,0,16,13,3,35,34,0,1,0,2
"2011","E00001518","E00001518","Total",134,59,26,33,0,50,47,3,23,23,0,0,0,2
"2011","E00001519","E00001519","Total",134,82,32,50,0,27,27,0,25,24,0,1,0,0
"2011","E00000670","E00000670","Total",130,93,52,41,1,2,0,2,30,28,0,2,0,4
"2011","E00000710","E00000710","Total",137,69,40,29,0,2,2,0,60,60,0,0,0,6
"2011","E00000712","E00000712","Total",123,83,59,24,0,2,1,1,34,34,0,0,0,4
"2011","E00000720","E00000720","Total",133,58,30,28,1,30,29,1,40,39,0,0,1,4
"2011","E00000679","E00000679","Total",125,45,19,26,0,8,0,8,71,71,0,0,0,1
"2011","E00000714","E00000714","Total",119,83,40,43,0,3,2,1,29,25,0,3,1,4
"2011","E00000715","E00000715","Total",153,76,42,34,0,7,0,7,65,62,0,2,1,5
"2011","E00000719","E00000719","Total",139,51,20,31,0,0,0,0,87,84,0,3,0,1
"2011","E00174894","E00174894","Total",116,35,5,30,0,2,0,2,78,78,0,0,0,1
"2011","E00174895","E00174895","Total",102,43,8,35,0,0,0,0,57,56,0,1,0,2
"2011","E00174901","E00174901","Total",93,42,18,24,0,2,0,2,49,46,0,3,0,0
"2011","E00174902","E00174902","Total",103,26,7,19,10,30,1,29,35,34,0,1,0,2
"2011","E00001080","E00001080","Total",127,66,29,37,0,43,37,6,18,16,0,2,0,0
"2011","E00001081","E00001081","Total",124,77,48,29,0,9,7,2,38,34,0,2,2,0
"2011","E00001082","E00001082","Total",123,71,39,32,0,6,4,2,44,44,0,0,0,2
"2011","E00001085","E00001085","Total",132,77,45,32,0,4,1,3,46,41,2,3,0,5
"2011","E00001086","E00001086","Total",148,92,57,35,1,1,1,0,50,49,0,1,0,4
"2011","E00001087","E00001087","Total",113,78,47,31,1,3,1,2,28,25,1,0,2,3
"2011","E00001089","E00001089","Total",141,91,43,48,1,1,0,1,47,47,0,0,0,1
"2011","E00001091","E00001091","Total",122,83,42,41,0,3,1,2,34,32,0,1,1,2
"2011","E00000678","E00000678","Total",133,43,15,28,1,49,44,5,35,34,0,0,1,5
"2011","E00000709","E00000709","Total",160,39,12,27,4,96,74,22,19,19,0,0,0,2
"2011","E00000713","E00000713","Total",142,84,53,31,0,9,9,0,47,44,1,2,0,2
"2011","E00000717","E00000717","Total",115,17,6,11,0,79,77,2,18,16,0,1,1,1
"2011","E00000718","E00000718","Total",119,44,18,26,1,51,45,6,21,20,1,0,0,2
"2011","E00000669","E00000669","Total",141,86,44,42,1,4,3,1,44,40,1,2,1,6
"2011","E00000672","E00000672","Total",133,92,56,36,0,3,3,0,34,33,0,1,0,4
"2011","E00000674","E00000674","Total",141,107,71,36,0,8,7,1,20,18,0,1,1,6
"2011","E00000675","E00000675","Total",145,63,38,25,0,11,10,1,69,65,1,3,0,2
"2011","E00000671","E00000671","Total",122,55,25,30,1,12,5,7,50,48,0,2,0,4
"2011","E00000711","E00000711","Total",143,54,30,24,0,3,1,2,83,77,0,3,3,3
"2011","E00000716","E00000716","Total",146,65,35,30,0,6,2,4,73,70,1,1,1,2
"2011","E00000721","E00000721","Total",153,26,8,18,2,46,45,1,76,65,3,6,2,3
"2011","E00000722","E00000722","Total",119,83,53,30,0,4,3,1,30,26,0,2,2,2
"2011","E00000680","E00000680","Total",141,30,14,16,1,85,84,1,23,23,0,0,0,2
"2011","E00000682","E00000682","Total",119,63,38,25,0,35,32,3,20,18,1,1,0,1
"2011","E00000683","E00000683","Total",123,38,17,21,0,58,58,0,25,23,0,2,0,2
"2011","E00000684","E00000684","Total",155,29,11,18,7,63,19,44,56,55,0,1,0,0
"2011","E00002275","E00002275","Total",127,72,24,48,0,30,1,29,24,24,0,0,0,1
"2011","E00002296","E00002296","Total",128,83,28,55,0,18,3,15,22,20,0,1,1,5
"2011","E00002297","E00002297","Total",126,27,7,20,0,91,19,72,8,8,0,0,0,0
"2011","E00002300","E00002300","Total",127,18,3,15,2,86,6,80,17,17,0,0,0,4
"2011","E00002302","E00002302","Total",94,14,2,12,1,77,7,70,2,1,0,0,1,0
"2011","E00002282","E00002282","Total",90,39,5,34,0,37,3,34,14,13,0,1,0,0
"2011","E00002283","E00002283","Total",106,32,3,29,0,63,4,59,10,9,0,0,1,1
"2011","E00002284","E00002284","Total",126,90,21,69,0,8,0,8,25,20,0,4,1,3
"2011","E00002287","E00002287","Total",133,81,15,66,1,2,0,2,49,48,0,1,0,0
"2011","E00002289","E00002289","Total",136,72,15,57,1,21,2,19,41,41,0,0,0,1
"2011","E00002285","E00002285","Total",127,79,16,63,0,12,4,8,36,33,0,2,1,0
"2011","E00002286","E00002286","Total",114,64,8,56,0,3,1,2,45,39,0,6,0,2
"2011","E00002288","E00002288","Total",144,71,16,55,0,46,6,40,25,25,0,0,0,2
"2011","E00002291","E00002291","Total",134,86,13,73,1,10,2,8,36,36,0,0,0,1
"2011","E00166763","E00166763","Total",99,62,10,52,0,8,0,8,28,26,0,2,0,1
"2011","E00166764","E00166764","Total",121,64,3,61,0,8,1,7,49,49,0,0,0,0
"2011","E00166765","E00166765","Total",66,28,3,25,0,4,3,1,34,34,0,0,0,0
"2011","E00166766","E00166766","Total",85,39,2,37,0,6,0,6,40,36,0,3,1,0
"2011","E00002279","E00002279","Total",144,95,28,67,2,10,3,7,37,35,0,2,0,0
"2011","E00002290","E00002290","Total",118,76,22,54,1,6,2,4,34,32,0,1,1,1
"2011","E00002292","E00002292","Total",128,52,17,35,3,52,13,39,20,17,0,3,0,1
"2011","E00002293","E00002293","Total",136,86,23,63,2,18,1,17,28,28,0,0,0,2
"2011","E00002294","E00002294","Total",119,64,12,52,5,6,0,6,42,41,0,1,0,2
"2011","E00002042","E00002042","Total",131,73,29,44,0,31,0,31,27,26,0,1,0,0
"2011","E00002043","E00002043","Total",134,101,53,48,0,9,0,9,23,21,0,2,0,1
"2011","E00002048","E00002048","Total",130,82,27,55,2,8,2,6,37,37,0,0,0,1
"2011","E00002070","E00002070","Total",122,52,15,37,1,55,4,51,12,12,0,0,0,2
"2011","E00002044","E00002044","Total",141,92,26,66,0,10,0,10,38,33,0,5,0,1
"2011","E00002045","E00002045","Total",132,64,35,29,1,45,4,41,22,22,0,0,0,0
"2011","E00002046","E00002046","Total",107,81,31,50,2,6,1,5,18,17,0,1,0,0
"2011","E00002047","E00002047","Total",126,94,36,58,0,12,2,10,20,15,0,5,0,0
"2011","E00002049","E00002049","Total",129,92,35,57,2,14,3,11,21,19,0,2,0,0
"2011","E00002072","E00002072","Total",119,39,13,26,0,64,5,59,16,15,0,1,0,0
"2011","E00002040","E00002040","Total",115,21,8,13,0,85,4,81,7,7,0,0,0,2
"2011","E00002041","E00002041","Total",143,13,8,5,0,119,7,112,9,7,0,2,0,2
"2011","E00002068","E00002068","Total",139,5,2,3,0,129,5,124,4,4,0,0,0,1
"2011","E00002069","E00002069","Total",141,8,2,6,0,123,9,114,8,7,0,1,0,2
"2011","E00002071","E00002071","Total",143,62,20,42,0,63,10,53,17,13,0,3,1,1
"2011","E00002281","E00002281","Total",167,69,20,49,0,71,10,61,23,19,0,3,1,4
"2011","E00002304","E00002304","Total",118,47,14,33,0,56,6,50,15,13,1,1,0,0
"2011","E00002307","E00002307","Total",141,77,26,51,1,36,6,30,26,25,0,1,0,1
"2011","E00002309","E00002309","Total",120,0,0,0,0,115,5,110,4,4,0,0,0,1
"2011","E00002299","E00002299","Total",120,7,3,4,0,101,15,86,10,9,0,1,0,2
"2011","E00002301","E00002301","Total",126,58,17,41,0,49,5,44,14,14,0,0,0,5
"2011","E00002303","E00002303","Total",124,12,3,9,0,102,8,94,8,7,0,0,1,2
"2011","E00002305","E00002305","Total",97,25,6,19,0,65,7,58,4,4,0,0,0,3
"2011","E00002306","E00002306","Total",119,42,12,30,0,60,4,56,16,15,0,1,0,1
"2011","E00002308","E00002308","Total",121,28,13,15,0,75,9,66,16,14,0,2,0,2
"2011","E00002276","E00002276","Total",60,6,2,4,0,49,5,44,3,3,0,0,0,2
"2011","E00002277","E00002277","Total",120,9,7,2,0,82,10,72,29,27,0,2,0,0
"2011","E00002280","E00002280","Total",122,68,27,41,0,40,2,38,13,11,0,2,0,1
"2011","E00002295","E00002295","Total",134,18,14,4,0,100,10,90,16,14,0,1,1,0
"2011","E00002298","E00002298","Total",154,15,2,13,0,133,8,125,6,3,0,3,0,0
"2011","E00001629","E00001629","Total",137,115,68,47,0,2,0,2,19,17,0,2,0,1
"2011","E00001631","E00001631","Total",147,107,36,71,0,7,0,7,32,28,0,3,1,1
"2011","E00001657","E00001657","Total",118,44,12,32,0,67,7,60,5,5,0,0,0,2
"2011","E00001658","E00001658","Total",121,37,12,25,0,69,9,60,13,12,0,1,0,2
"2011","E00001659","E00001659","Total",137,70,29,41,1,6,0,6,58,52,0,3,3,2
"2011","E00001661","E00001661","Total",133,99,40,59,0,4,0,4,30,28,0,2,0,0
"2011","E00001632","E00001632","Total",163,95,33,62,0,33,7,26,32,29,0,3,0,3
"2011","E00001633","E00001633","Total",128,59,19,40,0,44,3,41,24,22,0,1,1,1
"2011","E00001634","E00001634","Total",98,33,11,22,6,33,3,30,24,22,0,2,0,2
"2011","E00001635","E00001635","Total",118,76,34,42,0,14,6,8,22,22,0,0,0,6
"2011","E00001644","E00001644","Total",131,74,20,54,0,21,2,19,34,33,0,1,0,2
"2011","E00001636","E00001636","Total",138,70,14,56,4,9,3,6,54,52,0,2,0,1
"2011","E00001637","E00001637","Total",168,59,17,42,0,90,1,89,18,16,1,0,1,1
"2011","E00001638","E00001638","Total",139,91,30,61,1,2,0,2,44,40,0,2,2,1
"2011","E00001639","E00001639","Total",121,46,19,27,0,52,9,43,21,19,0,1,1,2
"2011","E00001641","E00001641","Total",113,10,1,9,0,96,21,75,7,7,0,0,0,0
"2011","E00001646","E00001646","Total",114,39,5,34,0,52,12,40,21,18,0,2,1,2
"2011","E00001628","E00001628","Total",131,100,29,71,2,3,1,2,26,25,0,1,0,0
"2011","E00001640","E00001640","Total",149,98,35,63,0,13,1,12,37,34,0,2,1,1
"2011","E00001645","E00001645","Total",133,116,42,74,2,2,1,1,12,10,0,2,0,1
"2011","E00001648","E00001648","Total",123,60,17,43,1,35,4,31,26,26,0,0,0,1
"2011","E00001650","E00001650","Total",127,89,33,56,0,20,3,17,18,18,0,0,0,0
"2011","E00001627","E00001627","Total",128,90,34,56,1,7,0,7,29,25,0,3,1,1
"2011","E00001642","E00001642","Total",127,78,27,51,0,5,1,4,41,39,0,1,1,3
"2011","E00001647","E00001647","Total",134,96,25,71,1,2,0,2,35,33,0,1,1,0
"2011","E00001649","E00001649","Total",151,103,46,57,0,3,0,3,43,41,0,1,1,2
"2011","E00001652","E00001652","Total",153,115,39,76,0,8,0,8,29,26,0,2,1,1
"2011","E00001980","E00001980","Total",134,101,44,57,0,9,3,6,23,23,0,0,0,1
"2011","E00001981","E00001981","Total",227,59,14,45,36,122,5,117,10,10,0,0,0,0
"2011","E00002003","E00002003","Total",127,17,7,10,0,92,16,76,17,17,0,0,0,1
"2011","E00002004","E00002004","Total",138,115,71,44,1,9,1,8,13,12,0,1,0,0
"2011","E00166767","E00166767","Total",116,12,3,9,25,71,8,63,8,5,0,0,3,0
"2011","E00166769","E00166769","Total",136,13,5,8,31,72,4,68,17,15,1,0,1,3
"2011","E00166772","E00166772","Total",112,71,54,17,10,5,0,5,24,21,0,2,1,2
"2011","E00001972","E00001972","Total",207,78,12,66,0,8,2,6,120,117,1,1,1,1
"2011","E00001974","E00001974","Total",196,15,2,13,26,115,3,112,36,34,0,2,0,4
"2011","E00001997","E00001997","Total",153,65,20,45,3,27,8,19,52,52,0,0,0,6
"2011","E00002001","E00002001","Total",116,55,10,45,1,17,3,14,42,37,0,2,3,1
"2011","E00166768","E00166768","Total",109,42,4,38,1,9,4,5,54,53,0,1,0,3
"2011","E00166770","E00166770","Total",89,18,8,10,2,59,7,52,8,8,0,0,0,2
"2011","E00166771","E00166771","Total",89,25,3,22,0,8,5,3,56,55,0,0,1,0
"2011","E00001989","E00001989","Total",132,94,33,61,1,5,1,4,31,28,0,3,0,1
"2011","E00001991","E00001991","Total",125,65,10,55,0,35,5,30,24,23,0,1,0,1
"2011","E00001993","E00001993","Total",128,97,24,73,0,7,0,7,23,20,0,3,0,1
"2011","E00001994","E00001994","Total",137,85,22,63,1,24,2,22,26,26,0,0,0,1
"2011","E00001984","E00001984","Total",126,75,29,46,1,10,0,10,31,29,0,1,1,9
"2011","E00001985","E00001985","Total",119,86,26,60,0,10,1,9,21,19,0,2,0,2
"2011","E00001986","E00001986","Total",122,86,16,70,1,8,2,6,27,23,0,3,1,0
"2011","E00001987","E00001987","Total",122,95,35,60,0,4,1,3,23,23,0,0,0,0
"2011","E00001988","E00001988","Total",81,64,22,42,1,2,0,2,14,13,0,1,0,0
"2011","E00001625","E00001625","Total",110,95,70,25,1,3,0,3,8,7,0,1,0,3
"2011","E00001643","E00001643","Total",121,99,46,53,0,9,0,9,12,9,1,2,0,1
"2011","E00001651","E00001651","Total",142,126,72,54,0,2,0,2,12,10,0,2,0,2
"2011","E00001653","E00001653","Total",133,100,52,48,0,4,0,4,29,25,1,3,0,0
"2011","E00001655","E00001655","Total",105,67,21,46,0,28,6,22,10,10,0,0,0,0
"2011","E00001973","E00001973","Total",153,76,25,51,0,34,0,34,41,39,0,2,0,2
"2011","E00001975","E00001975","Total",123,54,15,39,2,44,3,41,22,22,0,0,0,1
"2011","E00001976","E00001976","Total",110,67,28,39,2,30,2,28,10,7,0,2,1,1
"2011","E00001990","E00001990","Total",142,83,46,37,1,47,8,39,11,9,0,2,0,0
"2011","E00001995","E00001995","Total",132,84,20,64,0,13,3,10,35,35,0,0,0,0
"2011","E00001992","E00001992","Total",125,100,36,64,1,3,0,3,19,18,0,1,0,2
"2011","E00001996","E00001996","Total",126,90,34,56,0,5,0,5,31,31,0,0,0,0
"2011","E00001998","E00001998","Total",115,78,17,61,0,10,2,8,25,24,0,1,0,2
"2011","E00002000","E00002000","Total",101,63,17,46,0,2,1,1,36,35,0,1,0,0
"2011","E00002002","E00002002","Total",127,97,34,63,2,10,2,8,17,15,0,2,0,1
"2011","E00001977","E00001977","Total",137,117,61,56,1,7,1,6,12,12,0,0,0,0
"2011","E00001978","E00001978","Total",140,99,60,39,0,25,2,23,15,15,0,0,0,1
"2011","E00001982","E00001982","Total",123,101,72,29,6,5,0,5,10,10,0,0,0,1
"2011","E00001983","E00001983","Total",109,64,35,29,0,34,4,30,11,11,0,0,0,0
"2011","E00002005","E00002005","Total",121,106,63,43,0,0,0,0,14,12,0,2,0,1
"2011","E00001626","E00001626","Total",122,101,53,48,7,3,0,3,11,10,1,0,0,0
"2011","E00001630","E00001630","Total",136,104,45,59,0,7,1,6,25,23,0,2,0,0
"2011","E00001654","E00001654","Total",145,114,54,60,1,16,3,13,11,9,0,2,0,3
"2011","E00001656","E00001656","Total",115,102,54,48,0,2,1,1,11,11,0,0,0,0
"2011","E00001660","E00001660","Total",122,97,44,53,4,4,0,4,16,15,0,1,0,1
"2011","E00002038","E00002038","Total",142,129,74,55,1,4,0,4,5,4,0,1,0,3
"2011","E00002050","E00002050","Total",118,76,40,36,1,5,1,4,35,33,1,1,0,1
"2011","E00002052","E00002052","Total",166,53,30,23,22,63,13,50,26,24,0,2,0,2
"2011","E00002053","E00002053","Total",152,79,30,49,0,51,8,43,22,20,0,2,0,0
"2011","E00002054","E00002054","Total",135,117,61,56,0,13,0,13,3,3,0,0,0,2
"2011","E00002056","E00002056","Total",127,119,64,55,0,1,0,1,7,7,0,0,0,0
"2011","E00002057","E00002057","Total",102,93,38,55,0,4,1,3,5,5,0,0,0,0
"2011","E00002059","E00002059","Total",127,124,60,64,0,0,0,0,3,2,0,1,0,0
"2011","E00002060","E00002060","Total",117,110,66,44,0,1,0,1,5,5,0,0,0,1
"2011","E00002062","E00002062","Total",121,110,75,35,0,2,1,1,8,7,0,1,0,1
"2011","E00002039","E00002039","Total",132,110,58,52,0,8,1,7,14,13,0,1,0,0
"2011","E00002051","E00002051","Total",111,88,33,55,1,9,1,8,12,12,0,0,0,1
"2011","E00002055","E00002055","Total",134,115,71,44,1,1,0,1,16,15,0,1,0,1
"2011","E00002058","E00002058","Total",113,108,51,57,0,1,0,1,4,4,0,0,0,0
"2011","E00002063","E00002063","Total",114,110,57,53,1,1,0,1,2,0,0,2,0,0
"2011","E00002154","E00002154","Total",131,111,54,57,0,13,1,12,6,6,0,0,0,1
"2011","E00002155","E00002155","Total",113,77,40,37,0,31,4,27,4,2,0,0,2,1
"2011","E00002157","E00002157","Total",120,113,46,67,0,0,0,0,6,6,0,0,0,1
"2011","E00002159","E00002159","Total",129,110,73,37,0,2,1,1,15,11,0,4,0,2
"2011","E00002163","E00002163","Total",133,121,60,61,1,2,0,2,9,8,0,1,0,0
"2011","E00002160","E00002160","Total",109,97,30,67,3,2,1,1,6,6,0,0,0,1
"2011","E00002161","E00002161","Total",137,131,73,58,0,1,1,0,5,3,0,2,0,0
"2011","E00002162","E00002162","Total",126,115,66,49,1,6,1,5,3,3,0,0,0,1
"2011","E00002167","E00002167","Total",126,84,23,61,0,26,5,21,15,12,0,3,0,1
"2011","E00002156","E00002156","Total",113,96,48,48,0,2,0,2,15,14,0,1,0,0
"2011","E00002164","E00002164","Total",132,116,54,62,1,1,0,1,12,9,0,2,1,2
"2011","E00002166","E00002166","Total",119,103,28,75,0,2,0,2,11,9,0,2,0,3
"2011","E00002169","E00002169","Total",119,95,31,64,1,5,0,5,17,16,0,1,0,1
"2011","E00002171","E00002171","Total",116,93,36,57,2,3,0,3,17,17,0,0,0,1
"2011","E00002143","E00002143","Total",137,80,24,56,0,40,6,34,16,13,0,3,0,1
"2011","E00002158","E00002158","Total",117,76,27,49,1,7,0,7,33,33,0,0,0,0
"2011","E00002168","E00002168","Total",113,88,30,58,1,12,3,9,6,5,0,1,0,6
"2011","E00002174","E00002174","Total",129,96,40,56,1,1,0,1,30,29,0,1,0,1
"2011","E00002149","E00002149","Total",123,114,48,66,1,1,0,1,5,5,0,0,0,2
"2011","E00002150","E00002150","Total",117,110,58,52,0,1,0,1,4,3,0,1,0,2
"2011","E00002153","E00002153","Total",142,135,86,49,0,3,2,1,3,3,0,0,0,1
"2011","E00002172","E00002172","Total",135,125,69,56,0,3,0,3,5,3,0,2,0,2
"2011","E00002144","E00002144","Total",139,112,34,78,0,24,3,21,3,3,0,0,0,0
"2011","E00002145","E00002145","Total",143,79,20,59,4,43,5,38,16,15,0,0,1,1
"2011","E00002148","E00002148","Total",140,14,7,7,0,114,18,96,12,10,0,1,1,0
"2011","E00002151","E00002151","Total",117,96,49,47,1,2,0,2,14,13,0,1,0,4
"2011","E00002152","E00002152","Total",133,83,31,52,1,17,1,16,30,30,0,0,0,2
"2011","E00001821","E00001821","Total",162,10,4,6,0,142,49,93,9,9,0,0,0,1
"2011","E00001822","E00001822","Total",117,65,12,53,0,34,3,31,17,15,0,0,2,1
"2011","E00001826","E00001826","Total",132,14,7,7,0,106,22,84,6,5,0,1,0,6
"2011","E00001827","E00001827","Total",160,6,2,4,2,147,40,107,5,5,0,0,0,0
"2011","E00001828","E00001828","Total",117,5,2,3,0,105,19,86,3,3,0,0,0,4
"2011","E00002112","E00002112","Total",124,24,4,20,2,57,4,53,39,38,0,1,0,2
"2011","E00002114","E00002114","Total",120,28,4,24,0,29,6,23,63,61,0,1,1,0
"2011","E00002118","E00002118","Total",133,55,7,48,0,27,3,24,51,46,0,3,2,0
"2011","E00002139","E00002139","Total",101,63,14,49,1,11,3,8,26,23,0,3,0,0
"2011","E00002141","E00002141","Total",115,41,11,30,0,59,11,48,13,13,0,0,0,2
"2011","E00002142","E00002142","Total",126,49,6,43,0,28,0,28,49,45,0,2,2,0
"2011","E00002109","E00002109","Total",126,68,25,43,1,47,10,37,8,8,0,0,0,2
"2011","E00002111","E00002111","Total",129,86,11,75,2,13,2,11,27,26,0,1,0,1
"2011","E00002115","E00002115","Total",135,92,17,75,3,26,4,22,14,13,0,1,0,0
"2011","E00002117","E00002117","Total",150,108,21,87,0,11,0,11,30,29,0,1,0,1
"2011","E00002120","E00002120","Total",138,83,28,55,1,41,1,40,11,8,0,3,0,2
"2011","E00002108","E00002108","Total",135,72,30,42,1,52,11,41,7,7,0,0,0,3
"2011","E00002113","E00002113","Total",133,60,23,37,0,37,3,34,35,34,0,1,0,1
"2011","E00002119","E00002119","Total",165,6,0,6,0,149,33,116,8,7,0,1,0,2
"2011","E00002121","E00002121","Total",154,25,7,18,0,113,29,84,15,14,0,0,1,1
"2011","E00002140","E00002140","Total",94,69,10,59,1,12,0,12,10,9,0,1,0,2
"2011","E00002116","E00002116","Total",129,99,52,47,2,16,1,15,6,6,0,0,0,6
"2011","E00002122","E00002122","Total",133,105,45,60,2,17,5,12,9,9,0,0,0,0
"2011","E00002127","E00002127","Total",135,80,23,57,0,36,3,33,19,17,0,2,0,0
"2011","E00002129","E00002129","Total",125,52,17,35,0,57,7,50,15,13,0,1,1,1
"2011","E00002132","E00002132","Total",118,45,14,31,0,54,4,50,17,16,0,0,1,2
"2011","E00002126","E00002126","Total",162,83,32,51,1,58,11,47,19,19,0,0,0,1
"2011","E00002130","E00002130","Total",194,74,19,55,0,80,17,63,39,37,0,0,2,1
"2011","E00002131","E00002131","Total",134,87,32,55,0,40,11,29,6,5,0,1,0,1
"2011","E00002135","E00002135","Total",124,57,27,30,1,55,8,47,11,10,0,1,0,0
"2011","E00002138","E00002138","Total",106,31,10,21,0,66,23,43,6,5,0,1,0,3
"2011","E00002110","E00002110","Total",152,13,2,11,0,133,5,128,5,5,0,0,0,1
"2011","E00002123","E00002123","Total",127,7,2,5,0,110,4,106,9,8,0,0,1,1
"2011","E00002124","E00002124","Total",87,25,7,18,0,57,14,43,4,4,0,0,0,1
"2011","E00002125","E00002125","Total",119,66,25,41,1,36,7,29,16,16,0,0,0,0
"2011","E00002128","E00002128","Total",111,75,23,52,1,26,2,24,9,9,0,0,0,0
"2011","E00001729","E00001729","Total",131,119,65,54,0,1,0,1,11,9,0,2,0,0
"2011","E00001744","E00001744","Total",121,110,70,40,0,3,1,2,7,7,0,0,0,1
"2011","E00001753","E00001753","Total",131,124,88,36,0,0,0,0,6,5,0,1,0,1
"2011","E00001754","E00001754","Total",124,119,71,48,2,0,0,0,3,3,0,0,0,0
"2011","E00001760","E00001760","Total",121,84,41,43,0,2,0,2,32,32,0,0,0,3
"2011","E00001730","E00001730","Total",126,118,58,60,0,2,1,1,6,5,0,1,0,0
"2011","E00001735","E00001735","Total",126,123,55,68,0,1,1,0,2,2,0,0,0,0
"2011","E00001742","E00001742","Total",117,111,49,62,0,1,0,1,5,4,0,1,0,0
"2011","E00001752","E00001752","Total",119,105,46,59,0,3,0,3,10,9,0,1,0,1
"2011","E00001728","E00001728","Total",124,114,58,56,0,1,1,0,8,7,0,0,1,1
"2011","E00001733","E00001733","Total",124,119,57,62,0,1,0,1,3,3,0,0,0,1
"2011","E00001734","E00001734","Total",125,114,57,57,0,1,1,0,8,7,0,0,1,2
"2011","E00001736","E00001736","Total",115,106,55,51,0,1,0,1,8,7,0,1,0,0
"2011","E00002061","E00002061","Total",123,118,60,58,0,0,0,0,4,4,0,0,0,1
"2011","E00002064","E00002064","Total",121,115,90,25,1,1,0,1,3,2,0,1,0,1
"2011","E00002065","E00002065","Total",110,105,43,62,0,0,0,0,5,5,0,0,0,0
"2011","E00002066","E00002066","Total",139,135,59,76,0,1,0,1,3,1,0,2,0,0
"2011","E00002067","E00002067","Total",110,107,93,14,1,1,0,1,1,0,0,1,0,0
"2011","E00002224","E00002224","Total",135,107,46,61,1,20,2,18,7,6,0,1,0,0
"2011","E00002225","E00002225","Total",117,52,19,33,1,51,5,46,11,10,0,1,0,2
"2011","E00002226","E00002226","Total",131,85,29,56,1,35,6,29,10,9,0,1,0,0
"2011","E00002227","E00002227","Total",133,126,68,58,0,1,0,1,6,4,0,2,0,0
"2011","E00002228","E00002228","Total",129,95,28,67,8,17,3,14,9,9,0,0,0,0
"2011","E00002209","E00002209","Total",118,115,49,66,0,1,1,0,2,2,0,0,0,0
"2011","E00002229","E00002229","Total",122,111,34,77,1,4,0,4,6,6,0,0,0,0
"2011","E00002230","E00002230","Total",133,126,51,75,0,0,0,0,6,5,0,1,0,1
"2011","E00002231","E00002231","Total",121,112,45,67,0,1,1,0,7,7,0,0,0,1
"2011","E00002232","E00002232","Total",127,109,35,74,1,4,0,4,13,13,0,0,0,0
"2011","E00002210","E00002210","Total",111,104,43,61,1,2,1,1,3,1,0,2,0,1
"2011","E00002233","E00002233","Total",118,108,34,74,0,0,0,0,10,8,0,2,0,0
"2011","E00002234","E00002234","Total",118,114,49,65,0,1,0,1,1,0,0,1,0,2
"2011","E00002235","E00002235","Total",148,132,38,94,1,6,0,6,8,6,0,1,1,1
"2011","E00001799","E00001799","Total",121,78,42,36,0,38,3,35,5,5,0,0,0,0
"2011","E00001801","E00001801","Total",138,56,19,37,1,71,11,60,7,7,0,0,0,3
"2011","E00001804","E00001804","Total",91,47,17,30,25,3,0,3,15,14,0,1,0,1
"2011","E00001824","E00001824","Total",126,91,36,55,1,24,5,19,9,9,0,0,0,1
"2011","E00001829","E00001829","Total",129,69,40,29,0,53,12,41,7,5,0,2,0,0
"2011","E00001802","E00001802","Total",132,52,18,34,2,76,1,75,1,1,0,0,0,1
"2011","E00001805","E00001805","Total",118,76,32,44,2,31,1,30,9,6,1,2,0,0
"2011","E00001808","E00001808","Total",125,56,23,33,1,61,6,55,6,6,0,0,0,1
"2011","E00001813","E00001813","Total",123,61,15,46,0,58,9,49,4,3,0,1,0,0
"2011","E00001814","E00001814","Total",134,71,13,58,5,35,7,28,22,20,0,2,0,1
"2011","E00001819","E00001819","Total",134,107,49,58,1,13,2,11,13,11,0,2,0,0
"2011","E00001820","E00001820","Total",117,106,52,54,1,8,2,6,2,2,0,0,0,0
"2011","E00001823","E00001823","Total",105,42,13,29,2,51,14,37,9,9,0,0,0,1
"2011","E00001825","E00001825","Total",116,50,13,37,0,56,10,46,7,5,0,1,1,3
"2011","E00001830","E00001830","Total",121,40,8,32,0,75,12,63,4,4,0,0,0,2
"2011","E00001831","E00001831","Total",131,99,31,68,0,3,0,3,28,27,0,0,1,1
"2011","E00001858","E00001858","Total",132,3,1,2,0,125,1,124,3,3,0,0,0,1
"2011","E00001859","E00001859","Total",112,79,30,49,2,6,2,4,25,24,0,1,0,0
"2011","E00001860","E00001860","Total",137,28,7,21,28,76,1,75,3,2,0,1,0,2
"2011","E00001861","E00001861","Total",113,58,13,45,17,27,1,26,11,11,0,0,0,0
"2011","E00001863","E00001863","Total",133,38,10,28,0,80,2,78,10,10,0,0,0,5
"2011","E00002133","E00002133","Total",145,132,71,61,0,3,0,3,9,8,0,1,0,1
"2011","E00002134","E00002134","Total",174,43,23,20,0,119,17,102,11,9,0,0,2,1
"2011","E00002136","E00002136","Total",140,101,27,74,1,6,0,6,32,28,0,4,0,0
"2011","E00002137","E00002137","Total",138,69,27,42,2,51,6,45,15,12,0,2,1,1
"2011","E00001740","E00001740","Total",125,119,57,62,0,2,1,1,4,4,0,0,0,0
"2011","E00001741","E00001741","Total",132,130,65,65,0,0,0,0,1,1,0,0,0,1
"2011","E00001743","E00001743","Total",129,127,82,45,0,0,0,0,2,2,0,0,0,0
"2011","E00001747","E00001747","Total",129,126,81,45,1,0,0,0,1,0,0,1,0,1
"2011","E00001748","E00001748","Total",147,137,84,53,1,4,2,2,4,3,0,1,0,1
"2011","E00001732","E00001732","Total",121,108,50,58,0,11,0,11,2,2,0,0,0,0
"2011","E00001737","E00001737","Total",119,84,44,40,0,23,0,23,11,10,0,1,0,1
"2011","E00001738","E00001738","Total",129,71,17,54,1,46,8,38,9,8,0,1,0,2
"2011","E00001745","E00001745","Total",115,112,61,51,0,0,0,0,2,2,0,0,0,1
"2011","E00001750","E00001750","Total",139,64,17,47,0,57,11,46,16,15,0,1,0,2
"2011","E00001739","E00001739","Total",108,104,48,56,1,1,0,1,2,2,0,0,0,0
"2011","E00001746","E00001746","Total",117,113,58,55,0,1,0,1,3,3,0,0,0,0
"2011","E00001749","E00001749","Total",139,128,83,45,0,1,0,1,8,6,0,2,0,2
"2011","E00001751","E00001751","Total",126,118,58,60,1,2,0,2,4,4,0,0,0,1
"2011","E00001755","E00001755","Total",123,116,76,40,0,1,1,0,4,4,0,0,0,2
"2011","E00001731","E00001731","Total",140,129,62,67,0,1,0,1,10,10,0,0,0,0
"2011","E00001756","E00001756","Total",136,117,60,57,1,2,1,1,16,15,0,1,0,0
"2011","E00001757","E00001757","Total",113,80,36,44,0,11,1,10,18,17,0,1,0,4
"2011","E00001758","E00001758","Total",139,132,74,58,1,0,0,0,6,5,0,1,0,0
"2011","E00001759","E00001759","Total",131,119,76,43,1,2,0,2,7,6,0,1,0,2
"2011","E00002146","E00002146","Total",114,90,40,50,0,1,0,1,23,22,0,0,1,0
"2011","E00002147","E00002147","Total",130,126,70,56,0,2,0,2,1,1,0,0,0,1
"2011","E00002165","E00002165","Total",119,113,61,52,0,3,0,3,3,3,0,0,0,0
"2011","E00002170","E00002170","Total",127,118,56,62,0,4,0,4,5,5,0,0,0,0
"2011","E00002173","E00002173","Total",125,115,52,63,0,1,0,1,9,9,0,0,0,0
"2011","E00001957","E00001957","Total",116,87,40,47,3,21,6,15,5,4,0,1,0,0
"2011","E00001959","E00001959","Total",144,98,35,63,1,17,2,15,26,23,0,3,0,2
"2011","E00001962","E00001962","Total",125,69,28,41,0,47,5,42,8,7,0,1,0,1
"2011","E00001963","E00001963","Total",130,70,23,47,2,13,1,12,42,38,0,4,0,3
"2011","E00001965","E00001965","Total",122,69,29,40,0,43,6,37,10,8,0,2,0,0
"2011","E00002208","E00002208","Total",135,128,48,80,0,0,0,0,7,7,0,0,0,0
"2011","E00002214","E00002214","Total",110,91,33,58,0,2,1,1,15,11,0,4,0,2
"2011","E00002237","E00002237","Total",129,120,45,75,0,2,0,2,7,6,0,1,0,0
"2011","E00002239","E00002239","Total",139,130,67,63,0,1,0,1,6,6,0,0,0,2
"2011","E00002211","E00002211","Total",138,129,43,86,0,2,0,2,6,6,0,0,0,1
"2011","E00002212","E00002212","Total",119,63,28,35,2,45,2,43,7,5,0,1,1,2
"2011","E00002213","E00002213","Total",123,102,31,71,0,10,2,8,9,9,0,0,0,2
"2011","E00002236","E00002236","Total",118,46,19,27,0,58,8,50,13,13,0,0,0,1
"2011","E00002238","E00002238","Total",130,121,55,66,1,2,1,1,6,6,0,0,0,0
"2011","E00002215","E00002215","Total",103,92,47,45,2,3,0,3,5,5,0,0,0,1
"2011","E00002217","E00002217","Total",119,107,48,59,1,1,0,1,10,9,0,1,0,0
"2011","E00002220","E00002220","Total",122,113,49,64,0,2,1,1,6,6,0,0,0,1
"2011","E00002222","E00002222","Total",148,129,55,74,0,1,0,1,16,15,0,1,0,2
"2011","E00002223","E00002223","Total",113,101,53,48,0,1,0,1,9,7,0,2,0,2
"2011","E00002216","E00002216","Total",120,112,58,54,1,1,0,1,6,5,0,1,0,0
"2011","E00002218","E00002218","Total",128,121,54,67,2,1,0,1,4,4,0,0,0,0
"2011","E00002219","E00002219","Total",125,114,51,63,0,3,2,1,7,7,0,0,0,1
"2011","E00002221","E00002221","Total",114,108,40,68,0,0,0,0,5,5,0,0,0,1
"2011","E00001592","E00001592","Total",119,111,46,65,0,0,0,0,6,6,0,0,0,2
"2011","E00001601","E00001601","Total",111,104,48,56,0,1,0,1,6,5,0,0,1,0
"2011","E00001606","E00001606","Total",129,110,57,53,0,2,1,1,16,14,0,2,0,1
"2011","E00001610","E00001610","Total",114,110,57,53,0,1,0,1,3,2,0,1,0,0
"2011","E00001615","E00001615","Total",110,107,63,44,0,1,1,0,2,1,0,1,0,0
"2011","E00001604","E00001604","Total",125,101,25,76,2,2,0,2,20,17,0,3,0,0
"2011","E00001605","E00001605","Total",133,116,39,77,1,2,0,2,14,14,0,0,0,0
"2011","E00001607","E00001607","Total",141,126,45,81,1,3,2,1,10,9,0,1,0,1
"2011","E00001608","E00001608","Total",145,128,45,83,1,1,1,0,15,14,0,1,0,0
"2011","E00001796","E00001796","Total",127,117,49,68,0,1,0,1,6,6,0,0,0,3
"2011","E00001797","E00001797","Total",130,113,52,61,1,2,0,2,14,14,0,0,0,0
"2011","E00001800","E00001800","Total",120,103,43,60,2,1,0,1,14,13,0,1,0,0
"2011","E00001803","E00001803","Total",125,73,28,45,2,39,9,30,11,11,0,0,0,0
"2011","E00001807","E00001807","Total",124,120,58,62,0,0,0,0,4,3,0,1,0,0
"2011","E00001798","E00001798","Total",119,111,64,47,1,0,0,0,6,5,0,1,0,1
"2011","E00001806","E00001806","Total",131,101,48,53,3,6,2,4,21,18,0,3,0,0
"2011","E00001811","E00001811","Total",127,122,71,51,0,2,1,1,2,2,0,0,0,1
"2011","E00001815","E00001815","Total",144,108,43,65,2,28,3,25,5,4,0,1,0,1
"2011","E00001817","E00001817","Total",128,85,38,47,1,25,8,17,17,16,0,1,0,0
"2011","E00001809","E00001809","Total",121,115,59,56,0,0,0,0,5,5,0,0,0,1
"2011","E00001810","E00001810","Total",140,135,54,81,1,0,0,0,3,2,0,1,0,1
"2011","E00001812","E00001812","Total",121,107,48,59,0,2,0,2,9,6,0,3,0,3
"2011","E00001816","E00001816","Total",112,97,46,51,0,0,0,0,14,14,0,0,0,1
"2011","E00001818","E00001818","Total",140,112,29,83,0,9,0,9,18,11,0,6,1,1
"2011","E00001767","E00001767","Total",131,100,44,56,0,2,0,2,25,24,0,1,0,4
"2011","E00001768","E00001768","Total",118,78,30,48,0,3,0,3,36,34,0,1,1,1
"2011","E00001773","E00001773","Total",150,77,26,51,0,1,0,1,69,66,0,3,0,3
"2011","E00001776","E00001776","Total",143,85,29,56,1,1,1,0,53,52,0,1,0,3
"2011","E00001778","E00001778","Total",120,107,45,62,0,1,0,1,11,10,0,1,0,1
"2011","E00001774","E00001774","Total",118,103,49,54,0,3,1,2,11,11,0,0,0,1
"2011","E00001782","E00001782","Total",132,96,62,34,0,23,6,17,8,5,0,3,0,5
"2011","E00001783","E00001783","Total",114,106,65,41,0,2,1,1,6,4,0,2,0,0
"2011","E00001785","E00001785","Total",126,116,60,56,0,0,0,0,9,8,0,1,0,1
"2011","E00001787","E00001787","Total",136,126,75,51,0,2,0,2,8,6,0,2,0,0
"2011","E00001765","E00001765","Total",132,108,53,55,0,2,0,2,20,18,1,1,0,2
"2011","E00001770","E00001770","Total",140,110,65,45,0,2,1,1,26,24,0,2,0,2
"2011","E00001771","E00001771","Total",138,65,29,36,0,29,5,24,43,38,0,4,1,1
"2011","E00001793","E00001793","Total",165,153,81,72,0,1,0,1,10,8,0,2,0,1
"2011","E00001795","E00001795","Total",125,100,48,52,0,2,2,0,23,22,0,1,0,0
"2011","E00001764","E00001764","Total",128,112,50,62,0,2,0,2,13,13,0,0,0,1
"2011","E00001766","E00001766","Total",126,110,46,64,0,3,0,3,9,7,0,2,0,4
"2011","E00001769","E00001769","Total",107,87,38,49,1,1,0,1,17,17,0,0,0,1
"2011","E00001772","E00001772","Total",149,91,33,58,7,16,0,16,33,30,1,2,0,2
"2011","E00001794","E00001794","Total",145,129,51,78,2,0,0,0,14,14,0,0,0,0
"2011","E00001905","E00001905","Total",129,105,55,50,0,0,0,0,23,19,0,4,0,1
"2011","E00001908","E00001908","Total",125,112,62,50,0,2,0,2,11,9,0,2,0,0
"2011","E00001932","E00001932","Total",114,93,57,36,1,0,0,0,20,17,0,3,0,0
"2011","E00001933","E00001933","Total",129,77,38,39,1,34,0,34,15,14,0,1,0,2
"2011","E00001936","E00001936","Total",127,112,49,63,1,0,0,0,13,10,0,3,0,1
"2011","E00001904","E00001904","Total",130,111,71,40,9,0,0,0,10,4,0,6,0,0
"2011","E00001911","E00001911","Total",134,126,67,59,0,1,0,1,6,6,0,0,0,1
"2011","E00001914","E00001914","Total",125,117,55,62,0,2,1,1,5,3,0,2,0,1
"2011","E00001915","E00001915","Total",109,97,61,36,0,7,0,7,5,5,0,0,0,0
"2011","E00001918","E00001918","Total",123,115,61,54,1,2,0,2,4,3,1,0,0,1
"2011","E00001907","E00001907","Total",171,50,24,26,3,46,6,40,65,63,0,1,1,7
"2011","E00001910","E00001910","Total",144,54,17,37,0,49,2,47,41,39,0,1,1,0
"2011","E00001929","E00001929","Total",125,92,22,70,0,4,2,2,29,29,0,0,0,0
"2011","E00001930","E00001930","Total",123,110,50,60,1,0,0,0,12,12,0,0,0,0
"2011","E00001935","E00001935","Total",132,28,8,20,0,87,8,79,14,12,0,2,0,3
"2011","E00002013","E00002013","Total",136,128,68,60,0,1,0,1,3,3,0,0,0,4
"2011","E00002018","E00002018","Total",139,129,58,71,0,2,0,2,7,4,0,3,0,1
"2011","E00002023","E00002023","Total",129,122,51,71,0,0,0,0,7,7,0,0,0,0
"2011","E00002025","E00002025","Total",114,106,36,70,1,0,0,0,7,7,0,0,0,0
"2011","E00002026","E00002026","Total",131,121,56,65,2,2,1,1,6,6,0,0,0,0
"2011","E00002007","E00002007","Total",138,125,55,70,1,1,0,1,10,10,0,0,0,1
"2011","E00002027","E00002027","Total",140,134,45,89,0,0,0,0,6,6,0,0,0,0
"2011","E00002028","E00002028","Total",133,121,57,64,0,1,0,1,11,9,0,2,0,0
"2011","E00002031","E00002031","Total",140,128,59,69,0,3,1,2,8,7,0,1,0,1
"2011","E00002009","E00002009","Total",129,98,42,56,1,2,0,2,27,27,0,0,0,1
"2011","E00002010","E00002010","Total",162,100,45,55,8,11,0,11,40,39,0,1,0,3
"2011","E00002014","E00002014","Total",135,116,66,50,2,1,1,0,15,15,0,0,0,1
"2011","E00002036","E00002036","Total",127,103,72,31,2,1,0,1,19,16,1,1,1,2
"2011","E00002037","E00002037","Total",121,82,36,46,1,1,0,1,36,31,1,3,1,1
"2011","E00002008","E00002008","Total",126,120,65,55,0,2,1,1,4,4,0,0,0,0
"2011","E00002011","E00002011","Total",115,109,58,51,0,2,1,1,4,4,0,0,0,0
"2011","E00002012","E00002012","Total",139,134,66,68,0,0,0,0,4,4,0,0,0,1
"2011","E00002015","E00002015","Total",132,123,52,71,0,3,1,2,5,5,0,0,0,1
"2011","E00001602","E00001602","Total",118,112,60,52,0,2,0,2,2,2,0,0,0,2
"2011","E00001603","E00001603","Total",130,113,52,61,2,4,0,4,8,7,0,1,0,3
"2011","E00001609","E00001609","Total",109,73,33,40,0,23,3,20,13,11,0,2,0,0
"2011","E00001611","E00001611","Total",131,125,69,56,0,1,0,1,5,4,0,1,0,0
"2011","E00001614","E00001614","Total",116,110,64,46,1,2,0,2,3,3,0,0,0,0
"2011","E00001595","E00001595","Total",108,76,32,44,0,24,2,22,8,7,0,1,0,0
"2011","E00001597","E00001597","Total",119,99,46,53,0,5,0,5,13,13,0,0,0,2
"2011","E00001613","E00001613","Total",125,117,49,68,0,3,1,2,4,3,0,1,0,1
"2011","E00001619","E00001619","Total",124,117,60,57,0,4,1,3,2,1,0,1,0,1
"2011","E00001624","E00001624","Total",120,112,61,51,0,2,0,2,4,4,0,0,0,2
"2011","E00001594","E00001594","Total",123,103,49,54,0,16,2,14,4,4,0,0,0,0
"2011","E00001596","E00001596","Total",138,65,25,40,0,52,7,45,18,14,3,0,1,3
"2011","E00001618","E00001618","Total",120,103,59,44,0,2,0,2,14,12,0,2,0,1
"2011","E00001622","E00001622","Total",136,110,61,49,0,13,1,12,13,10,0,3,0,0
"2011","E00001612","E00001612","Total",133,106,38,68,1,5,0,5,19,17,0,1,1,2
"2011","E00001616","E00001616","Total",130,94,39,55,1,20,1,19,14,13,0,1,0,1
"2011","E00001617","E00001617","Total",133,119,86,33,0,3,1,2,11,9,1,1,0,0
"2011","E00001620","E00001620","Total",133,101,57,44,0,4,0,4,26,24,0,2,0,2
"2011","E00001621","E00001621","Total",116,64,27,37,0,32,2,30,18,18,0,0,0,2
"2011","E00001623","E00001623","Total",127,53,21,32,1,50,2,48,22,20,0,1,1,1
"2011","E00001591","E00001591","Total",130,53,22,31,0,66,7,59,11,10,0,0,1,0
"2011","E00001593","E00001593","Total",107,77,32,45,0,21,3,18,9,8,0,1,0,0
"2011","E00001598","E00001598","Total",129,107,38,69,0,13,2,11,7,7,0,0,0,2
"2011","E00001599","E00001599","Total",120,69,31,38,0,41,11,30,7,6,0,1,0,3
"2011","E00001600","E00001600","Total",131,97,51,46,0,30,3,27,3,3,0,0,0,1
"2011","E00001685","E00001685","Total",132,121,52,69,4,0,0,0,6,6,0,0,0,1
"2011","E00001686","E00001686","Total",118,114,54,60,0,1,0,1,2,1,0,1,0,1
"2011","E00001687","E00001687","Total",128,115,59,56,2,4,0,4,5,4,0,1,0,2
"2011","E00001688","E00001688","Total",112,94,64,30,1,0,0,0,14,11,0,3,0,3
"2011","E00001692","E00001692","Total",129,102,39,63,1,0,0,0,24,22,1,1,0,2
"2011","E00001955","E00001955","Total",125,115,56,59,0,0,0,0,6,5,0,1,0,4
"2011","E00001969","E00001969","Total",115,108,54,54,0,1,1,0,6,5,0,1,0,0
"2011","E00001970","E00001970","Total",135,127,55,72,0,0,0,0,8,8,0,0,0,0
"2011","E00001971","E00001971","Total",124,121,63,58,0,0,0,0,2,0,0,2,0,1
"2011","E00001938","E00001938","Total",138,132,66,66,0,0,0,0,6,5,0,1,0,0
"2011","E00001939","E00001939","Total",115,109,51,58,1,0,0,0,5,4,0,1,0,0
"2011","E00001940","E00001940","Total",123,111,45,66,1,0,0,0,10,9,0,1,0,1
"2011","E00001941","E00001941","Total",131,119,50,69,4,0,0,0,7,6,0,1,0,1
"2011","E00002006","E00002006","Total",109,103,44,59,0,2,0,2,4,4,0,0,0,0
"2011","E00002017","E00002017","Total",134,123,47,76,1,0,0,0,9,9,0,0,0,1
"2011","E00002020","E00002020","Total",117,112,52,60,0,1,0,1,4,4,0,0,0,0
"2011","E00002021","E00002021","Total",122,88,45,43,1,1,0,1,30,30,0,0,0,2
"2011","E00002030","E00002030","Total",112,105,38,67,0,0,0,0,7,5,0,2,0,0
"2011","E00002016","E00002016","Total",129,121,42,79,1,0,0,0,5,5,0,0,0,2
"2011","E00002019","E00002019","Total",140,116,47,69,0,1,0,1,23,23,0,0,0,0
"2011","E00002022","E00002022","Total",104,70,35,35,0,2,0,2,29,28,0,1,0,3
"2011","E00002024","E00002024","Total",134,123,49,74,2,0,0,0,8,7,0,1,0,1
"2011","E00002029","E00002029","Total",125,121,45,76,1,0,0,0,3,2,0,1,0,0
"2011","E00002032","E00002032","Total",129,111,50,61,3,0,0,0,15,12,0,3,0,0
"2011","E00002033","E00002033","Total",121,112,45,67,0,1,0,1,7,5,0,2,0,1
"2011","E00002034","E00002034","Total",140,112,42,70,0,3,1,2,22,17,0,5,0,3
"2011","E00002035","E00002035","Total",115,109,39,70,0,0,0,0,6,6,0,0,0,0
"2011","E00001836","E00001836","Total",162,99,28,71,1,52,11,41,8,6,0,2,0,2
"2011","E00001862","E00001862","Total",134,51,15,36,1,75,21,54,7,6,0,0,1,0
"2011","E00001864","E00001864","Total",114,79,26,53,0,28,10,18,6,6,0,0,0,1
"2011","E00001865","E00001865","Total",124,54,16,38,0,64,15,49,6,5,0,0,1,0
"2011","E00001842","E00001842","Total",122,101,36,65,1,6,0,6,14,14,0,0,0,0
"2011","E00001844","E00001844","Total",123,103,38,65,1,10,1,9,9,8,0,1,0,0
"2011","E00001851","E00001851","Total",101,76,30,46,0,17,5,12,7,6,0,1,0,1
"2011","E00001852","E00001852","Total",113,52,16,36,2,52,9,43,7,7,0,0,0,0
"2011","E00001856","E00001856","Total",106,62,23,39,0,37,7,30,7,7,0,0,0,0
"2011","E00001832","E00001832","Total",116,106,43,63,1,3,0,3,5,3,0,2,0,1
"2011","E00001837","E00001837","Total",126,108,37,71,1,8,1,7,8,7,0,1,0,1
"2011","E00001838","E00001838","Total",128,108,44,64,0,3,1,2,17,14,0,3,0,0
"2011","E00001840","E00001840","Total",111,94,37,57,1,2,0,2,14,13,1,0,0,0
"2011","E00001866","E00001866","Total",125,54,19,35,0,57,16,41,11,9,0,1,1,3
"2011","E00001833","E00001833","Total",122,106,59,47,1,6,2,4,9,8,0,0,1,0
"2011","E00001835","E00001835","Total",143,119,39,80,1,2,0,2,20,19,0,1,0,1
"2011","E00001839","E00001839","Total",118,100,40,60,0,2,0,2,14,13,0,1,0,2
"2011","E00001841","E00001841","Total",140,125,65,60,0,4,1,3,10,7,0,3,0,1
"2011","E00001843","E00001843","Total",126,93,41,52,1,25,1,24,6,4,0,2,0,1
"2011","E00001845","E00001845","Total",133,125,92,33,1,5,1,4,1,1,0,0,0,1
"2011","E00001846","E00001846","Total",132,87,38,49,1,6,1,5,34,33,0,1,0,4
"2011","E00001847","E00001847","Total",156,83,28,55,0,37,10,27,34,32,0,1,1,2
"2011","E00001848","E00001848","Total",100,35,9,26,0,8,1,7,51,46,0,5,0,6
"2011","E00001849","E00001849","Total",124,48,18,30,0,61,14,47,15,15,0,0,0,0
"2011","E00166760","E00166760","Total",110,73,19,54,0,24,2,22,13,13,0,0,0,0
"2011","E00166761","E00166761","Total",104,75,14,61,1,2,0,2,26,22,0,4,0,0
"2011","E00166762","E00166762","Total",109,104,21,83,0,1,0,1,3,3,0,0,0,1
"2011","E00001834","E00001834","Total",182,160,51,109,2,4,0,4,15,14,0,1,0,1
"2011","E00001853","E00001853","Total",135,117,60,57,0,5,2,3,13,12,0,1,0,0
"2011","E00001854","E00001854","Total",109,51,14,37,0,44,6,38,14,14,0,0,0,0
"2011","E00001855","E00001855","Total",114,70,29,41,0,40,7,33,4,4,0,0,0,0
"2011","E00001857","E00001857","Total",123,90,36,54,0,25,2,23,8,8,0,0,0,0
"2011","E00001700","E00001700","Total",130,125,57,68,0,0,0,0,2,2,0,0,0,3
"2011","E00001716","E00001716","Total",138,131,48,83,0,2,0,2,5,5,0,0,0,0
"2011","E00001719","E00001719","Total",117,113,52,61,1,0,0,0,2,2,0,0,0,1
"2011","E00001725","E00001725","Total",138,131,58,73,0,2,0,2,5,5,0,0,0,0
"2011","E00001695","E00001695","Total",142,134,60,74,0,1,0,1,6,6,0,0,0,1
"2011","E00001712","E00001712","Total",121,113,52,61,0,2,1,1,6,6,0,0,0,0
"2011","E00001713","E00001713","Total",120,105,58,47,0,1,1,0,14,11,0,3,0,0
"2011","E00001715","E00001715","Total",129,123,61,62,0,1,0,1,5,5,0,0,0,0
"2011","E00001726","E00001726","Total",138,126,68,58,0,4,0,4,5,2,1,2,0,3
"2011","E00001761","E00001761","Total",102,97,43,54,0,0,0,0,5,5,0,0,0,0
"2011","E00001775","E00001775","Total",136,113,66,47,0,1,0,1,20,20,0,0,0,2
"2011","E00001777","E00001777","Total",131,107,46,61,0,2,1,1,21,19,0,1,1,1
"2011","E00001779","E00001779","Total",126,96,31,65,1,13,0,13,15,11,0,4,0,1
"2011","E00001789","E00001789","Total",107,83,27,56,0,16,0,16,7,7,0,0,0,1
"2011","E00001780","E00001780","Total",101,86,49,37,0,1,0,1,14,13,0,1,0,0
"2011","E00001781","E00001781","Total",115,101,45,56,0,3,0,3,11,10,1,0,0,0
"2011","E00001784","E00001784","Total",114,96,50,46,0,0,0,0,18,15,0,3,0,0
"2011","E00001788","E00001788","Total",116,111,53,58,0,0,0,0,5,4,0,1,0,0
"2011","E00001790","E00001790","Total",119,109,58,51,0,3,0,3,7,7,0,0,0,0
"2011","E00001906","E00001906","Total",143,134,64,70,0,0,0,0,9,8,0,1,0,0
"2011","E00001912","E00001912","Total",204,165,62,103,17,13,0,13,8,8,0,0,0,1
"2011","E00001916","E00001916","Total",100,24,12,12,0,64,2,62,12,11,0,1,0,0
"2011","E00001917","E00001917","Total",143,99,55,44,0,4,2,2,40,38,0,2,0,0
"2011","E00001920","E00001920","Total",124,116,69,47,0,1,0,1,6,6,0,0,0,1
"2011","E00001922","E00001922","Total",132,110,51,59,1,11,3,8,9,8,0,1,0,1
"2011","E00001926","E00001926","Total",128,119,67,52,1,3,0,3,5,4,0,1,0,0
"2011","E00001927","E00001927","Total",131,119,55,64,1,2,0,2,8,8,0,0,0,1
"2011","E00001928","E00001928","Total",124,104,57,47,0,13,0,13,7,7,0,0,0,0
"2011","E00001909","E00001909","Total",140,126,44,82,3,1,0,1,7,4,1,2,0,3
"2011","E00001913","E00001913","Total",114,92,38,54,0,3,0,3,17,15,0,2,0,2
"2011","E00001931","E00001931","Total",123,114,56,58,1,2,0,2,5,5,0,0,0,1
"2011","E00001934","E00001934","Total",124,106,44,62,1,3,0,3,13,10,0,3,0,1
"2011","E00001937","E00001937","Total",139,97,40,57,1,3,1,2,34,32,0,2,0,4
"2011","E00001697","E00001697","Total",112,108,65,43,0,2,0,2,2,2,0,0,0,0
"2011","E00001708","E00001708","Total",127,111,51,60,0,1,0,1,15,15,0,0,0,0
"2011","E00001720","E00001720","Total",123,116,50,66,1,0,0,0,5,2,0,3,0,1
"2011","E00001724","E00001724","Total",136,131,45,86,0,1,0,1,4,4,0,0,0,0
"2011","E00001727","E00001727","Total",127,114,35,79,0,2,0,2,11,9,0,1,1,0
"2011","E00001696","E00001696","Total",136,127,58,69,0,2,1,1,7,6,0,1,0,0
"2011","E00001705","E00001705","Total",108,75,26,49,1,3,1,2,28,28,0,0,0,1
"2011","E00001710","E00001710","Total",119,80,42,38,0,30,1,29,8,8,0,0,0,1
"2011","E00001711","E00001711","Total",120,110,37,73,1,1,0,1,8,8,0,0,0,0
"2011","E00001722","E00001722","Total",135,121,54,67,1,1,0,1,12,12,0,0,0,0
"2011","E00001699","E00001699","Total",122,115,57,58,0,0,0,0,7,5,0,1,1,0
"2011","E00001701","E00001701","Total",118,111,59,52,0,2,0,2,5,5,0,0,0,0
"2011","E00001714","E00001714","Total",147,130,55,75,2,1,0,1,14,12,0,2,0,0
"2011","E00001723","E00001723","Total",134,102,45,57,0,4,0,4,27,23,1,2,1,1
"2011","E00001704","E00001704","Total",137,120,56,64,0,6,0,6,10,10,0,0,0,1
"2011","E00001706","E00001706","Total",132,79,29,50,1,31,6,25,19,19,0,0,0,2
"2011","E00001707","E00001707","Total",137,103,42,61,4,4,1,3,26,25,0,1,0,0
"2011","E00001709","E00001709","Total",145,122,44,78,1,0,0,0,22,21,0,1,0,0
"2011","E00001717","E00001717","Total",125,99,44,55,1,3,0,3,18,17,0,1,0,4
"2011","E00001919","E00001919","Total",132,118,49,69,1,1,0,1,11,11,0,0,0,1
"2011","E00001921","E00001921","Total",121,109,43,66,0,1,0,1,9,7,0,2,0,2
"2011","E00001923","E00001923","Total",137,127,56,71,1,0,0,0,8,8,0,0,0,1
"2011","E00001924","E00001924","Total",119,97,38,59,0,11,1,10,9,8,0,1,0,2
"2011","E00001925","E00001925","Total",135,96,33,63,1,28,6,22,10,9,0,1,0,0
"2011","E00001664","E00001664","Total",138,122,57,65,0,3,0,3,12,11,0,1,0,1
"2011","E00001665","E00001665","Total",128,120,60,60,0,2,0,2,6,4,0,2,0,0
"2011","E00001672","E00001672","Total",112,107,57,50,0,0,0,0,5,5,0,0,0,0
"2011","E00001690","E00001690","Total",111,96,53,43,1,3,0,3,11,10,0,1,0,0
"2011","E00001693","E00001693","Total",121,116,61,55,0,1,0,1,4,4,0,0,0,0
"2011","E00001666","E00001666","Total",144,139,52,87,1,0,0,0,4,4,0,0,0,0
"2011","E00001668","E00001668","Total",131,119,49,70,0,0,0,0,11,9,0,2,0,1
"2011","E00001669","E00001669","Total",136,131,57,74,0,1,1,0,4,4,0,0,0,0
"2011","E00001670","E00001670","Total",95,88,33,55,0,0,0,0,4,3,0,1,0,3
"2011","E00001671","E00001671","Total",138,91,31,60,5,3,1,2,37,33,0,3,1,2
"2011","E00001674","E00001674","Total",134,115,50,65,0,0,0,0,17,16,0,0,1,2
"2011","E00001689","E00001689","Total",135,126,46,80,0,1,0,1,8,8,0,0,0,0
"2011","E00001691","E00001691","Total",134,100,49,51,2,0,0,0,30,29,1,0,0,2
"2011","E00001694","E00001694","Total",147,142,62,80,0,2,0,2,2,2,0,0,0,1
"2011","E00001662","E00001662","Total",121,109,41,68,0,2,1,1,10,9,0,1,0,0
"2011","E00001673","E00001673","Total",118,110,45,65,2,0,0,0,5,5,0,0,0,1
"2011","E00001675","E00001675","Total",111,97,32,65,1,0,0,0,13,12,0,1,0,0
"2011","E00001678","E00001678","Total",137,132,66,66,0,0,0,0,4,4,0,0,0,1
"2011","E00002268","E00002268","Total",114,95,41,54,1,2,0,2,15,14,0,1,0,1
"2011","E00002269","E00002269","Total",127,120,71,49,0,2,0,2,5,5,0,0,0,0
"2011","E00002270","E00002270","Total",126,118,55,63,0,1,0,1,7,6,0,1,0,0
"2011","E00002273","E00002273","Total",131,113,36,77,0,0,0,0,18,16,0,2,0,0
"2011","E00001762","E00001762","Total",123,115,78,37,0,3,0,3,5,5,0,0,0,0
"2011","E00001763","E00001763","Total",141,126,71,55,0,2,1,1,11,10,0,1,0,2
"2011","E00001786","E00001786","Total",124,105,54,51,0,8,4,4,8,8,0,0,0,3
"2011","E00001791","E00001791","Total",134,83,44,39,0,17,0,17,33,32,0,1,0,1
"2011","E00001792","E00001792","Total",129,110,36,74,0,8,1,7,11,8,0,2,1,0
"2011","E00002176","E00002176","Total",123,116,69,47,0,1,0,1,4,4,0,0,0,2
"2011","E00002180","E00002180","Total",117,110,67,43,0,0,0,0,5,4,0,1,0,2
"2011","E00002196","E00002196","Total",135,120,74,46,0,0,0,0,13,12,0,1,0,2
"2011","E00002200","E00002200","Total",120,108,53,55,0,1,1,0,10,9,0,1,0,1
"2011","E00002203","E00002203","Total",131,116,63,53,0,2,0,2,13,10,0,3,0,0
"2011","E00002177","E00002177","Total",137,103,33,70,0,13,0,13,21,21,0,0,0,0
"2011","E00002185","E00002185","Total",165,64,27,37,4,32,0,32,60,56,1,2,1,5
"2011","E00002190","E00002190","Total",158,119,59,60,0,8,1,7,31,30,0,0,1,0
"2011","E00002204","E00002204","Total",124,103,51,52,0,8,2,6,10,9,0,0,1,3
"2011","E00002206","E00002206","Total",129,105,45,60,0,3,0,3,20,18,1,1,0,1
"2011","E00002179","E00002179","Total",133,131,64,67,0,0,0,0,2,2,0,0,0,0
"2011","E00002189","E00002189","Total",131,127,89,38,0,1,0,1,2,2,0,0,0,1
"2011","E00002191","E00002191","Total",130,124,51,73,0,0,0,0,5,5,0,0,0,1
"2011","E00002192","E00002192","Total",110,106,65,41,0,2,0,2,2,1,0,1,0,0
"2011","E00002178","E00002178","Total",135,123,67,56,0,5,1,4,6,5,0,1,0,1
"2011","E00002181","E00002181","Total",128,112,62,50,0,3,0,3,11,11,0,0,0,2
"2011","E00002183","E00002183","Total",121,83,70,13,0,9,0,9,29,27,0,2,0,0
"2011","E00002205","E00002205","Total",136,132,69,63,0,0,0,0,4,4,0,0,0,0
"2011","E00002207","E00002207","Total",128,125,75,50,0,1,0,1,2,2,0,0,0,0
"2011","E00001698","E00001698","Total",122,109,36,73,0,0,0,0,12,12,0,0,0,1
"2011","E00001702","E00001702","Total",99,94,53,41,0,1,0,1,2,2,0,0,0,2
"2011","E00001703","E00001703","Total",124,119,75,44,0,3,0,3,2,2,0,0,0,0
"2011","E00001718","E00001718","Total",149,138,64,74,0,0,0,0,11,8,0,3,0,0
"2011","E00001721","E00001721","Total",122,106,41,65,0,0,0,0,16,14,0,2,0,0
"2011","E00002193","E00002193","Total",123,112,42,70,1,5,2,3,5,5,0,0,0,0
"2011","E00002197","E00002197","Total",121,105,37,68,0,10,1,9,6,5,0,0,1,0
"2011","E00002198","E00002198","Total",126,69,31,38,2,36,3,33,18,16,1,1,0,1
"2011","E00002201","E00002201","Total",140,104,56,48,1,30,4,26,5,5,0,0,0,0
"2011","E00002175","E00002175","Total",120,111,78,33,0,0,0,0,9,8,0,1,0,0
"2011","E00002194","E00002194","Total",132,121,70,51,0,0,0,0,8,7,0,1,0,3
"2011","E00002195","E00002195","Total",166,155,66,89,0,0,0,0,11,11,0,0,0,0
"2011","E00002199","E00002199","Total",127,114,74,40,0,2,0,2,9,9,0,0,0,2
"2011","E00002202","E00002202","Total",142,122,78,44,0,1,0,1,17,14,0,2,1,2
"2011","E00002182","E00002182","Total",129,102,40,62,1,4,1,3,21,19,0,2,0,1
"2011","E00002184","E00002184","Total",118,107,34,73,0,0,0,0,10,8,0,2,0,1
"2011","E00002186","E00002186","Total",113,107,43,64,0,1,0,1,4,4,0,0,0,1
"2011","E00002187","E00002187","Total",119,108,40,68,0,0,0,0,10,8,0,2,0,1
"2011","E00002188","E00002188","Total",123,114,41,73,1,0,0,0,8,6,0,1,1,0
"2011","E00002246","E00002246","Total",120,113,52,61,0,1,1,0,4,4,0,0,0,2
"2011","E00002248","E00002248","Total",120,110,56,54,0,1,0,1,8,7,0,1,0,1
"2011","E00002249","E00002249","Total",93,83,40,43,0,2,0,2,6,6,0,0,0,2
"2011","E00002250","E00002250","Total",135,128,67,61,1,1,0,1,5,4,0,1,0,0
"2011","E00002271","E00002271","Total",101,99,35,64,0,1,0,1,1,1,0,0,0,0
"2011","E00001679","E00001679","Total",124,100,49,51,0,16,0,16,8,8,0,0,0,0
"2011","E00001681","E00001681","Total",130,116,53,63,1,6,0,6,7,6,0,1,0,0
"2011","E00001682","E00001682","Total",130,105,51,54,0,14,0,14,10,10,0,0,0,1
"2011","E00001683","E00001683","Total",127,107,42,65,2,7,0,7,8,8,0,0,0,3
"2011","E00001684","E00001684","Total",91,11,6,5,0,78,2,76,2,2,0,0,0,0
"2011","E00001663","E00001663","Total",125,116,60,56,0,2,0,2,6,5,0,1,0,1
"2011","E00001667","E00001667","Total",133,124,49,75,1,3,0,3,4,3,0,1,0,1
"2011","E00001676","E00001676","Total",130,112,50,62,1,1,1,0,14,14,0,0,0,2
"2011","E00001677","E00001677","Total",123,114,66,48,0,2,1,1,6,5,0,1,0,1
"2011","E00001680","E00001680","Total",135,94,37,57,0,5,2,3,34,31,0,2,1,2
"2011","E00002090","E00002090","Total",90,86,42,44,0,1,0,1,2,2,0,0,0,1
"2011","E00002093","E00002093","Total",112,108,67,41,1,2,0,2,1,1,0,0,0,0
"2011","E00002095","E00002095","Total",136,131,69,62,0,1,0,1,3,1,0,2,0,1
"2011","E00002099","E00002099","Total",140,129,50,79,1,0,0,0,10,10,0,0,0,0
"2011","E00002100","E00002100","Total",131,116,47,69,1,2,1,1,11,10,0,1,0,1
"2011","E00002076","E00002076","Total",108,105,57,48,0,0,0,0,3,3,0,0,0,0
"2011","E00002091","E00002091","Total",102,98,50,48,0,2,0,2,2,2,0,0,0,0
"2011","E00002092","E00002092","Total",124,121,64,57,0,2,0,2,1,1,0,0,0,0
"2011","E00002094","E00002094","Total",137,131,59,72,0,1,0,1,3,3,0,0,0,2
"2011","E00002097","E00002097","Total",119,113,55,58,1,1,0,1,4,3,0,1,0,0
"2011","E00002244","E00002244","Total",100,95,42,53,0,0,0,0,5,5,0,0,0,0
"2011","E00002245","E00002245","Total",123,115,51,64,0,0,0,0,8,7,0,1,0,0
"2011","E00002247","E00002247","Total",99,93,48,45,0,1,0,1,3,3,0,0,0,2
"2011","E00002274","E00002274","Total",130,113,36,77,2,1,0,1,13,10,0,3,0,1
"2011","E00002078","E00002078","Total",127,122,71,51,0,1,0,1,3,2,1,0,0,1
"2011","E00002083","E00002083","Total",113,101,59,42,1,2,1,1,8,6,0,2,0,1
"2011","E00002096","E00002096","Total",129,101,31,70,0,0,0,0,26,24,0,2,0,2
"2011","E00002098","E00002098","Total",134,128,71,57,0,0,0,0,6,6,0,0,0,0
"2011","E00002101","E00002101","Total",130,115,39,76,0,2,0,2,13,13,0,0,0,0
"2011","E00002104","E00002104","Total",132,88,34,54,0,31,0,31,13,12,0,1,0,0
"2011","E00002077","E00002077","Total",108,92,31,61,0,0,0,0,15,14,0,1,0,1
"2011","E00002081","E00002081","Total",99,50,19,31,0,41,7,34,8,7,0,1,0,0
"2011","E00002102","E00002102","Total",101,81,21,60,4,7,1,6,9,9,0,0,0,0
"2011","E00002103","E00002103","Total",143,100,51,49,1,2,0,2,38,36,2,0,0,2
"2011","E00002105","E00002105","Total",142,110,47,63,1,1,0,1,28,26,0,2,0,2
"2011","E00002106","E00002106","Total",119,96,38,58,0,9,0,9,12,10,1,1,0,2
"2011","E00002073","E00002073","Total",134,104,68,36,7,7,1,6,14,13,1,0,0,2
"2011","E00002079","E00002079","Total",115,13,8,5,0,90,2,88,9,9,0,0,0,3
"2011","E00002080","E00002080","Total",106,86,56,30,1,1,0,1,18,18,0,0,0,0
"2011","E00002082","E00002082","Total",151,118,59,59,0,15,13,2,18,13,0,5,0,0
"2011","E00002085","E00002085","Total",202,160,83,77,0,32,1,31,9,9,0,0,0,1
"2011","E00002087","E00002087","Total",101,88,30,58,1,3,0,3,8,7,0,1,0,1
"2011","E00002107","E00002107","Total",113,103,72,31,1,1,1,0,8,8,0,0,0,0
"2011","E00002240","E00002240","Total",185,155,91,64,2,4,1,3,23,23,0,0,0,1
"2011","E00002259","E00002259","Total",149,63,37,26,23,13,0,13,49,43,0,5,1,1
"2011","E00002260","E00002260","Total",158,117,66,51,0,5,0,5,35,31,0,3,1,1
"2011","E00002262","E00002262","Total",137,68,40,28,1,1,0,1,66,63,1,2,0,1
"2011","E00002263","E00002263","Total",196,90,37,53,11,13,1,12,80,74,1,5,0,2
"2011","E00002242","E00002242","Total",121,105,62,43,0,8,1,7,7,7,0,0,0,1
"2011","E00002243","E00002243","Total",108,72,36,36,0,32,1,31,3,3,0,0,0,1
"2011","E00002251","E00002251","Total",124,68,34,34,0,7,0,7,47,46,0,1,0,2
"2011","E00002252","E00002252","Total",135,44,15,29,0,22,1,21,67,58,0,8,1,2
"2011","E00002257","E00002257","Total",129,110,62,48,2,1,0,1,14,13,0,1,0,2
"2011","E00002272","E00002272","Total",121,61,29,32,0,5,0,5,53,51,1,1,0,2
"2011","E00001880","E00001880","Total",111,85,34,51,0,17,3,14,8,8,0,0,0,1
"2011","E00001881","E00001881","Total",116,104,62,42,0,1,0,1,10,9,0,1,0,1
"2011","E00001883","E00001883","Total",127,115,59,56,0,6,0,6,5,5,0,0,0,1
"2011","E00001884","E00001884","Total",92,91,51,40,0,0,0,0,1,1,0,0,0,0
"2011","E00001903","E00001903","Total",141,128,68,60,0,5,0,5,8,8,0,0,0,0
"2011","E00001868","E00001868","Total",133,116,54,62,1,0,0,0,16,13,0,3,0,0
"2011","E00001873","E00001873","Total",125,104,54,50,1,3,0,3,16,16,0,0,0,1
"2011","E00001886","E00001886","Total",142,104,52,52,0,12,2,10,26,23,0,3,0,0
"2011","E00001887","E00001887","Total",110,54,28,26,0,40,1,39,14,13,0,1,0,2
"2011","E00001889","E00001889","Total",136,44,13,31,1,57,5,52,32,28,0,3,1,2
"2011","E00001891","E00001891","Total",134,111,33,78,1,4,1,3,18,18,0,0,0,0
"2011","E00001878","E00001878","Total",141,97,31,66,2,27,6,21,15,15,0,0,0,0
"2011","E00001899","E00001899","Total",126,113,61,52,0,2,0,2,10,9,0,1,0,1
"2011","E00001900","E00001900","Total",119,110,60,50,0,0,0,0,8,7,0,1,0,1
"2011","E00001901","E00001901","Total",121,113,58,55,0,5,0,5,3,3,0,0,0,0
"2011","E00001902","E00001902","Total",111,101,65,36,0,5,0,5,5,5,0,0,0,0
"2011","E00002074","E00002074","Total",203,120,62,58,0,12,3,9,64,63,0,1,0,7
"2011","E00002075","E00002075","Total",147,83,49,34,1,9,0,9,54,52,0,2,0,0
"2011","E00002084","E00002084","Total",128,20,4,16,0,87,2,85,19,18,0,1,0,2
"2011","E00002086","E00002086","Total",134,16,5,11,0,111,0,111,7,7,0,0,0,0
"2011","E00002088","E00002088","Total",130,8,3,5,0,113,0,113,9,7,1,1,0,0
"2011","E00002089","E00002089","Total",140,117,76,41,0,1,0,1,22,21,1,0,0,0
"2011","E00002253","E00002253","Total",127,124,67,57,0,1,0,1,2,2,0,0,0,0
"2011","E00002254","E00002254","Total",126,64,40,24,0,36,1,35,25,24,0,1,0,1
"2011","E00002255","E00002255","Total",121,95,46,49,0,3,0,3,22,19,1,2,0,1
"2011","E00002256","E00002256","Total",135,130,87,43,0,2,1,1,3,3,0,0,0,0
"2011","E00002258","E00002258","Total",122,104,66,38,0,5,0,5,12,12,0,0,0,1
"2011","E00002241","E00002241","Total",155,68,34,34,1,58,1,57,27,22,0,5,0,1
"2011","E00002261","E00002261","Total",85,74,49,25,1,1,0,1,9,7,0,1,1,0
"2011","E00002264","E00002264","Total",144,57,32,25,6,37,2,35,42,41,0,1,0,2
"2011","E00002265","E00002265","Total",99,81,47,34,1,3,0,3,14,14,0,0,0,0
"2011","E00002266","E00002266","Total",162,113,61,52,0,7,1,6,39,35,1,3,0,3
"2011","E00002267","E00002267","Total",136,100,84,16,0,24,0,24,10,10,0,0,0,2
"2011","E00001870","E00001870","Total",131,102,37,65,0,7,0,7,22,22,0,0,0,0
"2011","E00001871","E00001871","Total",102,61,23,38,4,29,1,28,6,5,0,1,0,2
"2011","E00001876","E00001876","Total",134,89,36,53,0,37,4,33,8,8,0,0,0,0
"2011","E00001877","E00001877","Total",60,50,28,22,0,0,0,0,8,5,1,2,0,2
"2011","E00001879","E00001879","Total",145,73,24,49,4,56,8,48,10,10,0,0,0,2
"2011","E00001882","E00001882","Total",88,42,16,26,1,40,8,32,4,2,0,2,0,1
"2011","E00001869","E00001869","Total",128,110,62,48,0,12,0,12,5,5,0,0,0,1
"2011","E00001872","E00001872","Total",118,114,66,48,0,2,1,1,2,2,0,0,0,0
"2011","E00001885","E00001885","Total",138,109,49,60,0,18,1,17,9,5,1,3,0,2
"2011","E00001892","E00001892","Total",146,125,65,60,0,5,0,5,13,13,0,0,0,3
"2011","E00001894","E00001894","Total",103,53,25,28,0,45,7,38,4,4,0,0,0,1
"2011","E00001874","E00001874","Total",158,65,31,34,28,53,8,45,8,8,0,0,0,4
"2011","E00001890","E00001890","Total",124,51,21,30,0,64,11,53,6,6,0,0,0,3
"2011","E00001893","E00001893","Total",143,40,16,24,0,90,16,74,11,11,0,0,0,2
"2011","E00001895","E00001895","Total",169,78,21,57,1,54,2,52,33,32,0,1,0,3
"2011","E00001896","E00001896","Total",176,94,39,55,9,55,12,43,16,16,0,0,0,2
"2011","E00001867","E00001867","Total",164,60,24,36,0,82,9,73,21,19,0,2,0,1
"2011","E00001875","E00001875","Total",139,41,13,28,0,80,16,64,16,16,0,0,0,2
"2011","E00001888","E00001888","Total",132,64,32,32,0,52,2,50,16,16,0,0,0,0
"2011","E00001897","E00001897","Total",106,10,3,7,10,75,7,68,11,10,0,1,0,0
"2011","E00001898","E00001898","Total",118,68,25,43,0,33,6,27,16,14,0,2,0,1
"2011","E00001944","E00001944","Total",116,66,22,44,0,41,10,31,6,5,0,1,0,3
"2011","E00001945","E00001945","Total",135,108,51,57,1,9,2,7,16,15,0,1,0,1
"2011","E00001946","E00001946","Total",127,94,44,50,2,20,4,16,11,10,0,1,0,0
"2011","E00001951","E00001951","Total",120,96,52,44,4,14,1,13,5,5,0,0,0,1
"2011","E00001956","E00001956","Total",113,72,34,38,0,29,2,27,10,9,0,1,0,2
"2011","E00001952","E00001952","Total",111,88,42,46,0,8,1,7,13,10,0,3,0,2
"2011","E00001954","E00001954","Total",114,107,66,41,0,2,0,2,4,4,0,0,0,1
"2011","E00001961","E00001961","Total",126,117,58,59,0,3,0,3,6,6,0,0,0,0
"2011","E00001964","E00001964","Total",126,115,54,61,0,3,0,3,8,5,0,3,0,0
"2011","E00001968","E00001968","Total",142,75,39,36,1,29,5,24,35,32,0,3,0,2
"2011","E00001949","E00001949","Total",110,80,24,56,0,4,0,4,26,24,0,2,0,0
"2011","E00001958","E00001958","Total",122,101,40,61,0,10,2,8,11,11,0,0,0,0
"2011","E00001960","E00001960","Total",112,95,47,48,0,4,0,4,13,11,0,2,0,0
"2011","E00001966","E00001966","Total",114,93,42,51,0,17,2,15,3,2,0,1,0,1
"2011","E00001967","E00001967","Total",132,107,65,42,2,4,0,4,19,17,0,1,1,0
"2011","E00001943","E00001943","Total",125,67,17,50,0,26,4,22,31,30,0,1,0,1
"2011","E00001947","E00001947","Total",131,54,17,37,2,66,9,57,9,8,0,1,0,0
"2011","E00001948","E00001948","Total",119,43,17,26,1,66,10,56,8,8,0,0,0,1
"2011","E00001950","E00001950","Total",123,108,61,47,2,9,4,5,4,3,0,1,0,0
"2011","E00001953","E00001953","Total",135,102,52,50,1,22,3,19,9,9,0,0,0,1
"2011","E00165791","E00165791","Total",114,98,43,55,3,2,0,2,10,10,0,0,0,1
"2011","E00002857","E00002857","Total",106,78,36,42,1,3,2,1,24,23,0,1,0,0
"2011","E00002859","E00002859","Total",126,100,51,49,0,3,0,3,20,19,0,1,0,3
"2011","E00002865","E00002865","Total",118,88,51,37,0,5,0,5,24,23,0,1,0,1
"2011","E00002867","E00002867","Total",108,84,46,38,0,4,1,3,18,17,0,1,0,2
"2011","E00002869","E00002869","Total",140,99,54,45,0,5,1,4,31,30,0,1,0,5
"2011","E00002872","E00002872","Total",119,99,58,41,1,7,0,7,10,10,0,0,0,2
"2011","E00002878","E00002878","Total",112,82,50,32,1,3,0,3,24,23,0,1,0,2
"2011","E00174696","E00174696","Total",134,60,29,31,6,22,1,21,43,42,0,1,0,3
"2011","E00174697","E00174697","Total",87,54,27,27,0,14,2,12,17,17,0,0,0,2
"2011","E00002864","E00002864","Total",115,91,48,43,2,5,3,2,17,16,0,0,1,0
"2011","E00002868","E00002868","Total",109,84,42,42,1,3,1,2,19,19,0,0,0,2
"2011","E00002870","E00002870","Total",172,84,48,36,1,42,8,34,43,41,0,2,0,2
"2011","E00002873","E00002873","Total",116,86,48,38,0,2,0,2,27,26,0,1,0,1
"2011","E00002877","E00002877","Total",114,91,42,49,2,1,1,0,19,17,0,2,0,1
"2011","E00002850","E00002850","Total",166,39,17,22,1,87,6,81,36,32,0,1,3,3
"2011","E00002851","E00002851","Total",124,95,42,53,1,0,0,0,27,27,0,0,0,1
"2011","E00002852","E00002852","Total",112,89,57,32,1,3,2,1,19,19,0,0,0,0
"2011","E00002856","E00002856","Total",123,96,53,43,1,6,3,3,17,17,0,0,0,3
"2011","E00002854","E00002854","Total",148,61,25,36,0,70,6,64,13,13,0,0,0,4
"2011","E00002855","E00002855","Total",128,96,43,53,0,1,0,1,28,27,0,1,0,3
"2011","E00002862","E00002862","Total",125,87,45,42,1,2,1,1,34,34,0,0,0,1
"2011","E00174685","E00174685","Total",143,44,7,37,26,39,5,34,33,32,0,0,1,1
"2011","E00174703","E00174703","Total",136,71,26,45,10,33,0,33,19,18,0,1,0,3
"2011","E00002858","E00002858","Total",126,65,38,27,2,7,0,7,50,47,0,2,1,2
"2011","E00002861","E00002861","Total",149,60,30,30,0,26,20,6,60,57,1,1,1,3
"2011","E00002863","E00002863","Total",117,84,45,39,0,3,0,3,29,28,0,1,0,1
"2011","E00002871","E00002871","Total",135,109,50,59,1,6,1,5,17,15,0,2,0,2
"2011","E00002499","E00002499","Total",120,84,37,47,0,3,1,2,30,29,0,1,0,3
"2011","E00002505","E00002505","Total",121,85,47,38,1,7,3,4,24,23,0,1,0,4
"2011","E00002509","E00002509","Total",115,92,36,56,2,1,1,0,16,15,0,0,1,4
"2011","E00002530","E00002530","Total",115,61,31,30,0,14,10,4,36,31,0,5,0,4
"2011","E00002502","E00002502","Total",128,100,43,57,1,7,2,5,20,18,0,0,2,0
"2011","E00002504","E00002504","Total",117,68,30,38,3,5,3,2,40,38,0,1,1,1
"2011","E00002506","E00002506","Total",130,71,19,52,1,8,3,5,49,46,0,2,1,1
"2011","E00002511","E00002511","Total",120,87,43,44,0,5,3,2,27,27,0,0,0,1
"2011","E00002496","E00002496","Total",126,103,52,51,0,1,0,1,18,18,0,0,0,4
"2011","E00002525","E00002525","Total",128,86,46,40,0,7,1,6,34,34,0,0,0,1
"2011","E00002526","E00002526","Total",132,49,18,31,0,5,0,5,77,73,0,0,4,1
"2011","E00002529","E00002529","Total",131,99,51,48,1,5,1,4,25,25,0,0,0,1
"2011","E00002497","E00002497","Total",122,88,39,49,0,4,3,1,27,26,0,1,0,3
"2011","E00002500","E00002500","Total",101,77,41,36,0,2,1,1,20,20,0,0,0,2
"2011","E00002501","E00002501","Total",131,76,30,46,0,1,1,0,54,53,0,1,0,0
"2011","E00002527","E00002527","Total",107,31,14,17,1,46,5,41,25,25,0,0,0,4
"2011","E00002528","E00002528","Total",125,57,31,26,0,36,31,5,31,31,0,0,0,1
"2011","E00002866","E00002866","Total",202,2,1,1,1,177,9,168,19,18,0,1,0,3
"2011","E00002874","E00002874","Total",134,104,50,54,2,4,1,3,22,22,0,0,0,2
"2011","E00002875","E00002875","Total",132,102,50,52,1,6,2,4,23,23,0,0,0,0
"2011","E00174698","E00174698","Total",79,43,24,19,1,17,2,15,17,17,0,0,0,1
"2011","E00174699","E00174699","Total",122,34,17,17,31,35,5,30,21,20,0,1,0,1
"2011","E00002498","E00002498","Total",126,69,20,49,0,16,12,4,41,37,0,4,0,0
"2011","E00002508","E00002508","Total",117,25,9,16,10,67,5,62,15,15,0,0,0,0
"2011","E00002510","E00002510","Total",126,52,29,23,0,37,4,33,34,32,1,1,0,3
"2011","E00002512","E00002512","Total",139,37,16,21,1,42,36,6,55,54,0,1,0,4
"2011","E00002513","E00002513","Total",120,54,18,36,1,36,32,4,28,28,0,0,0,1
"2011","E00002503","E00002503","Total",123,52,26,26,1,1,0,1,69,67,0,2,0,0
"2011","E00002507","E00002507","Total",132,104,65,39,1,0,0,0,23,22,0,1,0,4
"2011","E00002515","E00002515","Total",116,96,65,31,1,1,0,1,18,18,0,0,0,0
"2011","E00002518","E00002518","Total",120,92,50,42,0,10,7,3,18,18,0,0,0,0
"2011","E00002608","E00002608","Total",123,105,57,48,0,2,0,2,15,13,0,1,1,1
"2011","E00002634","E00002634","Total",110,43,26,17,3,24,21,3,37,34,0,2,1,3
"2011","E00002635","E00002635","Total",134,113,75,38,0,4,1,3,16,15,0,0,1,1
"2011","E00002636","E00002636","Total",133,46,20,26,0,29,21,8,55,53,2,0,0,3
"2011","E00002849","E00002849","Total",178,99,49,50,6,25,5,20,44,41,0,1,2,4
"2011","E00002876","E00002876","Total",107,66,39,27,0,5,2,3,33,31,1,1,0,3
"2011","E00002880","E00002880","Total",123,75,45,30,0,11,2,9,36,33,0,2,1,1
"2011","E00002881","E00002881","Total",106,58,30,28,0,24,22,2,22,20,0,1,1,2
"2011","E00002882","E00002882","Total",136,50,23,27,1,15,8,7,68,67,0,0,1,2
"2011","E00002610","E00002610","Total",129,81,35,46,1,23,22,1,23,22,0,0,1,1
"2011","E00002612","E00002612","Total",137,102,61,41,0,9,9,0,26,25,0,1,0,0
"2011","E00002617","E00002617","Total",113,88,52,36,0,8,4,4,14,12,0,2,0,3
"2011","E00002628","E00002628","Total",135,104,65,39,0,3,0,3,26,23,3,0,0,2
"2011","E00002629","E00002629","Total",129,101,53,48,1,2,1,1,24,24,0,0,0,1
"2011","E00002630","E00002630","Total",98,77,52,25,1,3,1,2,16,14,0,2,0,1
"2011","E00002633","E00002633","Total",107,79,45,34,1,1,0,1,24,21,0,2,1,2
"2011","E00002613","E00002613","Total",121,110,65,45,0,0,0,0,11,9,0,2,0,0
"2011","E00002632","E00002632","Total",127,108,62,46,0,2,1,1,15,14,1,0,0,2
"2011","E00002637","E00002637","Total",158,67,47,20,0,14,5,9,73,66,2,5,0,4
"2011","E00002638","E00002638","Total",116,97,48,49,0,1,0,1,17,17,0,0,0,1
"2011","E00002609","E00002609","Total",123,105,54,51,0,1,0,1,15,15,0,0,0,2
"2011","E00002611","E00002611","Total",120,106,48,58,0,1,0,1,13,13,0,0,0,0
"2011","E00002615","E00002615","Total",116,103,57,46,0,0,0,0,11,10,0,1,0,2
"2011","E00002620","E00002620","Total",119,106,52,54,1,0,0,0,12,12,0,0,0,0
"2011","E00002607","E00002607","Total",105,55,43,12,1,1,0,1,44,44,0,0,0,4
"2011","E00002614","E00002614","Total",120,100,52,48,1,1,1,0,18,18,0,0,0,0
"2011","E00002616","E00002616","Total",101,87,48,39,1,2,0,2,9,9,0,0,0,2
"2011","E00002621","E00002621","Total",105,90,51,39,0,1,0,1,11,11,0,0,0,3
"2011","E00002625","E00002625","Total",117,73,32,41,0,36,0,36,6,6,0,0,0,2
"2011","E00002619","E00002619","Total",117,105,65,40,0,1,1,0,10,10,0,0,0,1
"2011","E00002622","E00002622","Total",120,102,57,45,0,0,0,0,17,16,0,0,1,1
"2011","E00002623","E00002623","Total",121,98,42,56,0,2,1,1,21,21,0,0,0,0
"2011","E00002624","E00002624","Total",113,95,65,30,0,2,0,2,14,12,0,1,1,2
"2011","E00002618","E00002618","Total",96,31,17,14,0,30,25,5,34,31,2,1,0,1
"2011","E00002626","E00002626","Total",158,91,55,36,0,3,1,2,58,51,3,1,3,6
"2011","E00002627","E00002627","Total",119,63,23,40,1,10,9,1,43,42,0,1,0,2
"2011","E00002631","E00002631","Total",126,106,44,62,0,1,1,0,17,16,0,1,0,2
"2011","E00002514","E00002514","Total",138,35,8,27,2,75,46,29,21,19,0,2,0,5
"2011","E00002516","E00002516","Total",129,110,55,55,0,6,4,2,11,11,0,0,0,2
"2011","E00002517","E00002517","Total",122,82,41,41,0,5,2,3,35,35,0,0,0,0
"2011","E00002519","E00002519","Total",168,72,26,46,3,47,21,26,44,40,1,1,2,2
"2011","E00002520","E00002520","Total",112,19,6,13,0,19,8,11,73,71,1,1,0,1
"2011","E00002521","E00002521","Total",125,65,27,38,1,18,14,4,38,37,0,1,0,3
"2011","E00002522","E00002522","Total",127,62,28,34,0,42,38,4,22,22,0,0,0,1
"2011","E00002523","E00002523","Total",121,101,47,54,0,2,2,0,15,15,0,0,0,3
"2011","E00002524","E00002524","Total",144,60,26,34,0,25,18,7,58,55,0,1,2,1
"2011","E00003003","E00003003","Total",131,108,61,47,0,4,2,2,16,16,0,0,0,3
"2011","E00003006","E00003006","Total",126,33,18,15,0,16,14,2,76,69,0,5,2,1
"2011","E00003008","E00003008","Total",143,113,53,60,0,6,1,5,23,22,0,1,0,1
"2011","E00003009","E00003009","Total",141,113,61,52,0,3,2,1,23,22,0,1,0,2
"2011","E00003002","E00003002","Total",110,95,53,42,1,2,0,2,11,11,0,0,0,1
"2011","E00003004","E00003004","Total",114,92,54,38,0,2,2,0,19,17,0,2,0,1
"2011","E00003005","E00003005","Total",125,81,27,54,0,9,5,4,34,31,0,3,0,1
"2011","E00003007","E00003007","Total",141,103,56,47,1,4,2,2,30,30,0,0,0,3
"2011","E00003038","E00003038","Total",104,80,35,45,0,4,2,2,19,19,0,0,0,1
"2011","E00003034","E00003034","Total",115,82,40,42,1,6,3,3,25,24,0,1,0,1
"2011","E00003035","E00003035","Total",113,76,35,41,2,11,8,3,23,21,0,2,0,1
"2011","E00003036","E00003036","Total",119,80,33,47,0,3,2,1,35,34,0,1,0,1
"2011","E00003037","E00003037","Total",115,86,41,45,0,3,2,1,25,24,0,0,1,1
"2011","E00003039","E00003039","Total",143,97,46,51,1,5,2,3,38,36,0,2,0,2
"2011","E00002361","E00002361","Total",138,113,47,66,2,1,0,1,22,19,1,2,0,0
"2011","E00002362","E00002362","Total",128,96,43,53,0,2,0,2,28,28,0,0,0,2
"2011","E00002365","E00002365","Total",127,73,36,37,0,5,3,2,49,49,0,0,0,0
"2011","E00002366","E00002366","Total",142,114,61,53,0,3,0,3,23,23,0,0,0,2
"2011","E00002345","E00002345","Total",92,46,27,19,9,26,0,26,9,8,0,1,0,2
"2011","E00002349","E00002349","Total",100,15,6,9,4,57,8,49,22,22,0,0,0,2
"2011","E00002378","E00002378","Total",54,27,8,19,0,20,19,1,7,7,0,0,0,0
"2011","E00002379","E00002379","Total",177,35,12,23,11,111,31,80,18,18,0,0,0,2
"2011","E00002346","E00002346","Total",109,63,24,39,0,17,13,4,28,27,0,1,0,1
"2011","E00002380","E00002380","Total",113,66,30,36,2,22,17,5,20,17,0,3,0,3
"2011","E00002381","E00002381","Total",124,47,22,25,0,46,40,6,30,28,0,1,1,1
"2011","E00002382","E00002382","Total",142,41,16,25,0,68,58,10,33,31,0,1,1,0
"2011","E00002347","E00002347","Total",125,90,45,45,0,3,1,2,30,29,0,0,1,2
"2011","E00002351","E00002351","Total",142,101,50,51,0,5,1,4,34,30,0,3,1,2
"2011","E00002352","E00002352","Total",139,84,41,43,1,7,5,2,46,42,2,0,2,1
"2011","E00002359","E00002359","Total",126,88,54,34,2,1,1,0,33,31,0,2,0,2
"2011","E00002348","E00002348","Total",129,80,55,25,0,2,1,1,46,42,0,2,2,1
"2011","E00002350","E00002350","Total",112,53,35,18,0,43,3,40,9,8,0,1,0,7
"2011","E00002356","E00002356","Total",120,56,25,31,0,1,0,1,60,58,0,2,0,3
"2011","E00002358","E00002358","Total",123,75,31,44,2,10,10,0,34,33,0,0,1,2
"2011","E00002364","E00002364","Total",190,62,28,34,1,32,2,30,93,90,0,2,1,2
"2011","E00002797","E00002797","Total",125,63,32,31,3,11,2,9,46,44,0,1,1,2
"2011","E00002798","E00002798","Total",110,87,47,40,0,4,0,4,18,17,0,1,0,1
"2011","E00002799","E00002799","Total",109,86,43,43,1,3,1,2,17,17,0,0,0,2
"2011","E00002800","E00002800","Total",118,96,51,45,0,2,1,1,17,17,0,0,0,3
"2011","E00002773","E00002773","Total",112,78,41,37,0,5,2,3,26,23,1,2,0,3
"2011","E00002801","E00002801","Total",119,80,41,39,0,2,0,2,36,31,0,4,1,1
"2011","E00002802","E00002802","Total",117,85,42,43,2,6,0,6,24,22,1,1,0,0
"2011","E00002803","E00002803","Total",126,91,54,37,0,6,4,2,28,25,0,2,1,1
"2011","E00002772","E00002772","Total",107,76,41,35,1,6,0,6,18,17,0,0,1,6
"2011","E00002778","E00002778","Total",111,70,34,36,1,8,2,6,32,32,0,0,0,0
"2011","E00002804","E00002804","Total",122,100,57,43,0,3,1,2,19,19,0,0,0,0
"2011","E00002805","E00002805","Total",88,47,22,25,2,7,0,7,31,31,0,0,0,1
"2011","E00002770","E00002770","Total",139,66,20,46,1,3,1,2,67,65,1,0,1,2
"2011","E00002776","E00002776","Total",99,48,33,15,0,24,1,23,25,25,0,0,0,2
"2011","E00002777","E00002777","Total",130,84,49,35,1,5,4,1,37,37,0,0,0,3
"2011","E00002781","E00002781","Total",125,68,23,45,2,4,1,3,51,50,0,1,0,0
"2011","E00002806","E00002806","Total",132,51,21,30,2,7,0,7,71,67,2,1,1,1
"2011","E00002769","E00002769","Total",119,33,14,19,1,62,46,16,22,22,0,0,0,1
"2011","E00002779","E00002779","Total",138,33,10,23,1,6,2,4,95,90,1,4,0,3
"2011","E00002790","E00002790","Total",125,33,12,21,0,41,5,36,49,47,0,0,2,2
"2011","E00174553","E00174553","Total",169,29,9,20,26,47,7,40,62,58,1,2,1,5
"2011","E00174554","E00174554","Total",119,11,3,8,9,82,6,76,12,11,0,1,0,5
"2011","E00174704","E00174704","Total",123,27,2,25,0,33,5,28,62,59,0,2,1,1
"2011","E00002742","E00002742","Total",115,45,21,24,10,31,3,28,27,27,0,0,0,2
"2011","E00002753","E00002753","Total",123,111,61,50,2,2,0,2,8,7,0,1,0,0
"2011","E00002759","E00002759","Total",127,112,55,57,0,2,2,0,11,11,0,0,0,2
"2011","E00002760","E00002760","Total",115,106,54,52,0,0,0,0,6,5,0,1,0,3
"2011","E00002751","E00002751","Total",115,106,47,59,0,1,1,0,7,7,0,0,0,1
"2011","E00002757","E00002757","Total",109,104,59,45,0,0,0,0,3,3,0,0,0,2
"2011","E00002764","E00002764","Total",133,90,52,38,3,11,4,7,28,24,2,1,1,1
"2011","E00002766","E00002766","Total",117,103,51,52,0,2,0,2,10,10,0,0,0,2
"2011","E00002755","E00002755","Total",114,95,54,41,0,2,1,1,16,15,0,1,0,1
"2011","E00002758","E00002758","Total",114,97,39,58,0,2,0,2,15,14,0,1,0,0
"2011","E00002761","E00002761","Total",125,105,52,53,1,2,0,2,17,15,0,1,1,0
"2011","E00002768","E00002768","Total",122,88,43,45,2,9,7,2,20,19,0,0,1,3
"2011","E00002748","E00002748","Total",139,84,55,29,8,4,2,2,41,38,2,0,1,2
"2011","E00174557","E00174557","Total",402,26,13,13,0,282,7,275,90,77,0,1,12,4
"2011","E00174695","E00174695","Total",94,60,32,28,0,2,0,2,32,31,0,0,1,0
"2011","E00174700","E00174700","Total",53,27,14,13,0,0,0,0,25,25,0,0,0,1
"2011","E00174730","E00174730","Total",99,1,0,1,0,78,4,74,20,17,0,0,3,0
"2011","E00002750","E00002750","Total",120,100,52,48,0,3,1,2,16,13,0,3,0,1
"2011","E00002752","E00002752","Total",116,100,49,51,0,2,2,0,13,13,0,0,0,1
"2011","E00002754","E00002754","Total",115,95,46,49,0,2,1,1,17,17,0,0,0,1
"2011","E00002756","E00002756","Total",129,113,50,63,0,4,1,3,12,11,0,0,1,0
"2011","E00002354","E00002354","Total",118,95,48,47,0,3,1,2,19,19,0,0,0,1
"2011","E00002357","E00002357","Total",123,104,58,46,0,1,0,1,18,18,0,0,0,0
"2011","E00002363","E00002363","Total",121,90,48,42,0,3,0,3,24,23,0,1,0,4
"2011","E00002367","E00002367","Total",148,112,47,65,2,5,0,5,27,25,0,2,0,2
"2011","E00002353","E00002353","Total",109,17,7,10,2,71,64,7,18,18,0,0,0,1
"2011","E00002355","E00002355","Total",120,60,33,27,3,7,4,3,47,47,0,0,0,3
"2011","E00002360","E00002360","Total",119,54,20,34,0,50,47,3,15,14,0,1,0,0
"2011","E00002368","E00002368","Total",115,24,8,16,1,6,1,5,82,80,0,0,2,2
"2011","E00002369","E00002369","Total",147,49,23,26,1,38,14,24,59,59,0,0,0,0
"2011","E00002370","E00002370","Total",170,30,16,14,34,45,34,11,57,55,0,0,2,4
"2011","E00002372","E00002372","Total",216,23,7,16,14,115,24,91,63,62,0,1,0,1
"2011","E00174713","E00174713","Total",122,32,16,16,6,47,9,38,34,33,0,0,1,3
"2011","E00174731","E00174731","Total",121,5,4,1,1,97,15,82,15,15,0,0,0,3
"2011","E00174733","E00174733","Total",112,10,2,8,10,56,7,49,36,36,0,0,0,0
"2011","E00174736","E00174736","Total",125,8,4,4,1,105,13,92,9,8,0,1,0,2
"2011","E00174738","E00174738","Total",126,51,21,30,0,35,12,23,35,34,0,0,1,5
"2011","E00002373","E00002373","Total",134,39,16,23,1,49,15,34,44,44,0,0,0,1
"2011","E00002374","E00002374","Total",138,40,18,22,4,48,12,36,40,40,0,0,0,6
"2011","E00002375","E00002375","Total",122,24,10,14,0,58,11,47,39,38,0,0,1,1
"2011","E00002376","E00002376","Total",121,24,8,16,1,79,26,53,17,14,0,1,2,0
"2011","E00002377","E00002377","Total",128,44,10,34,0,40,6,34,43,38,0,3,2,1
"2011","E00003010","E00003010","Total",124,78,27,51,0,5,1,4,39,36,0,3,0,2
"2011","E00003011","E00003011","Total",112,37,16,21,0,45,7,38,27,26,0,1,0,3
"2011","E00003012","E00003012","Total",121,56,28,28,1,31,4,27,27,27,0,0,0,6
"2011","E00003013","E00003013","Total",105,79,45,34,2,2,0,2,18,16,0,2,0,4
"2011","E00003014","E00003014","Total",95,55,29,26,1,6,2,4,30,29,0,0,1,3
"2011","E00002426","E00002426","Total",105,71,45,26,1,18,1,17,15,15,0,0,0,0
"2011","E00002427","E00002427","Total",140,66,22,44,0,25,8,17,48,47,0,0,1,1
"2011","E00002428","E00002428","Total",114,77,49,28,0,20,7,13,17,17,0,0,0,0
"2011","E00002430","E00002430","Total",98,71,41,30,0,6,0,6,18,18,0,0,0,3
"2011","E00003001","E00003001","Total",123,66,31,35,0,20,14,6,36,34,1,1,0,1
"2011","E00003015","E00003015","Total",116,46,21,25,0,12,9,3,57,57,0,0,0,1
"2011","E00003016","E00003016","Total",127,36,12,24,4,12,4,8,75,74,0,1,0,0
"2011","E00003017","E00003017","Total",140,44,15,29,1,14,11,3,81,77,0,4,0,0
"2011","E00003018","E00003018","Total",130,72,29,43,2,25,17,8,29,28,0,1,0,2
"2011","E00003019","E00003019","Total",104,9,3,6,1,63,10,53,31,30,0,1,0,0
"2011","E00003020","E00003020","Total",109,7,3,4,1,92,7,85,9,6,2,0,1,0
"2011","E00003021","E00003021","Total",124,25,13,12,2,50,7,43,45,44,0,0,1,2
"2011","E00003023","E00003023","Total",121,25,7,18,11,64,7,57,20,17,1,2,0,1
"2011","E00003026","E00003026","Total",132,23,3,20,21,66,2,64,21,21,0,0,0,1
"2011","E00002432","E00002432","Total",113,62,32,30,0,19,7,12,32,28,3,1,0,0
"2011","E00002433","E00002433","Total",139,90,66,24,0,15,3,12,32,30,0,1,1,2
"2011","E00002435","E00002435","Total",106,59,37,22,1,19,5,14,26,24,0,0,2,1
"2011","E00002436","E00002436","Total",134,90,56,34,0,16,3,13,27,25,1,1,0,1
"2011","E00002442","E00002442","Total",100,67,42,25,2,10,4,6,21,20,0,0,1,0
"2011","E00002444","E00002444","Total",105,66,35,31,0,12,0,12,27,27,0,0,0,0
"2011","E00002446","E00002446","Total",116,70,42,28,2,12,3,9,31,31,0,0,0,1
"2011","E00002431","E00002431","Total",120,80,37,43,0,15,10,5,24,23,0,1,0,1
"2011","E00002438","E00002438","Total",102,74,39,35,3,7,2,5,17,16,0,0,1,1
"2011","E00002443","E00002443","Total",132,77,42,35,1,12,3,9,40,40,0,0,0,2
"2011","E00002448","E00002448","Total",125,63,31,32,7,9,6,3,46,44,0,2,0,0
"2011","E00002452","E00002452","Total",107,15,1,14,17,56,4,52,19,18,0,1,0,0
"2011","E00002425","E00002425","Total",146,50,30,20,1,28,14,14,65,63,0,1,1,2
"2011","E00002429","E00002429","Total",113,31,20,11,0,58,27,31,20,19,0,1,0,4
"2011","E00002434","E00002434","Total",117,75,45,30,1,10,1,9,28,25,0,1,2,3
"2011","E00002439","E00002439","Total",124,81,47,34,0,2,1,1,39,39,0,0,0,2
"2011","E00002423","E00002423","Total",127,22,9,13,6,85,28,57,12,11,0,1,0,2
"2011","E00002424","E00002424","Total",226,99,33,66,11,32,5,27,81,75,2,3,1,3
"2011","E00002437","E00002437","Total",119,79,42,37,0,22,12,10,17,16,0,0,1,1
"2011","E00002441","E00002441","Total",119,23,7,16,0,85,67,18,10,8,0,2,0,1
"2011","E00002449","E00002449","Total",143,21,10,11,0,111,49,62,9,9,0,0,0,2
"2011","E00002440","E00002440","Total",107,40,13,27,0,16,12,4,51,50,0,1,0,0
"2011","E00002445","E00002445","Total",123,85,32,53,1,9,6,3,26,26,0,0,0,2
"2011","E00002447","E00002447","Total",100,43,14,29,1,41,3,38,11,10,0,1,0,4
"2011","E00002454","E00002454","Total",123,96,54,42,0,3,1,2,24,23,0,1,0,0
"2011","E00002422","E00002422","Total",128,71,38,33,1,35,29,6,18,18,0,0,0,3
"2011","E00002450","E00002450","Total",113,51,11,40,3,6,1,5,52,51,0,0,1,1
"2011","E00002451","E00002451","Total",172,110,73,37,0,19,5,14,40,35,1,3,1,3
"2011","E00002453","E00002453","Total",136,90,57,33,1,8,5,3,36,35,0,1,0,1
"2011","E00002455","E00002455","Total",172,42,21,21,0,103,88,15,25,24,0,1,0,2
"2011","E00002771","E00002771","Total",121,64,27,37,0,15,10,5,41,39,0,0,2,1
"2011","E00002784","E00002784","Total",139,58,25,33,1,42,38,4,38,34,0,3,1,0
"2011","E00002792","E00002792","Total",134,54,19,35,3,47,43,4,29,27,0,2,0,1
"2011","E00002793","E00002793","Total",119,87,42,45,0,6,1,5,26,25,0,1,0,0
"2011","E00002791","E00002791","Total",128,95,48,47,2,3,0,3,27,26,0,1,0,1
"2011","E00002794","E00002794","Total",137,74,32,42,1,3,0,3,56,56,0,0,0,3
"2011","E00002795","E00002795","Total",122,90,48,42,0,3,1,2,28,28,0,0,0,1
"2011","E00002796","E00002796","Total",90,71,37,34,0,3,0,3,13,13,0,0,0,3
"2011","E00002774","E00002774","Total",173,96,44,52,0,23,4,19,54,49,0,5,0,0
"2011","E00002775","E00002775","Total",113,81,47,34,1,4,0,4,25,23,0,2,0,2
"2011","E00002783","E00002783","Total",122,95,46,49,1,3,1,2,22,22,0,0,0,1
"2011","E00002789","E00002789","Total",126,66,50,16,4,1,1,0,49,45,0,2,2,6
"2011","E00002780","E00002780","Total",133,67,37,30,7,1,0,1,55,55,0,0,0,3
"2011","E00002785","E00002785","Total",153,34,16,18,20,47,2,45,52,48,0,3,1,0
"2011","E00002786","E00002786","Total",124,66,34,32,2,27,3,24,28,26,1,0,1,1
"2011","E00002787","E00002787","Total",121,62,45,17,2,22,0,22,31,30,0,1,0,4
"2011","E00002788","E00002788","Total",158,126,87,39,3,4,0,4,22,22,0,0,0,3
"2011","E00002739","E00002739","Total",117,55,24,31,2,9,4,5,47,46,0,1,0,4
"2011","E00002740","E00002740","Total",118,98,39,59,0,1,0,1,18,17,0,1,0,1
"2011","E00002763","E00002763","Total",106,35,11,24,0,8,3,5,57,55,0,2,0,6
"2011","E00002765","E00002765","Total",119,53,27,26,2,10,0,10,52,51,0,1,0,2
"2011","E00002738","E00002738","Total",128,45,12,33,0,48,42,6,30,30,0,0,0,5
"2011","E00002746","E00002746","Total",117,39,16,23,1,63,36,27,11,11,0,0,0,3
"2011","E00002762","E00002762","Total",136,73,27,46,7,13,0,13,41,39,0,1,1,2
"2011","E00002767","E00002767","Total",116,104,60,44,1,1,0,1,8,7,0,0,1,2
"2011","E00002934","E00002934","Total",144,83,40,43,0,5,2,3,53,48,0,4,1,3
"2011","E00002937","E00002937","Total",140,99,33,66,1,5,2,3,34,31,0,3,0,1
"2011","E00002940","E00002940","Total",130,76,38,38,0,6,4,2,47,46,0,0,1,1
"2011","E00002962","E00002962","Total",119,71,34,37,3,8,2,6,33,32,0,1,0,4
"2011","E00002967","E00002967","Total",134,92,34,58,0,3,0,3,36,35,0,1,0,3
"2011","E00002935","E00002935","Total",116,25,16,9,1,8,1,7,81,78,0,2,1,1
"2011","E00002939","E00002939","Total",129,39,16,23,0,34,23,11,55,51,0,2,2,1
"2011","E00002955","E00002955","Total",131,76,27,49,1,6,1,5,47,46,0,1,0,1
"2011","E00002964","E00002964","Total",123,40,9,31,0,42,32,10,41,36,2,3,0,0
"2011","E00174690","E00174690","Total",125,89,63,26,1,12,11,1,20,20,0,0,0,3
"2011","E00174701","E00174701","Total",110,52,9,43,1,36,1,35,20,18,0,0,2,1
"2011","E00002931","E00002931","Total",129,44,14,30,1,14,2,12,69,65,0,4,0,1
"2011","E00002932","E00002932","Total",120,61,23,38,1,24,4,20,32,30,0,2,0,2
"2011","E00002951","E00002951","Total",153,56,25,31,0,51,4,47,44,44,0,0,0,2
"2011","E00002953","E00002953","Total",123,48,9,39,1,3,1,2,69,69,0,0,0,2
"2011","E00002954","E00002954","Total",114,26,7,19,2,14,3,11,72,69,0,2,1,0
"2011","E00002456","E00002456","Total",153,21,4,17,10,79,4,75,41,40,0,1,0,2
"2011","E00002457","E00002457","Total",121,24,12,12,1,37,21,16,58,56,0,1,1,1
"2011","E00002468","E00002468","Total",125,38,13,25,0,20,13,7,67,67,0,0,0,0
"2011","E00002471","E00002471","Total",128,54,17,37,0,8,4,4,66,66,0,0,0,0
"2011","E00002484","E00002484","Total",130,47,24,23,1,19,5,14,62,59,1,2,0,1
"2011","E00002488","E00002488","Total",77,52,26,26,0,6,2,4,19,17,0,2,0,0
"2011","E00002489","E00002489","Total",116,76,50,26,0,12,5,7,27,26,0,1,0,1
"2011","E00002490","E00002490","Total",127,79,48,31,0,3,0,3,44,41,0,3,0,1
"2011","E00002492","E00002492","Total",110,65,35,30,0,8,1,7,34,33,1,0,0,3
"2011","E00002458","E00002458","Total",115,67,43,24,2,10,3,7,32,31,0,1,0,4
"2011","E00002491","E00002491","Total",160,17,7,10,2,20,7,13,118,112,1,4,1,3
"2011","E00002493","E00002493","Total",134,68,32,36,1,16,6,10,47,45,0,2,0,2
"2011","E00002494","E00002494","Total",124,82,44,38,1,11,3,8,28,23,1,4,0,2
"2011","E00002459","E00002459","Total",134,73,35,38,1,10,3,7,46,44,0,2,0,4
"2011","E00002460","E00002460","Total",124,97,39,58,2,4,2,2,21,20,0,1,0,0
"2011","E00002461","E00002461","Total",160,61,29,32,0,11,3,8,85,79,3,3,0,3
"2011","E00002495","E00002495","Total",125,27,11,16,0,30,7,23,66,65,0,1,0,2
"2011","E00003022","E00003022","Total",129,57,19,38,0,45,45,0,24,24,0,0,0,3
"2011","E00003024","E00003024","Total",134,21,6,15,1,92,5,87,17,15,0,0,2,3
"2011","E00003025","E00003025","Total",146,40,15,25,6,37,19,18,59,54,0,2,3,4
"2011","E00003027","E00003027","Total",122,29,12,17,0,23,18,5,69,68,0,0,1,1
"2011","E00003030","E00003030","Total",122,71,49,22,1,15,4,11,34,33,0,1,0,1
"2011","E00003028","E00003028","Total",122,86,42,44,4,10,1,9,22,21,0,1,0,0
"2011","E00003029","E00003029","Total",124,47,24,23,0,15,6,9,60,60,0,0,0,2
"2011","E00003031","E00003031","Total",126,60,28,32,1,14,7,7,48,48,0,0,0,3
"2011","E00003032","E00003032","Total",134,55,22,33,2,54,29,25,23,23,0,0,0,0
"2011","E00003033","E00003033","Total",127,36,14,22,4,33,10,23,53,52,0,1,0,1
"2011","E00002731","E00002731","Total",169,39,18,21,1,29,4,25,99,97,0,2,0,1
"2011","E00002732","E00002732","Total",138,60,24,36,0,20,4,16,58,56,0,2,0,0
"2011","E00002734","E00002734","Total",127,55,25,30,0,17,6,11,55,54,0,1,0,0
"2011","E00002735","E00002735","Total",126,47,26,21,0,19,4,15,59,58,1,0,0,1
"2011","E00002737","E00002737","Total",136,60,43,17,0,16,6,10,59,53,1,2,3,1
"2011","E00002697","E00002697","Total",148,70,24,46,0,24,13,11,51,48,0,2,1,3
"2011","E00002728","E00002728","Total",117,36,14,22,0,44,5,39,34,31,0,3,0,3
"2011","E00002729","E00002729","Total",135,74,29,45,1,5,0,5,55,53,0,2,0,0
"2011","E00002730","E00002730","Total",149,62,25,37,1,20,4,16,65,62,0,2,1,1
"2011","E00002733","E00002733","Total",134,67,33,34,1,19,7,12,46,41,0,4,1,1
"2011","E00002692","E00002692","Total",129,82,32,50,1,11,4,7,32,32,0,0,0,3
"2011","E00002695","E00002695","Total",117,71,40,31,1,11,3,8,34,32,0,1,1,0
"2011","E00002699","E00002699","Total",138,74,42,32,0,7,0,7,55,55,0,0,0,2
"2011","E00002702","E00002702","Total",128,64,37,27,1,16,15,1,41,40,0,1,0,6
"2011","E00002693","E00002693","Total",183,19,14,5,0,24,7,17,138,134,0,1,3,2
"2011","E00002694","E00002694","Total",127,7,5,2,3,55,7,48,60,59,0,0,1,2
"2011","E00002700","E00002700","Total",149,34,22,12,0,37,8,29,77,73,1,3,0,1
"2011","E00002701","E00002701","Total",201,32,18,14,0,20,5,15,147,147,0,0,0,2
"2011","E00002703","E00002703","Total",140,34,15,19,0,17,8,9,89,85,0,3,1,0
"2011","E00002696","E00002696","Total",125,60,30,30,3,10,3,7,51,50,0,1,0,1
"2011","E00002698","E00002698","Total",122,36,13,23,1,36,5,31,48,45,0,3,0,1
"2011","E00002704","E00002704","Total",141,50,20,30,2,10,3,7,79,78,0,1,0,0
"2011","E00002706","E00002706","Total",183,40,19,21,0,19,4,15,122,121,1,0,0,2
"2011","E00002736","E00002736","Total",180,37,17,20,1,6,2,4,134,133,0,1,0,2
"2011","E00002705","E00002705","Total",125,57,20,37,1,40,5,35,27,27,0,0,0,0
"2011","E00002708","E00002708","Total",137,38,11,27,1,15,8,7,80,76,0,4,0,3
"2011","E00002710","E00002710","Total",112,57,22,35,1,29,7,22,25,25,0,0,0,0
"2011","E00002711","E00002711","Total",157,53,28,25,1,39,20,19,63,63,0,0,0,1
"2011","E00002718","E00002718","Total",134,60,33,27,0,15,7,8,58,55,0,3,0,1
"2011","E00002741","E00002741","Total",122,72,32,40,1,12,4,8,35,34,0,1,0,2
"2011","E00002743","E00002743","Total",107,62,24,38,2,17,11,6,26,26,0,0,0,0
"2011","E00002744","E00002744","Total",120,97,46,51,0,2,1,1,17,17,0,0,0,4
"2011","E00002745","E00002745","Total",137,66,36,30,6,45,7,38,17,17,0,0,0,3
"2011","E00002957","E00002957","Total",92,50,21,29,2,8,4,4,32,30,0,1,1,0
"2011","E00002960","E00002960","Total",121,58,34,24,1,35,10,25,25,25,0,0,0,2
"2011","E00002963","E00002963","Total",115,69,27,42,0,12,8,4,34,31,1,1,1,0
"2011","E00002965","E00002965","Total",122,69,31,38,2,6,2,4,42,42,0,0,0,3
"2011","E00002966","E00002966","Total",117,77,43,34,0,9,4,5,29,28,0,1,0,2
"2011","E00002933","E00002933","Total",152,76,33,43,2,38,3,35,32,29,0,3,0,4
"2011","E00002938","E00002938","Total",131,49,17,32,1,15,2,13,65,61,1,3,0,1
"2011","E00002942","E00002942","Total",133,78,33,45,0,12,1,11,43,40,1,2,0,0
"2011","E00002958","E00002958","Total",115,77,33,44,1,8,3,5,29,26,0,3,0,0
"2011","E00002961","E00002961","Total",109,75,34,41,0,5,3,2,29,29,0,0,0,0
"2011","E00002941","E00002941","Total",86,38,21,17,1,19,14,5,27,23,0,3,1,1
"2011","E00002944","E00002944","Total",97,8,0,8,0,82,69,13,4,3,0,0,1,3
"2011","E00002945","E00002945","Total",122,57,17,40,0,4,0,4,61,61,0,0,0,0
"2011","E00002947","E00002947","Total",149,98,52,46,1,8,6,2,38,37,0,1,0,4
"2011","E00002968","E00002968","Total",158,31,6,25,0,10,3,7,114,110,0,3,1,3
"2011","E00002975","E00002975","Total",138,98,42,56,0,14,4,10,23,20,0,3,0,3
"2011","E00002979","E00002979","Total",120,80,43,37,1,15,4,11,22,22,0,0,0,2
"2011","E00002999","E00002999","Total",147,35,19,16,1,2,0,2,109,105,0,1,3,0
"2011","E00002982","E00002982","Total",132,86,36,50,0,8,3,5,35,32,0,2,1,3
"2011","E00002984","E00002984","Total",117,43,24,19,0,13,6,7,60,60,0,0,0,1
"2011","E00002985","E00002985","Total",130,96,61,35,0,4,2,2,28,23,0,5,0,2
"2011","E00002991","E00002991","Total",149,85,45,40,0,42,5,37,20,19,0,0,1,2
"2011","E00002969","E00002969","Total",114,58,31,27,1,34,0,34,19,19,0,0,0,2
"2011","E00002983","E00002983","Total",131,98,50,48,3,3,0,3,23,22,0,0,1,4
"2011","E00002989","E00002989","Total",125,94,54,40,2,4,0,4,24,24,0,0,0,1
"2011","E00002993","E00002993","Total",130,94,46,48,1,16,7,9,17,17,0,0,0,2
"2011","E00002980","E00002980","Total",117,86,44,42,4,6,3,3,18,18,0,0,0,3
"2011","E00002981","E00002981","Total",119,91,49,42,1,7,3,4,18,18,0,0,0,2
"2011","E00002986","E00002986","Total",130,95,59,36,1,10,8,2,23,21,1,1,0,1
"2011","E00002988","E00002988","Total",107,73,49,24,2,10,2,8,22,21,0,1,0,0
"2011","E00174551","E00174551","Total",103,11,5,6,2,68,62,6,20,19,0,0,1,2
"2011","E00174556","E00174556","Total",217,13,5,8,64,68,9,59,71,70,0,0,1,1
"2011","E00174693","E00174693","Total",200,13,4,9,41,79,17,62,65,54,2,7,2,2
"2011","E00174722","E00174722","Total",118,5,2,3,0,50,17,33,60,59,0,1,0,3
"2011","E00002970","E00002970","Total",146,38,14,24,0,3,0,3,105,104,1,0,0,0
"2011","E00002971","E00002971","Total",130,80,40,40,2,9,2,7,39,38,0,1,0,0
"2011","E00002972","E00002972","Total",152,87,45,42,3,8,3,5,54,53,0,1,0,0
"2011","E00003000","E00003000","Total",134,46,18,28,0,4,1,3,83,77,1,5,0,1
"2011","E00002464","E00002464","Total",126,53,20,33,1,14,10,4,56,51,2,3,0,2
"2011","E00002466","E00002466","Total",143,48,25,23,0,31,14,17,64,57,0,5,2,0
"2011","E00002474","E00002474","Total",123,71,32,39,0,13,4,9,38,38,0,0,0,1
"2011","E00002477","E00002477","Total",154,65,29,36,0,64,47,17,23,22,0,1,0,2
"2011","E00002478","E00002478","Total",130,39,21,18,1,18,8,10,72,69,0,2,1,0
"2011","E00002469","E00002469","Total",120,81,50,31,2,7,4,3,29,28,0,1,0,1
"2011","E00002479","E00002479","Total",120,92,67,25,0,4,2,2,21,21,0,0,0,3
"2011","E00002481","E00002481","Total",163,69,37,32,3,46,8,38,43,41,0,2,0,2
"2011","E00002482","E00002482","Total",122,6,2,4,0,94,10,84,20,15,0,0,5,2
"2011","E00002462","E00002462","Total",111,75,39,36,0,13,4,9,22,22,0,0,0,1
"2011","E00002463","E00002463","Total",117,76,49,27,0,16,6,10,24,24,0,0,0,1
"2011","E00002473","E00002473","Total",123,86,54,32,2,4,2,2,30,29,0,1,0,1
"2011","E00002480","E00002480","Total",157,58,31,27,2,43,18,25,52,49,2,1,0,2
"2011","E00002465","E00002465","Total",126,59,28,31,0,14,4,10,52,51,0,1,0,1
"2011","E00002467","E00002467","Total",123,85,44,41,0,11,3,8,27,27,0,0,0,0
"2011","E00002470","E00002470","Total",109,57,21,36,0,13,2,11,39,36,0,1,2,0
"2011","E00002472","E00002472","Total",120,86,41,45,0,12,6,6,21,19,0,2,0,1
"2011","E00002475","E00002475","Total",132,51,26,25,0,19,8,11,61,61,0,0,0,1
"2011","E00002707","E00002707","Total",139,46,13,33,1,26,6,20,66,63,0,3,0,0
"2011","E00002709","E00002709","Total",121,42,19,23,0,57,10,47,21,18,0,2,1,1
"2011","E00002712","E00002712","Total",102,23,7,16,0,25,1,24,54,53,0,1,0,0
"2011","E00002715","E00002715","Total",154,54,19,35,12,27,9,18,61,60,0,1,0,0
"2011","E00002717","E00002717","Total",134,35,12,23,0,22,2,20,76,74,0,0,2,1
"2011","E00002930","E00002930","Total",134,65,32,33,0,21,3,18,44,43,0,1,0,4
"2011","E00002936","E00002936","Total",127,69,36,33,0,20,3,17,36,35,0,1,0,2
"2011","E00002943","E00002943","Total",117,49,29,20,0,32,9,23,33,30,0,2,1,3
"2011","E00002956","E00002956","Total",114,76,34,42,0,7,3,4,31,31,0,0,0,0
"2011","E00002959","E00002959","Total",129,51,13,38,0,28,17,11,49,48,0,1,0,1
"2011","E00002946","E00002946","Total",143,70,28,42,1,23,21,2,49,43,0,4,2,0
"2011","E00002948","E00002948","Total",125,64,30,34,2,6,1,5,51,46,1,4,0,2
"2011","E00002949","E00002949","Total",145,88,42,46,0,29,27,2,27,25,1,1,0,1
"2011","E00002950","E00002950","Total",108,58,28,30,1,30,17,13,15,14,0,1,0,4
"2011","E00003047","E00003047","Total",133,56,20,36,16,8,4,4,52,48,0,3,1,1
"2011","E00003054","E00003054","Total",133,101,56,45,1,6,6,0,25,22,0,3,0,0
"2011","E00003057","E00003057","Total",128,87,52,35,2,2,1,1,34,32,0,0,2,3
"2011","E00003058","E00003058","Total",128,80,46,34,0,2,0,2,44,42,0,2,0,2
"2011","E00003049","E00003049","Total",150,72,37,35,0,21,11,10,53,49,1,3,0,4
"2011","E00003051","E00003051","Total",124,49,35,14,0,20,7,13,50,44,1,1,4,5
"2011","E00003053","E00003053","Total",123,76,44,32,0,4,0,4,42,40,0,1,1,1
"2011","E00003059","E00003059","Total",157,66,37,29,1,9,2,7,75,72,0,1,2,6
"2011","E00003048","E00003048","Total",106,32,18,14,0,12,0,12,61,56,1,0,4,1
"2011","E00003063","E00003063","Total",127,90,36,54,1,4,2,2,32,30,0,2,0,0
"2011","E00003064","E00003064","Total",148,37,8,29,0,55,12,43,53,50,0,3,0,3
"2011","E00003068","E00003068","Total",108,61,27,34,1,17,14,3,29,28,0,1,0,0
"2011","E00174684","E00174684","Total",106,47,10,37,1,0,0,0,57,55,0,2,0,1
"2011","E00174735","E00174735","Total",101,35,13,22,4,33,4,29,29,27,0,1,1,0
"2011","E00002973","E00002973","Total",130,56,26,30,1,9,8,1,62,62,0,0,0,2
"2011","E00002974","E00002974","Total",137,76,42,34,1,15,4,11,44,42,0,2,0,1
"2011","E00002976","E00002976","Total",155,69,39,30,0,11,2,9,73,71,0,2,0,2
"2011","E00002977","E00002977","Total",164,69,39,30,2,20,10,10,71,69,1,1,0,2
"2011","E00002987","E00002987","Total",118,79,49,30,0,2,2,0,33,33,0,0,0,4
"2011","E00002990","E00002990","Total",124,85,50,35,0,4,2,2,31,28,0,3,0,4
"2011","E00002992","E00002992","Total",132,69,40,29,0,8,0,8,48,44,0,3,1,7
"2011","E00002994","E00002994","Total",126,92,48,44,0,4,1,3,27,27,0,0,0,3
"2011","E00002995","E00002995","Total",110,78,50,28,0,4,1,3,27,26,0,1,0,1
"2011","E00002996","E00002996","Total",132,83,39,44,2,5,3,2,40,38,0,1,1,2
"2011","E00002997","E00002997","Total",142,85,36,49,3,10,7,3,44,40,2,2,0,0
"2011","E00002998","E00002998","Total",130,55,32,23,0,5,4,1,67,66,1,0,0,3
"2011","E00003041","E00003041","Total",128,63,39,24,1,8,4,4,56,53,1,2,0,0
"2011","E00003042","E00003042","Total",141,58,16,42,0,28,16,12,51,46,1,2,2,4
"2011","E00003065","E00003065","Total",123,72,33,39,3,4,1,3,44,41,0,3,0,0
"2011","E00174683","E00174683","Total",128,42,14,28,1,18,12,6,67,62,1,3,1,0
"2011","E00174687","E00174687","Total",125,8,3,5,27,73,7,66,17,15,0,0,2,0
"2011","E00174729","E00174729","Total",129,45,10,35,1,12,1,11,70,68,1,1,0,1
"2011","E00003043","E00003043","Total",124,78,41,37,2,7,0,7,37,35,1,1,0,0
"2011","E00003045","E00003045","Total",125,54,24,30,1,5,2,3,63,61,1,0,1,2
"2011","E00003046","E00003046","Total",134,92,57,35,3,7,3,4,32,30,2,0,0,0
"2011","E00003050","E00003050","Total",135,95,49,46,0,5,0,5,32,30,0,0,2,3
"2011","E00002913","E00002913","Total",131,41,19,22,0,68,52,16,13,13,0,0,0,9
"2011","E00002914","E00002914","Total",116,20,5,15,0,80,38,42,8,8,0,0,0,8
"2011","E00002916","E00002916","Total",129,34,15,19,0,72,24,48,19,18,0,1,0,4
"2011","E00002918","E00002918","Total",142,13,6,7,0,102,78,24,25,25,0,0,0,2
"2011","E00002926","E00002926","Total",122,13,7,6,1,74,66,8,32,32,0,0,0,2
"2011","E00002899","E00002899","Total",103,9,2,7,1,64,7,57,25,24,0,0,1,4
"2011","E00002900","E00002900","Total",119,23,5,18,2,84,75,9,6,4,0,1,1,4
"2011","E00002901","E00002901","Total",98,27,15,12,0,38,9,29,32,29,0,1,2,1
"2011","E00002907","E00002907","Total",157,32,12,20,1,100,23,77,23,21,0,0,2,1
"2011","E00002887","E00002887","Total",122,90,49,41,2,12,5,7,17,16,0,1,0,1
"2011","E00002902","E00002902","Total",128,24,11,13,0,96,83,13,6,6,0,0,0,2
"2011","E00002904","E00002904","Total",124,29,11,18,2,75,67,8,16,16,0,0,0,2
"2011","E00002906","E00002906","Total",138,17,8,9,2,109,98,11,5,5,0,0,0,5
"2011","E00002888","E00002888","Total",145,47,11,36,2,24,11,13,72,71,0,1,0,0
"2011","E00002903","E00002903","Total",90,45,24,21,1,21,9,12,21,21,0,0,0,2
"2011","E00002905","E00002905","Total",108,44,17,27,5,9,4,5,49,42,0,7,0,1
"2011","E00002910","E00002910","Total",115,27,7,20,21,24,4,20,43,42,0,0,1,0
"2011","E00002911","E00002911","Total",118,7,2,5,6,94,8,86,9,9,0,0,0,2
"2011","E00002908","E00002908","Total",134,34,9,25,0,90,80,10,9,9,0,0,0,1
"2011","E00002909","E00002909","Total",143,17,4,13,2,114,105,9,9,9,0,0,0,1
"2011","E00002912","E00002912","Total",140,19,4,15,8,101,87,14,11,11,0,0,0,1
"2011","E00002917","E00002917","Total",131,26,7,19,1,92,81,11,12,12,0,0,0,0
"2011","E00002920","E00002920","Total",135,16,3,13,2,106,93,13,8,7,0,1,0,3
"2011","E00002923","E00002923","Total",124,17,10,7,0,95,84,11,12,11,0,0,1,0
"2011","E00002924","E00002924","Total",180,49,21,28,1,122,75,47,6,6,0,0,0,2
"2011","E00002925","E00002925","Total",114,16,8,8,0,90,73,17,6,6,0,0,0,2
"2011","E00002387","E00002387","Total",123,89,48,41,1,1,0,1,29,26,0,0,3,3
"2011","E00002397","E00002397","Total",114,47,19,28,0,47,37,10,19,18,0,0,1,1
"2011","E00002413","E00002413","Total",172,39,13,26,0,30,16,14,102,100,0,1,1,1
"2011","E00002418","E00002418","Total",124,45,18,27,2,36,30,6,41,40,0,0,1,0
"2011","E00003083","E00003083","Total",112,38,15,23,1,20,6,14,52,49,1,2,0,1
"2011","E00003084","E00003084","Total",136,39,16,23,3,39,5,34,51,50,0,1,0,4
"2011","E00003086","E00003086","Total",126,48,25,23,1,21,2,19,52,50,0,1,1,4
"2011","E00003093","E00003093","Total",128,40,15,25,0,33,3,30,54,51,0,3,0,1
"2011","E00003100","E00003100","Total",134,50,22,28,1,40,4,36,42,39,0,3,0,1
"2011","E00003087","E00003087","Total",127,56,30,26,0,11,3,8,59,59,0,0,0,1
"2011","E00003089","E00003089","Total",123,38,12,26,0,15,4,11,68,65,0,2,1,2
"2011","E00003092","E00003092","Total",180,34,12,22,1,23,2,21,117,116,0,1,0,5
"2011","E00003096","E00003096","Total",137,16,6,10,2,24,0,24,95,92,0,1,2,0
"2011","E00003099","E00003099","Total",149,63,28,35,0,22,1,21,61,59,0,1,1,3
"2011","E00003097","E00003097","Total",152,17,8,9,0,8,0,8,124,121,1,0,2,3
"2011","E00003101","E00003101","Total",142,37,12,25,1,20,3,17,82,80,0,1,1,2
"2011","E00003103","E00003103","Total",141,33,16,17,1,55,22,33,49,49,0,0,0,3
"2011","E00003104","E00003104","Total",177,47,15,32,44,33,14,19,51,49,0,2,0,2
"2011","E00003105","E00003105","Total",163,25,12,13,1,11,1,10,125,124,1,0,0,1
"2011","E00003106","E00003106","Total",140,31,11,20,3,42,3,39,59,59,0,0,0,5
"2011","E00003073","E00003073","Total",123,54,27,27,0,27,4,23,40,40,0,0,0,2
"2011","E00003075","E00003075","Total",129,63,21,42,0,23,5,18,40,40,0,0,0,3
"2011","E00003098","E00003098","Total",132,37,13,24,0,46,6,40,47,47,0,0,0,2
"2011","E00003108","E00003108","Total",145,51,35,16,0,29,5,24,61,57,2,2,0,4
"2011","E00003109","E00003109","Total",199,44,17,27,15,71,15,56,66,64,0,2,0,3
"2011","E00002383","E00002383","Total",147,62,27,35,0,16,1,15,65,64,0,1,0,4
"2011","E00002393","E00002393","Total",190,58,22,36,1,41,9,32,89,86,0,3,0,1
"2011","E00002416","E00002416","Total",168,39,11,28,1,24,10,14,100,100,0,0,0,4
"2011","E00002420","E00002420","Total",109,44,18,26,1,19,6,13,42,40,0,2,0,3
"2011","E00002421","E00002421","Total",173,46,14,32,1,27,2,25,99,99,0,0,0,0
"2011","E00002392","E00002392","Total",211,53,29,24,1,58,32,26,97,88,0,7,2,2
"2011","E00002406","E00002406","Total",131,69,41,28,0,30,7,23,29,28,0,1,0,3
"2011","E00002412","E00002412","Total",116,40,9,31,0,23,7,16,52,50,0,2,0,1
"2011","E00002414","E00002414","Total",115,52,18,34,5,18,18,0,39,39,0,0,0,1
"2011","E00002415","E00002415","Total",151,70,41,29,0,20,5,15,55,54,0,1,0,6
"2011","E00002386","E00002386","Total",147,59,25,34,0,13,5,8,73,68,0,5,0,2
"2011","E00002407","E00002407","Total",147,45,14,31,0,46,26,20,56,55,0,0,1,0
"2011","E00002408","E00002408","Total",131,23,8,15,1,79,70,9,26,26,0,0,0,2
"2011","E00002409","E00002409","Total",122,29,13,16,7,51,43,8,33,33,0,0,0,2
"2011","E00002410","E00002410","Total",158,31,12,19,0,82,39,43,39,35,0,0,4,6
"2011","E00002411","E00002411","Total",145,37,18,19,0,61,7,54,46,42,2,1,1,1
"2011","E00002713","E00002713","Total",127,53,37,16,1,15,7,8,54,53,0,1,0,4
"2011","E00002714","E00002714","Total",94,43,19,24,0,8,1,7,41,39,0,2,0,2
"2011","E00002716","E00002716","Total",136,13,7,6,0,39,4,35,83,80,0,0,3,1
"2011","E00002720","E00002720","Total",94,33,17,16,0,10,3,7,51,49,0,2,0,0
"2011","E00002724","E00002724","Total",127,55,20,35,0,28,14,14,43,42,0,1,0,1
"2011","E00002725","E00002725","Total",149,64,24,40,0,20,10,10,62,62,0,0,0,3
"2011","E00002719","E00002719","Total",134,31,12,19,7,49,40,9,47,45,0,1,1,0
"2011","E00002721","E00002721","Total",130,16,7,9,1,102,99,3,11,10,0,0,1,0
"2011","E00002722","E00002722","Total",154,69,30,39,0,10,8,2,75,75,0,0,0,0
"2011","E00002723","E00002723","Total",148,52,25,27,1,45,38,7,49,46,0,3,0,1
"2011","E00002726","E00002726","Total",124,14,7,7,0,97,94,3,13,12,0,0,1,0
"2011","E00002727","E00002727","Total",133,49,20,29,1,0,0,0,80,79,0,1,0,3
"2011","E00003081","E00003081","Total",161,27,13,14,3,51,10,41,79,77,0,2,0,1
"2011","E00003082","E00003082","Total",120,36,9,27,0,30,4,26,52,51,0,1,0,2
"2011","E00003090","E00003090","Total",152,30,19,11,0,27,6,21,93,90,1,1,1,2
"2011","E00003091","E00003091","Total",137,29,17,12,0,39,3,36,67,67,0,0,0,2
"2011","E00003095","E00003095","Total",145,37,19,18,3,28,3,25,75,75,0,0,0,2
"2011","E00003071","E00003071","Total",135,41,17,24,12,28,3,25,53,52,0,1,0,1
"2011","E00003072","E00003072","Total",147,23,13,10,3,38,2,36,81,79,0,0,2,2
"2011","E00003088","E00003088","Total",166,39,19,20,12,9,0,9,103,103,0,0,0,3
"2011","E00003102","E00003102","Total",205,30,8,22,4,50,4,46,117,114,0,2,1,4
"2011","E00003107","E00003107","Total",149,41,28,13,0,10,6,4,94,92,0,0,2,4
"2011","E00003078","E00003078","Total",181,37,21,16,3,76,8,68,59,59,0,0,0,6
"2011","E00003079","E00003079","Total",135,39,18,21,2,41,8,33,51,49,0,1,1,2
"2011","E00003080","E00003080","Total",142,29,15,14,1,30,4,26,80,78,0,1,1,2
"2011","E00003085","E00003085","Total",141,46,14,32,1,35,5,30,59,58,0,1,0,0
"2011","E00003094","E00003094","Total",116,44,22,22,0,23,4,19,46,43,1,0,2,3
"2011","E00003069","E00003069","Total",115,8,5,3,2,96,12,84,7,6,0,1,0,2
"2011","E00003070","E00003070","Total",160,22,11,11,14,86,15,71,34,33,0,0,1,4
"2011","E00003076","E00003076","Total",183,19,8,11,1,149,51,98,12,7,0,2,3,2
"2011","E00003077","E00003077","Total",162,5,2,3,42,105,42,63,7,6,0,1,0,3
"2011","E00174688","E00174688","Total",110,56,15,41,2,26,1,25,26,22,0,3,1,0
"2011","E00174689","E00174689","Total",110,41,18,23,0,35,9,26,31,27,0,3,1,3
"2011","E00002476","E00002476","Total",189,11,2,9,11,87,16,71,77,76,0,0,1,3
"2011","E00002483","E00002483","Total",142,17,6,11,0,110,17,93,13,13,0,0,0,2
"2011","E00002485","E00002485","Total",120,42,21,21,4,43,24,19,28,28,0,0,0,3
"2011","E00002486","E00002486","Total",137,43,21,22,2,29,4,25,59,58,0,1,0,4
"2011","E00002487","E00002487","Total",128,55,31,24,2,26,10,16,44,42,0,2,0,1
"2011","E00002534","E00002534","Total",168,45,26,19,4,63,13,50,51,51,0,0,0,5
"2011","E00002538","E00002538","Total",233,57,23,34,0,65,16,49,105,98,0,5,2,6
"2011","E00002544","E00002544","Total",147,16,4,12,3,73,7,66,54,54,0,0,0,1
"2011","E00002545","E00002545","Total",142,30,15,15,3,38,15,23,70,69,0,0,1,1
"2011","E00002546","E00002546","Total",215,13,4,9,0,94,15,79,106,104,0,2,0,2
"2011","E00002532","E00002532","Total",160,78,34,44,2,37,3,34,38,38,0,0,0,5
"2011","E00002535","E00002535","Total",143,10,2,8,0,111,29,82,21,19,0,0,2,1
"2011","E00002537","E00002537","Total",127,54,19,35,1,36,9,27,32,32,0,0,0,4
"2011","E00002567","E00002567","Total",160,72,30,42,1,33,5,28,54,50,0,2,2,0
"2011","E00002570","E00002570","Total",120,19,3,16,3,86,17,69,10,10,0,0,0,2
"2011","E00002558","E00002558","Total",207,34,11,23,20,113,18,95,37,36,0,1,0,3
"2011","E00002559","E00002559","Total",148,40,20,20,0,63,13,50,39,39,0,0,0,6
"2011","E00002560","E00002560","Total",125,21,7,14,2,90,15,75,11,10,0,0,1,1
"2011","E00002563","E00002563","Total",123,18,6,12,0,92,16,76,13,13,0,0,0,0
"2011","E00174694","E00174694","Total",100,12,4,8,0,82,11,71,6,6,0,0,0,0
"2011","E00174726","E00174726","Total",110,8,3,5,1,94,16,78,6,4,0,1,1,1
"2011","E00002533","E00002533","Total",205,75,37,38,1,57,10,47,68,64,0,4,0,4
"2011","E00002561","E00002561","Total",168,53,22,31,2,57,11,46,52,51,0,1,0,4
"2011","E00002564","E00002564","Total",159,51,33,18,2,39,9,30,62,59,0,2,1,5
"2011","E00002565","E00002565","Total",144,37,14,23,1,55,6,49,48,46,0,2,0,3
"2011","E00002568","E00002568","Total",137,38,10,28,0,39,7,32,55,53,0,1,1,5
"2011","E00002531","E00002531","Total",112,5,1,4,1,102,16,86,4,3,0,0,1,0
"2011","E00002536","E00002536","Total",53,2,2,0,15,32,2,30,0,0,0,0,0,4
"2011","E00002562","E00002562","Total",133,2,0,2,0,126,23,103,2,2,0,0,0,3
"2011","E00002566","E00002566","Total",133,16,4,12,2,93,14,79,20,18,0,0,2,2
"2011","E00002569","E00002569","Total",169,46,14,32,1,88,13,75,29,29,0,0,0,5
"2011","E00002321","E00002321","Total",122,81,33,48,1,8,7,1,29,28,1,0,0,3
"2011","E00002323","E00002323","Total",120,71,26,45,1,24,21,3,24,22,0,1,1,0
"2011","E00002324","E00002324","Total",115,72,30,42,1,12,6,6,29,27,0,1,1,1
"2011","E00002325","E00002325","Total",112,84,30,54,1,5,4,1,21,15,0,6,0,1
"2011","E00002329","E00002329","Total",132,72,31,41,1,26,24,2,32,27,0,4,1,1
"2011","E00002331","E00002331","Total",118,65,23,42,1,44,41,3,6,6,0,0,0,2
"2011","E00002333","E00002333","Total",123,83,46,37,0,6,3,3,33,27,1,4,1,1
"2011","E00002335","E00002335","Total",128,77,24,53,0,35,26,9,16,15,0,1,0,0
"2011","E00002310","E00002310","Total",120,83,41,42,0,15,12,3,19,15,0,2,2,3
"2011","E00002312","E00002312","Total",109,82,52,30,0,7,3,4,17,15,0,1,1,3
"2011","E00002315","E00002315","Total",114,79,41,38,1,16,14,2,18,18,0,0,0,0
"2011","E00002342","E00002342","Total",112,77,34,43,0,2,1,1,32,27,0,4,1,1
"2011","E00002319","E00002319","Total",118,67,23,44,0,33,13,20,17,15,0,0,2,1
"2011","E00002337","E00002337","Total",137,58,22,36,0,10,5,5,66,65,0,1,0,3
"2011","E00002338","E00002338","Total",128,79,39,40,1,6,1,5,39,37,0,2,0,3
"2011","E00002339","E00002339","Total",136,57,15,42,0,9,6,3,70,66,0,3,1,0
"2011","E00002341","E00002341","Total",137,73,25,48,0,13,6,7,50,48,0,2,0,1
"2011","E00003044","E00003044","Total",159,10,5,5,0,129,64,65,17,17,0,0,0,3
"2011","E00003052","E00003052","Total",212,34,8,26,20,114,8,106,43,39,0,3,1,1
"2011","E00174682","E00174682","Total",123,69,27,42,3,19,11,8,32,32,0,0,0,0
"2011","E00174721","E00174721","Total",96,44,26,18,2,12,7,5,38,38,0,0,0,0
"2011","E00174727","E00174727","Total",110,45,25,20,0,11,6,5,49,48,0,1,0,5
"2011","E00174728","E00174728","Total",68,22,6,16,6,26,10,16,13,12,0,1,0,1
"2011","E00002891","E00002891","Total",136,36,20,16,1,71,13,58,23,23,0,0,0,5
"2011","E00002893","E00002893","Total",133,15,7,8,10,82,17,65,23,21,0,2,0,3
"2011","E00002915","E00002915","Total",135,33,17,16,1,58,29,29,42,41,0,1,0,1
"2011","E00002919","E00002919","Total",178,63,28,35,1,75,14,61,37,36,0,1,0,2
"2011","E00002883","E00002883","Total",206,12,1,11,38,125,59,66,27,27,0,0,0,4
"2011","E00002897","E00002897","Total",146,11,2,9,5,121,30,91,8,8,0,0,0,1
"2011","E00174702","E00174702","Total",137,1,1,0,5,121,35,86,6,5,0,0,1,4
"2011","E00002886","E00002886","Total",111,1,0,1,1,97,43,54,10,9,0,0,1,2
"2011","E00002894","E00002894","Total",138,20,10,10,0,85,41,44,31,30,0,0,1,2
"2011","E00002898","E00002898","Total",148,20,11,9,0,101,51,50,23,20,0,1,2,4
"2011","E00174691","E00174691","Total",128,15,3,12,2,99,51,48,12,12,0,0,0,0
"2011","E00174692","E00174692","Total",128,17,4,13,2,77,39,38,31,28,0,2,1,1
"2011","E00174715","E00174715","Total",130,22,6,16,25,21,5,16,61,59,0,1,1,1
"2011","E00002892","E00002892","Total",209,18,4,14,0,168,79,89,21,18,0,1,2,2
"2011","E00002921","E00002921","Total",108,5,3,2,4,96,48,48,3,3,0,0,0,0
"2011","E00002922","E00002922","Total",127,15,4,11,1,80,30,50,27,27,0,0,0,4
"2011","E00002928","E00002928","Total",117,27,13,14,0,79,28,51,8,8,0,0,0,3
"2011","E00002929","E00002929","Total",118,2,1,1,1,110,40,70,3,3,0,0,0,2
"2011","E00174725","E00174725","Total",64,2,0,2,0,56,29,27,1,1,0,0,0,5
"2011","E00002639","E00002639","Total",176,62,30,32,0,55,22,33,59,56,0,1,2,0
"2011","E00002683","E00002683","Total",124,31,11,20,0,46,38,8,41,40,0,0,1,6
"2011","E00002684","E00002684","Total",124,44,14,30,0,36,5,31,42,37,1,1,3,2
"2011","E00002686","E00002686","Total",140,36,15,21,0,32,0,32,72,70,0,2,0,0
"2011","E00002687","E00002687","Total",158,29,8,21,1,24,12,12,103,99,3,1,0,1
"2011","E00002689","E00002689","Total",134,20,5,15,0,14,4,10,96,90,0,3,3,4
"2011","E00002640","E00002640","Total",116,40,14,26,1,31,6,25,44,43,0,1,0,0
"2011","E00002642","E00002642","Total",148,19,8,11,4,47,2,45,78,77,0,1,0,0
"2011","E00002685","E00002685","Total",129,55,24,31,0,25,4,21,48,46,0,2,0,1
"2011","E00002688","E00002688","Total",115,87,48,39,0,8,4,4,19,16,1,2,0,1
"2011","E00002690","E00002690","Total",119,27,11,16,1,13,3,10,78,77,1,0,0,0
"2011","E00002691","E00002691","Total",129,22,7,15,1,26,12,14,78,76,0,2,0,2
"2011","E00002643","E00002643","Total",142,45,19,26,1,38,6,32,55,54,0,1,0,3
"2011","E00002644","E00002644","Total",133,22,5,17,0,69,9,60,42,42,0,0,0,0
"2011","E00002645","E00002645","Total",111,66,28,38,0,8,0,8,34,33,0,1,0,3
"2011","E00002647","E00002647","Total",132,72,35,37,0,24,2,22,35,34,0,0,1,1
"2011","E00002648","E00002648","Total",115,48,19,29,0,19,0,19,47,44,0,2,1,1
"2011","E00002651","E00002651","Total",135,34,14,20,1,56,5,51,41,41,0,0,0,3
"2011","E00002646","E00002646","Total",130,12,2,10,0,65,29,36,51,50,0,1,0,2
"2011","E00002649","E00002649","Total",199,85,19,66,6,16,6,10,91,86,0,5,0,1
"2011","E00002650","E00002650","Total",148,9,7,2,0,92,71,21,45,43,0,1,1,2
"2011","E00002653","E00002653","Total",104,26,15,11,2,54,26,28,22,22,0,0,0,0
"2011","E00002654","E00002654","Total",150,44,7,37,0,36,6,30,70,67,0,3,0,0
"2011","E00174681","E00174681","Total",168,69,30,39,0,14,10,4,83,76,0,7,0,2
"2011","E00174686","E00174686","Total",115,21,10,11,0,18,12,6,76,75,0,1,0,0
"2011","E00002641","E00002641","Total",214,105,42,63,0,18,3,15,91,87,0,4,0,0
"2011","E00002652","E00002652","Total",135,68,25,43,1,25,8,17,37,36,0,1,0,4
"2011","E00002655","E00002655","Total",120,57,21,36,0,32,2,30,31,31,0,0,0,0
"2011","E00002657","E00002657","Total",110,55,16,39,0,21,7,14,34,33,0,1,0,0
"2011","E00002658","E00002658","Total",133,62,27,35,1,9,2,7,59,59,0,0,0,2
"2011","E00002662","E00002662","Total",171,64,22,42,6,37,3,34,64,60,0,4,0,0
"2011","E00002326","E00002326","Total",118,53,25,28,0,2,0,2,63,60,0,0,3,0
"2011","E00002327","E00002327","Total",126,40,5,35,0,0,0,0,84,84,0,0,0,2
"2011","E00002328","E00002328","Total",129,45,11,34,0,8,4,4,75,72,0,1,2,1
"2011","E00174705","E00174705","Total",139,70,31,39,1,19,3,16,46,44,0,0,2,3
"2011","E00002311","E00002311","Total",116,40,15,25,10,17,11,6,47,45,0,2,0,2
"2011","E00002313","E00002313","Total",139,60,36,24,9,24,2,22,43,40,0,1,2,3
"2011","E00002332","E00002332","Total",133,85,49,36,3,2,1,1,39,30,1,3,5,4
"2011","E00002336","E00002336","Total",132,63,36,27,1,21,12,9,43,38,0,2,3,4
"2011","E00002330","E00002330","Total",124,48,26,22,1,7,1,6,61,57,1,1,2,7
"2011","E00002334","E00002334","Total",112,65,27,38,1,11,3,8,33,31,0,1,1,2
"2011","E00002343","E00002343","Total",130,90,43,47,0,9,5,4,31,29,0,2,0,0
"2011","E00174723","E00174723","Total",118,84,45,39,2,11,4,7,20,18,0,1,1,1
"2011","E00174724","E00174724","Total",112,18,2,16,12,57,1,56,25,25,0,0,0,0
"2011","E00002314","E00002314","Total",110,82,37,45,1,8,3,5,17,13,0,4,0,2
"2011","E00002316","E00002316","Total",120,65,34,31,1,23,6,17,29,25,1,3,0,2
"2011","E00002322","E00002322","Total",107,68,40,28,0,8,3,5,26,26,0,0,0,5
"2011","E00002340","E00002340","Total",110,72,36,36,0,6,1,5,30,28,0,2,0,2
"2011","E00003056","E00003056","Total",122,79,49,30,2,2,1,1,34,30,0,2,2,5
"2011","E00003060","E00003060","Total",144,83,46,37,1,5,0,5,53,46,0,6,1,2
"2011","E00003061","E00003061","Total",148,99,54,45,0,4,1,3,40,38,1,0,1,5
"2011","E00003062","E00003062","Total",134,84,53,31,0,2,1,1,45,44,0,0,1,3
"2011","E00002391","E00002391","Total",112,79,39,40,0,7,4,3,24,23,0,1,0,2
"2011","E00002394","E00002394","Total",118,65,34,31,1,10,4,6,40,38,2,0,0,2
"2011","E00002395","E00002395","Total",114,52,20,32,0,43,38,5,14,13,0,1,0,5
"2011","E00002417","E00002417","Total",130,25,15,10,1,74,7,67,27,26,0,0,1,3
"2011","E00002419","E00002419","Total",119,76,45,31,1,9,5,4,32,31,0,0,1,1
"2011","E00002384","E00002384","Total",235,69,25,44,0,67,25,42,94,93,0,1,0,5
"2011","E00002385","E00002385","Total",138,76,43,33,0,34,29,5,23,22,1,0,0,5
"2011","E00002388","E00002388","Total",129,70,25,45,0,8,7,1,46,44,1,1,0,5
"2011","E00002390","E00002390","Total",148,42,19,23,1,57,30,27,46,43,0,2,1,2
"2011","E00002398","E00002398","Total",156,97,50,47,1,29,13,16,24,23,0,0,1,5
"2011","E00002389","E00002389","Total",105,84,44,40,0,7,5,2,14,13,0,1,0,0
"2011","E00002396","E00002396","Total",108,69,34,35,1,19,4,15,18,17,1,0,0,1
"2011","E00002399","E00002399","Total",125,86,48,38,0,6,3,3,32,30,0,2,0,1
"2011","E00002401","E00002401","Total",129,85,31,54,0,13,2,11,30,29,0,1,0,1
"2011","E00002400","E00002400","Total",110,90,44,46,0,4,1,3,15,15,0,0,0,1
"2011","E00002402","E00002402","Total",123,87,45,42,0,8,5,3,24,22,0,1,1,4
"2011","E00002403","E00002403","Total",110,77,52,25,1,11,3,8,19,19,0,0,0,2
"2011","E00002404","E00002404","Total",99,83,50,33,0,1,1,0,13,11,0,2,0,2
"2011","E00002405","E00002405","Total",136,75,25,50,0,18,4,14,40,37,0,3,0,3
"2011","E00002828","E00002828","Total",110,54,25,29,0,24,8,16,26,26,0,0,0,6
"2011","E00002829","E00002829","Total",121,37,19,18,0,28,2,26,53,50,0,3,0,3
"2011","E00002830","E00002830","Total",125,74,39,35,0,15,5,10,35,34,0,1,0,1
"2011","E00002832","E00002832","Total",120,48,13,35,0,16,6,10,56,54,1,0,1,0
"2011","E00002837","E00002837","Total",127,59,36,23,1,37,12,25,30,26,0,3,1,0
"2011","E00002539","E00002539","Total",184,53,12,41,3,69,13,56,56,53,0,1,2,3
"2011","E00002540","E00002540","Total",155,56,26,30,1,51,8,43,44,43,0,1,0,3
"2011","E00002541","E00002541","Total",183,68,21,47,1,58,13,45,54,54,0,0,0,2
"2011","E00002542","E00002542","Total",198,64,26,38,0,68,23,45,58,58,0,0,0,8
"2011","E00174706","E00174706","Total",137,11,3,8,2,39,14,25,85,82,0,1,2,0
"2011","E00174707","E00174707","Total",86,4,3,1,0,9,1,8,72,70,0,0,2,1
"2011","E00174709","E00174709","Total",50,8,2,6,1,28,5,23,12,12,0,0,0,1
"2011","E00002547","E00002547","Total",120,9,4,5,0,56,6,50,51,49,0,2,0,4
"2011","E00002548","E00002548","Total",132,23,7,16,5,66,18,48,37,36,0,0,1,1
"2011","E00002549","E00002549","Total",206,25,9,16,2,85,14,71,91,88,0,0,3,3
"2011","E00002550","E00002550","Total",137,37,14,23,4,52,5,47,41,37,0,3,1,3
"2011","E00174708","E00174708","Total",107,29,9,20,4,40,6,34,33,31,0,2,0,1
"2011","E00174710","E00174710","Total",109,5,3,2,1,32,5,27,71,71,0,0,0,0
"2011","E00174712","E00174712","Total",109,7,5,2,1,31,0,31,67,66,0,0,1,3
"2011","E00174719","E00174719","Total",115,22,3,19,16,41,5,36,34,33,0,1,0,2
"2011","E00002552","E00002552","Total",133,39,14,25,2,47,12,35,43,42,0,1,0,2
"2011","E00002553","E00002553","Total",140,40,13,27,0,51,16,35,49,46,0,2,1,0
"2011","E00002554","E00002554","Total",152,28,11,17,4,88,29,59,32,31,0,0,1,0
"2011","E00002555","E00002555","Total",131,23,11,12,2,66,10,56,40,37,0,2,1,0
"2011","E00002556","E00002556","Total",229,48,18,30,1,96,11,85,83,82,0,0,1,1
"2011","E00002577","E00002577","Total",196,66,26,40,5,69,19,50,52,51,0,1,0,4
"2011","E00002579","E00002579","Total",244,37,20,17,0,103,16,87,99,96,0,3,0,5
"2011","E00002580","E00002580","Total",217,48,15,33,12,57,11,46,97,93,0,2,2,3
"2011","E00002581","E00002581","Total",119,8,2,6,7,94,38,56,9,9,0,0,0,1
"2011","E00002583","E00002583","Total",176,34,10,24,1,47,5,42,89,87,0,1,1,5
"2011","E00002586","E00002586","Total",153,52,20,32,1,48,5,43,51,49,0,1,1,1
"2011","E00002591","E00002591","Total",181,79,25,54,2,21,4,17,77,74,0,2,1,2
"2011","E00002596","E00002596","Total",182,87,21,66,0,19,3,16,75,70,0,5,0,1
"2011","E00002598","E00002598","Total",151,59,24,35,1,26,4,22,61,56,1,3,1,4
"2011","E00002604","E00002604","Total",162,71,33,38,2,16,7,9,71,69,1,0,1,2
"2011","E00002594","E00002594","Total",169,60,25,35,3,46,12,34,59,57,0,2,0,1
"2011","E00174711","E00174711","Total",109,7,2,5,0,17,3,14,83,79,0,3,1,2
"2011","E00174718","E00174718","Total",136,13,3,10,4,28,8,20,89,88,0,0,1,2
"2011","E00174720","E00174720","Total",87,25,11,14,1,26,9,17,35,32,0,0,3,0
"2011","E00002588","E00002588","Total",161,49,24,25,1,69,25,44,41,39,0,0,2,1
"2011","E00002589","E00002589","Total",219,35,16,19,0,66,35,31,116,115,0,1,0,2
"2011","E00002601","E00002601","Total",193,51,18,33,0,88,33,55,51,49,0,0,2,3
"2011","E00002603","E00002603","Total",216,35,17,18,0,84,33,51,95,90,0,2,3,2
"2011","E00002816","E00002816","Total",143,60,25,35,2,29,1,28,51,46,1,0,4,1
"2011","E00002818","E00002818","Total",126,65,30,35,3,32,14,18,25,23,0,2,0,1
"2011","E00002819","E00002819","Total",149,71,31,40,1,31,14,17,45,42,0,1,2,1
"2011","E00002821","E00002821","Total",145,67,33,34,1,34,23,11,42,40,0,0,2,1
"2011","E00002823","E00002823","Total",120,49,14,35,1,32,13,19,37,37,0,0,0,1
"2011","E00002824","E00002824","Total",156,48,18,30,0,74,66,8,32,31,0,1,0,2
"2011","E00002825","E00002825","Total",156,74,25,49,1,23,10,13,57,57,0,0,0,1
"2011","E00002826","E00002826","Total",170,103,54,49,0,21,4,17,43,39,0,1,3,3
"2011","E00002833","E00002833","Total",184,98,50,48,0,36,15,21,46,44,0,2,0,4
"2011","E00002834","E00002834","Total",155,115,62,53,1,7,5,2,31,27,3,1,0,1
"2011","E00002838","E00002838","Total",150,76,46,30,0,17,10,7,50,47,2,1,0,7
"2011","E00002844","E00002844","Total",118,78,42,36,0,11,5,6,25,25,0,0,0,4
"2011","E00002846","E00002846","Total",168,83,33,50,0,36,4,32,46,43,0,3,0,3
"2011","E00002847","E00002847","Total",140,79,40,39,0,23,8,15,38,36,0,1,1,0
"2011","E00002848","E00002848","Total",144,62,23,39,0,18,7,11,62,59,0,1,2,2
"2011","E00002807","E00002807","Total",179,78,26,52,1,25,7,18,71,67,0,4,0,4
"2011","E00002808","E00002808","Total",113,6,2,4,1,83,57,26,22,19,0,2,1,1
"2011","E00002827","E00002827","Total",158,36,12,24,1,33,9,24,88,87,0,1,0,0
"2011","E00002831","E00002831","Total",157,91,42,49,1,15,5,10,47,45,0,1,1,3
"2011","E00002839","E00002839","Total",186,99,44,55,0,15,7,8,71,68,0,2,1,1
"2011","E00002840","E00002840","Total",224,57,24,33,0,56,28,28,107,104,0,1,2,4
"2011","E00002810","E00002810","Total",111,19,5,14,0,72,66,6,20,20,0,0,0,0
"2011","E00002811","E00002811","Total",153,51,24,27,0,22,12,10,75,74,0,1,0,5
"2011","E00002815","E00002815","Total",195,53,14,39,5,46,25,21,87,87,0,0,0,4
"2011","E00002820","E00002820","Total",232,39,12,27,1,70,36,34,119,116,1,1,1,3
"2011","E00002822","E00002822","Total",221,84,25,59,10,35,12,23,91,88,0,3,0,1
"2011","E00002845","E00002845","Total",181,35,10,25,1,2,1,1,139,137,0,2,0,4
"2011","E00002585","E00002585","Total",138,111,74,37,0,7,0,7,19,18,0,1,0,1
"2011","E00002587","E00002587","Total",124,94,47,47,2,6,2,4,22,21,0,1,0,0
"2011","E00002593","E00002593","Total",147,96,47,49,1,6,1,5,40,40,0,0,0,4
"2011","E00002600","E00002600","Total",124,62,16,46,0,18,6,12,42,40,0,2,0,2
"2011","E00002602","E00002602","Total",167,59,24,35,1,56,16,40,51,48,0,3,0,0
"2011","E00002572","E00002572","Total",216,35,21,14,9,25,6,19,143,139,1,1,2,4
"2011","E00002597","E00002597","Total",162,71,26,45,1,22,5,17,67,61,0,4,2,1
"2011","E00002599","E00002599","Total",151,70,36,34,0,39,12,27,41,39,0,1,1,1
"2011","E00002605","E00002605","Total",127,53,19,34,1,46,4,42,26,24,0,2,0,1
"2011","E00174714","E00174714","Total",91,12,5,7,17,28,5,23,31,31,0,0,0,3
"2011","E00174716","E00174716","Total",91,41,22,19,0,32,7,25,15,14,0,1,0,3
"2011","E00174717","E00174717","Total",70,3,0,3,0,41,0,41,26,26,0,0,0,0
"2011","E00002571","E00002571","Total",132,61,26,35,2,33,16,17,32,32,0,0,0,4
"2011","E00002573","E00002573","Total",147,69,27,42,0,46,26,20,29,27,0,0,2,3
"2011","E00002575","E00002575","Total",204,47,18,29,0,124,24,100,33,30,0,1,2,0
"2011","E00002576","E00002576","Total",137,76,32,44,1,33,22,11,27,24,0,2,1,0
"2011","E00002606","E00002606","Total",113,40,18,22,0,36,19,17,32,30,0,2,0,5
"2011","E00002578","E00002578","Total",126,97,49,48,0,8,5,3,19,19,0,0,0,2
"2011","E00002582","E00002582","Total",118,53,17,36,0,28,8,20,37,35,0,2,0,0
"2011","E00002584","E00002584","Total",119,63,26,37,0,18,2,16,38,36,0,2,0,0
"2011","E00002592","E00002592","Total",125,71,23,48,0,15,1,14,36,33,0,3,0,3
"2011","E00002595","E00002595","Total",163,86,30,56,2,28,5,23,45,44,0,1,0,2
"2011","E00002835","E00002835","Total",117,92,54,38,1,5,1,4,17,15,0,2,0,2
"2011","E00002836","E00002836","Total",102,82,56,26,0,6,5,1,13,13,0,0,0,1
"2011","E00002841","E00002841","Total",136,77,39,38,0,11,2,9,45,43,0,2,0,3
"2011","E00002842","E00002842","Total",147,67,19,48,2,27,5,22,49,47,0,2,0,2
"2011","E00002843","E00002843","Total",117,55,15,40,1,28,7,21,33,33,0,0,0,0
"2011","E00002809","E00002809","Total",145,71,37,34,1,26,11,15,45,44,0,1,0,2
"2011","E00002812","E00002812","Total",153,73,28,45,0,50,19,31,29,27,0,2,0,1
"2011","E00002813","E00002813","Total",140,67,23,44,1,32,10,22,40,40,0,0,0,0
"2011","E00002814","E00002814","Total",139,64,28,36,1,31,14,17,43,41,0,1,1,0
"2011","E00002817","E00002817","Total",141,76,31,45,1,15,0,15,48,48,0,0,0,1
"2011","E00002668","E00002668","Total",185,61,11,50,19,56,48,8,47,45,0,1,1,2
"2011","E00002678","E00002678","Total",138,6,2,4,4,118,117,1,10,10,0,0,0,0
"2011","E00002680","E00002680","Total",139,4,2,2,0,126,109,17,7,5,0,2,0,2
"2011","E00002681","E00002681","Total",129,18,8,10,0,90,89,1,19,19,0,0,0,2
"2011","E00002682","E00002682","Total",151,24,10,14,0,81,73,8,45,42,2,1,0,1
"2011","E00002659","E00002659","Total",164,52,22,30,2,69,9,60,41,38,0,2,1,0
"2011","E00002660","E00002660","Total",114,8,4,4,0,98,95,3,5,4,0,1,0,3
"2011","E00002661","E00002661","Total",151,13,7,6,1,92,71,21,44,38,0,0,6,1
"2011","E00002663","E00002663","Total",160,24,5,19,3,89,6,83,42,38,1,2,1,2
"2011","E00002664","E00002664","Total",117,23,10,13,0,73,61,12,19,19,0,0,0,2
"2011","E00002670","E00002670","Total",200,34,10,24,16,119,62,57,28,25,0,1,2,3
"2011","E00002665","E00002665","Total",127,27,14,13,2,81,77,4,16,14,0,0,2,1
"2011","E00002666","E00002666","Total",151,10,4,6,3,128,124,4,9,7,0,0,2,1
"2011","E00002667","E00002667","Total",231,31,9,22,1,168,117,51,31,30,0,1,0,0
"2011","E00002669","E00002669","Total",154,10,2,8,0,140,135,5,4,4,0,0,0,0
"2011","E00002671","E00002671","Total",100,10,2,8,1,85,75,10,3,3,0,0,0,1
"2011","E00002672","E00002672","Total",177,10,7,3,2,144,95,49,19,19,0,0,0,2
"2011","E00002673","E00002673","Total",135,4,3,1,0,122,118,4,8,7,0,1,0,1
"2011","E00002674","E00002674","Total",167,5,3,2,0,150,144,6,6,6,0,0,0,6
"2011","E00002675","E00002675","Total",97,12,5,7,7,64,31,33,11,10,0,1,0,3
"2011","E00002676","E00002676","Total",138,4,2,2,0,124,108,16,8,8,0,0,0,2
"2011","E00002677","E00002677","Total",120,11,3,8,0,97,37,60,9,6,0,0,3,3
"2011","E00002679","E00002679","Total",136,4,2,2,1,123,118,5,7,7,0,0,0,1
"2011","E00003814","E00003814","Total",98,84,42,42,0,7,1,6,5,5,0,0,0,2
"2011","E00003815","E00003815","Total",117,69,27,42,0,20,3,17,27,24,0,2,1,1
"2011","E00003837","E00003837","Total",117,83,46,37,1,3,1,2,25,24,0,1,0,5
"2011","E00003838","E00003838","Total",117,93,59,34,0,17,0,17,5,5,0,0,0,2
"2011","E00003839","E00003839","Total",102,84,36,48,0,2,0,2,14,13,0,1,0,2
"2011","E00003812","E00003812","Total",123,73,34,39,0,38,7,31,7,7,0,0,0,5
"2011","E00003813","E00003813","Total",137,107,45,62,0,9,2,7,19,18,0,1,0,2
"2011","E00003817","E00003817","Total",106,30,15,15,1,56,5,51,16,15,0,1,0,3
"2011","E00003818","E00003818","Total",127,57,28,29,1,49,3,46,19,18,0,1,0,1
"2011","E00003819","E00003819","Total",135,99,43,56,3,29,1,28,3,3,0,0,0,1
"2011","E00003809","E00003809","Total",121,41,13,28,18,47,3,44,15,15,0,0,0,0
"2011","E00003810","E00003810","Total",122,52,18,34,1,60,11,49,9,9,0,0,0,0
"2011","E00003811","E00003811","Total",120,64,26,38,0,43,7,36,11,10,1,0,0,2
"2011","E00003820","E00003820","Total",124,31,6,25,0,85,11,74,6,6,0,0,0,2
"2011","E00003821","E00003821","Total",127,63,14,49,0,52,3,49,11,10,0,0,1,1
"2011","E00003816","E00003816","Total",111,48,14,34,0,51,6,45,11,8,0,3,0,1
"2011","E00003823","E00003823","Total",119,44,18,26,1,61,14,47,13,13,0,0,0,0
"2011","E00003825","E00003825","Total",152,24,13,11,0,88,7,81,38,36,1,1,0,2
"2011","E00003827","E00003827","Total",126,63,19,44,1,50,8,42,10,9,0,1,0,2
"2011","E00003830","E00003830","Total",139,61,19,42,0,63,15,48,15,15,0,0,0,0
"2011","E00003822","E00003822","Total",120,51,22,29,2,54,10,44,11,11,0,0,0,2
"2011","E00003824","E00003824","Total",119,68,22,46,1,38,2,36,12,11,1,0,0,0
"2011","E00003826","E00003826","Total",123,50,12,38,1,59,6,53,11,11,0,0,0,2
"2011","E00003831","E00003831","Total",137,77,21,56,1,40,6,34,17,17,0,0,0,2
"2011","E00003832","E00003832","Total",127,58,25,33,0,52,9,43,15,13,0,2,0,2
"2011","E00003806","E00003806","Total",113,56,25,31,1,51,8,43,4,4,0,0,0,1
"2011","E00003807","E00003807","Total",119,65,19,46,2,43,3,40,9,9,0,0,0,0
"2011","E00003828","E00003828","Total",123,50,15,35,3,60,7,53,10,9,0,1,0,0
"2011","E00003833","E00003833","Total",132,57,21,36,1,62,11,51,9,9,0,0,0,3
"2011","E00003836","E00003836","Total",122,92,50,42,1,25,4,21,4,3,0,0,1,0
"2011","E00003338","E00003338","Total",127,86,58,28,0,13,1,12,25,24,1,0,0,3
"2011","E00003346","E00003346","Total",131,85,30,55,2,39,3,36,4,3,0,1,0,1
"2011","E00003347","E00003347","Total",121,61,20,41,0,46,7,39,14,12,0,1,1,0
"2011","E00003348","E00003348","Total",116,48,12,36,2,49,10,39,15,14,0,1,0,2
"2011","E00003363","E00003363","Total",117,81,39,42,0,1,0,1,33,33,0,0,0,2
"2011","E00003333","E00003333","Total",137,131,59,72,0,3,0,3,2,2,0,0,0,1
"2011","E00003335","E00003335","Total",127,108,37,71,0,2,0,2,17,17,0,0,0,0
"2011","E00003354","E00003354","Total",132,115,51,64,1,9,1,8,7,7,0,0,0,0
"2011","E00003357","E00003357","Total",138,113,52,61,0,18,3,15,5,4,0,1,0,2
"2011","E00003334","E00003334","Total",119,60,15,45,0,47,4,43,11,10,0,0,1,1
"2011","E00003349","E00003349","Total",126,98,39,59,0,6,1,5,21,19,1,1,0,1
"2011","E00003350","E00003350","Total",118,98,42,56,0,2,1,1,16,15,1,0,0,2
"2011","E00003352","E00003352","Total",121,110,50,60,0,4,0,4,7,5,0,2,0,0
"2011","E00003356","E00003356","Total",135,61,30,31,0,62,0,62,9,8,0,0,1,3
"2011","E00003336","E00003336","Total",138,125,50,75,0,1,0,1,12,10,0,1,1,0
"2011","E00003351","E00003351","Total",129,118,49,69,0,1,0,1,10,10,0,0,0,0
"2011","E00003359","E00003359","Total",133,68,22,46,0,10,0,10,50,46,2,2,0,5
"2011","E00003360","E00003360","Total",130,95,47,48,0,5,1,4,30,30,0,0,0,0
"2011","E00003364","E00003364","Total",129,99,57,42,0,13,0,13,17,15,1,0,1,0
"2011","E00003805","E00003805","Total",112,102,38,64,0,3,1,2,6,5,0,1,0,1
"2011","E00003808","E00003808","Total",136,120,44,76,0,3,0,3,13,12,0,1,0,0
"2011","E00003829","E00003829","Total",127,69,30,39,5,37,3,34,14,13,0,1,0,2
"2011","E00003834","E00003834","Total",108,98,31,67,0,1,0,1,9,9,0,0,0,0
"2011","E00003835","E00003835","Total",99,73,25,48,0,1,0,1,25,25,0,0,0,0
"2011","E00003889","E00003889","Total",135,75,23,52,0,29,1,28,29,27,1,1,0,2
"2011","E00003925","E00003925","Total",144,35,7,28,0,14,0,14,92,90,0,0,2,3
"2011","E00003926","E00003926","Total",160,96,36,60,7,39,2,37,17,17,0,0,0,1
"2011","E00003932","E00003932","Total",139,91,29,62,0,28,1,27,17,16,1,0,0,3
"2011","E00003940","E00003940","Total",141,104,38,66,0,11,0,11,24,23,0,1,0,2
"2011","E00003895","E00003895","Total",141,67,22,45,2,40,0,40,31,30,0,1,0,1
"2011","E00003902","E00003902","Total",130,41,8,33,0,71,7,64,18,16,0,2,0,0
"2011","E00003903","E00003903","Total",119,74,21,53,1,28,1,27,15,13,0,1,1,1
"2011","E00003906","E00003906","Total",125,70,20,50,0,20,3,17,35,34,0,1,0,0
"2011","E00003907","E00003907","Total",103,75,33,42,1,15,3,12,12,10,0,0,2,0
"2011","E00003909","E00003909","Total",132,78,32,46,1,12,1,11,38,36,0,1,1,3
"2011","E00003896","E00003896","Total",119,56,18,38,0,43,1,42,19,19,0,0,0,1
"2011","E00003898","E00003898","Total",128,89,45,44,0,10,0,10,24,22,0,2,0,5
"2011","E00003899","E00003899","Total",130,51,11,40,0,30,2,28,49,46,0,1,2,0
"2011","E00003900","E00003900","Total",135,67,19,48,17,27,1,26,23,23,0,0,0,1
"2011","E00003904","E00003904","Total",118,36,13,23,2,54,7,47,26,26,0,0,0,0
"2011","E00003947","E00003947","Total",100,63,18,45,1,15,0,15,20,17,0,1,2,1
"2011","E00003890","E00003890","Total",124,111,55,56,0,4,0,4,8,7,0,1,0,1
"2011","E00003897","E00003897","Total",103,93,50,43,0,3,0,3,7,6,0,1,0,0
"2011","E00003901","E00003901","Total",110,95,45,50,0,0,0,0,15,13,1,1,0,0
"2011","E00003915","E00003915","Total",114,79,35,44,0,15,1,14,19,17,0,2,0,1
"2011","E00003946","E00003946","Total",97,86,36,50,0,3,0,3,8,7,0,1,0,0
"2011","E00003892","E00003892","Total",130,65,18,47,1,35,2,33,28,26,0,1,1,1
"2011","E00003905","E00003905","Total",131,92,33,59,1,11,0,11,27,26,0,0,1,0
"2011","E00003908","E00003908","Total",110,67,27,40,0,10,0,10,32,31,0,1,0,1
"2011","E00003912","E00003912","Total",102,56,19,37,1,29,5,24,16,15,0,0,1,0
"2011","E00003917","E00003917","Total",122,75,29,46,1,19,0,19,25,21,1,3,0,2
"2011","E00003918","E00003918","Total",122,53,25,28,7,45,3,42,17,17,0,0,0,0
"2011","E00003603","E00003603","Total",133,61,11,50,0,3,0,3,69,64,0,5,0,0
"2011","E00003604","E00003604","Total",118,23,2,21,0,7,1,6,84,83,0,1,0,4
"2011","E00003607","E00003607","Total",98,24,9,15,1,29,3,26,44,44,0,0,0,0
"2011","E00003614","E00003614","Total",130,36,7,29,1,43,9,34,49,47,0,1,1,1
"2011","E00003618","E00003618","Total",123,38,11,27,0,70,8,62,14,13,0,1,0,1
"2011","E00003627","E00003627","Total",126,61,12,49,0,20,4,16,45,43,1,1,0,0
"2011","E00003628","E00003628","Total",143,44,13,31,7,23,1,22,69,66,1,2,0,0
"2011","E00003617","E00003617","Total",131,24,5,19,0,86,13,73,21,20,0,1,0,0
"2011","E00003620","E00003620","Total",120,53,13,40,1,34,2,32,32,32,0,0,0,0
"2011","E00003622","E00003622","Total",141,53,16,37,0,30,3,27,54,50,0,4,0,4
"2011","E00003623","E00003623","Total",139,47,11,36,0,52,3,49,40,38,0,2,0,0
"2011","E00003624","E00003624","Total",165,71,14,57,0,48,1,47,45,44,0,1,0,1
"2011","E00003626","E00003626","Total",146,48,15,33,0,64,4,60,34,32,0,1,1,0
"2011","E00003600","E00003600","Total",176,58,14,44,2,60,3,57,56,55,0,1,0,0
"2011","E00003602","E00003602","Total",139,47,13,34,0,58,3,55,33,32,0,1,0,1
"2011","E00003606","E00003606","Total",228,96,22,74,18,48,3,45,65,63,0,2,0,1
"2011","E00003612","E00003612","Total",130,40,11,29,0,32,14,18,57,55,0,2,0,1
"2011","E00003615","E00003615","Total",147,62,21,41,0,30,2,28,54,52,0,2,0,1
"2011","E00003619","E00003619","Total",98,28,3,25,0,11,0,11,59,58,0,1,0,0
"2011","E00003621","E00003621","Total",126,53,8,45,1,37,4,33,32,30,0,2,0,3
"2011","E00003599","E00003599","Total",139,38,11,27,0,47,3,44,53,50,0,2,1,1
"2011","E00003637","E00003637","Total",145,67,8,59,3,14,1,13,61,60,0,1,0,0
"2011","E00003638","E00003638","Total",108,35,8,27,0,36,3,33,37,37,0,0,0,0
"2011","E00003639","E00003639","Total",103,18,8,10,1,74,10,64,9,9,0,0,0,1
"2011","E00003640","E00003640","Total",125,71,19,52,1,21,1,20,31,31,0,0,0,1
"2011","E00003641","E00003641","Total",136,93,37,56,1,6,0,6,36,36,0,0,0,0
"2011","E00003642","E00003642","Total",127,62,19,43,1,27,0,27,34,32,0,2,0,3
"2011","E00003601","E00003601","Total",164,77,23,54,0,26,2,24,61,59,0,2,0,0
"2011","E00003605","E00003605","Total",136,61,20,41,0,38,3,35,37,37,0,0,0,0
"2011","E00003611","E00003611","Total",150,87,24,63,0,36,2,34,26,25,0,1,0,1
"2011","E00003613","E00003613","Total",157,70,31,39,0,42,2,40,43,40,0,0,3,2
"2011","E00003616","E00003616","Total",175,58,19,39,0,36,1,35,80,77,0,3,0,1
"2011","E00003643","E00003643","Total",167,71,20,51,1,22,2,20,70,70,0,0,0,3
"2011","E00003378","E00003378","Total",167,78,45,33,0,53,3,50,35,33,0,2,0,1
"2011","E00003379","E00003379","Total",162,123,60,63,0,20,1,19,16,16,0,0,0,3
"2011","E00003380","E00003380","Total",181,98,55,43,0,10,0,10,71,68,1,2,0,2
"2011","E00003415","E00003415","Total",159,104,49,55,1,6,0,6,46,43,0,3,0,2
"2011","E00003422","E00003422","Total",118,33,17,16,1,66,8,58,17,17,0,0,0,1
"2011","E00003433","E00003433","Total",139,81,38,43,0,6,0,6,52,49,1,2,0,0
"2011","E00003434","E00003434","Total",130,80,31,49,0,3,0,3,46,44,0,2,0,1
"2011","E00003436","E00003436","Total",134,92,36,56,0,2,0,2,38,36,0,2,0,2
"2011","E00003461","E00003461","Total",102,56,31,25,0,21,5,16,25,25,0,0,0,0
"2011","E00003463","E00003463","Total",120,72,38,34,2,18,3,15,28,25,0,1,2,0
"2011","E00003464","E00003464","Total",137,102,49,53,10,5,0,5,18,16,0,2,0,2
"2011","E00003466","E00003466","Total",100,65,34,31,0,3,0,3,32,32,0,0,0,0
"2011","E00003432","E00003432","Total",117,64,41,23,0,22,0,22,28,28,0,0,0,3
"2011","E00003438","E00003438","Total",139,86,44,42,0,1,0,1,50,45,0,5,0,2
"2011","E00003439","E00003439","Total",140,64,31,33,1,39,5,34,32,31,0,1,0,4
"2011","E00003443","E00003443","Total",122,60,25,35,1,26,1,25,32,30,0,2,0,3
"2011","E00003465","E00003465","Total",117,61,29,32,0,15,0,15,41,41,0,0,0,0
"2011","E00003467","E00003467","Total",158,79,34,45,1,4,0,4,73,70,0,3,0,1
"2011","E00003469","E00003469","Total",122,64,28,36,5,5,0,5,47,46,0,0,1,1
"2011","E00003471","E00003471","Total",97,51,25,26,0,7,0,7,38,36,0,1,1,1
"2011","E00003447","E00003447","Total",168,108,60,48,0,3,0,3,55,52,0,3,0,2
"2011","E00003448","E00003448","Total",193,123,68,55,0,2,0,2,67,64,0,3,0,1
"2011","E00003474","E00003474","Total",140,93,56,37,0,2,0,2,42,40,0,1,1,3
"2011","E00003477","E00003477","Total",116,42,5,37,1,14,0,14,59,59,0,0,0,0
"2011","E00003480","E00003480","Total",159,49,13,36,2,5,1,4,99,99,0,0,0,4
"2011","E00166107","E00166107","Total",124,87,42,45,0,8,1,7,25,24,0,0,1,4
"2011","E00166109","E00166109","Total",136,39,10,29,0,16,0,16,78,76,1,1,0,3
"2011","E00003435","E00003435","Total",197,89,23,66,20,69,7,62,18,15,0,3,0,1
"2011","E00003460","E00003460","Total",82,49,26,23,2,10,2,8,14,14,0,0,0,7
"2011","E00003462","E00003462","Total",94,5,2,3,0,80,2,78,9,9,0,0,0,0
"2011","E00003487","E00003487","Total",74,42,10,32,3,1,0,1,27,27,0,0,0,1
"2011","E00003488","E00003488","Total",95,84,40,44,2,2,0,2,3,3,0,0,0,4
"2011","E00003489","E00003489","Total",105,60,21,39,0,6,0,6,38,36,0,2,0,1
"2011","E00003490","E00003490","Total",101,33,10,23,1,49,3,46,18,18,0,0,0,0
"2011","E00003491","E00003491","Total",116,5,1,4,0,100,2,98,10,8,0,0,2,1
"2011","E00003492","E00003492","Total",107,60,23,37,0,4,0,4,42,41,0,1,0,1
"2011","E00003117","E00003117","Total",129,119,57,62,0,0,0,0,10,10,0,0,0,0
"2011","E00003128","E00003128","Total",145,131,67,64,0,0,0,0,12,12,0,0,0,2
"2011","E00003131","E00003131","Total",132,126,72,54,0,2,0,2,3,3,0,0,0,1
"2011","E00003133","E00003133","Total",130,122,68,54,0,1,0,1,3,3,0,0,0,4
"2011","E00003119","E00003119","Total",136,93,53,40,0,15,0,15,27,27,0,0,0,1
"2011","E00003122","E00003122","Total",116,107,65,42,0,0,0,0,9,9,0,0,0,0
"2011","E00003143","E00003143","Total",135,120,59,61,0,2,0,2,10,10,0,0,0,3
"2011","E00003145","E00003145","Total",132,118,67,51,0,1,0,1,13,12,1,0,0,0
"2011","E00166105","E00166105","Total",111,100,51,49,0,2,0,2,9,9,0,0,0,0
"2011","E00166626","E00166626","Total",95,43,11,32,12,26,0,26,14,11,0,2,1,0
"2011","E00166627","E00166627","Total",49,42,21,21,0,0,0,0,6,5,0,1,0,1
"2011","E00003337","E00003337","Total",110,97,60,37,0,1,1,0,8,8,0,0,0,4
"2011","E00003355","E00003355","Total",110,103,69,34,1,2,0,2,3,3,0,0,0,1
"2011","E00003362","E00003362","Total",141,129,80,49,3,0,0,0,9,7,0,2,0,0
"2011","E00003365","E00003365","Total",112,108,66,42,0,2,0,2,2,2,0,0,0,0
"2011","E00003368","E00003368","Total",162,154,75,79,0,1,0,1,7,7,0,0,0,0
"2011","E00003358","E00003358","Total",117,100,46,54,0,9,0,9,5,5,0,0,0,3
"2011","E00003361","E00003361","Total",127,98,53,45,1,14,0,14,13,13,0,0,0,1
"2011","E00003366","E00003366","Total",111,102,54,48,0,0,0,0,8,6,0,2,0,1
"2011","E00003370","E00003370","Total",120,91,50,41,0,2,0,2,24,23,0,1,0,3
"2011","E00003373","E00003373","Total",139,128,64,64,0,0,0,0,11,11,0,0,0,0
"2011","E00003340","E00003340","Total",136,96,56,40,0,1,0,1,34,33,0,1,0,5
"2011","E00003342","E00003342","Total",119,111,69,42,1,4,0,4,3,3,0,0,0,0
"2011","E00003367","E00003367","Total",125,120,77,43,0,0,0,0,5,5,0,0,0,0
"2011","E00003374","E00003374","Total",135,105,49,56,0,0,0,0,26,25,0,0,1,4
"2011","E00003376","E00003376","Total",122,113,70,43,1,0,0,0,7,7,0,0,0,1
"2011","E00003329","E00003329","Total",138,104,46,58,0,6,0,6,26,25,0,1,0,2
"2011","E00003341","E00003341","Total",137,97,47,50,1,1,0,1,37,34,0,3,0,1
"2011","E00003343","E00003343","Total",114,87,44,43,0,0,0,0,22,18,1,2,1,5
"2011","E00003371","E00003371","Total",131,109,56,53,0,1,0,1,20,19,0,1,0,1
"2011","E00003372","E00003372","Total",118,86,30,56,0,4,0,4,26,26,0,0,0,2
"2011","E00003375","E00003375","Total",127,101,37,64,1,1,0,1,24,22,0,2,0,0
"2011","E00003232","E00003232","Total",201,108,30,78,1,32,0,32,58,57,1,0,0,2
"2011","E00003246","E00003246","Total",152,90,44,46,0,38,1,37,23,22,0,1,0,1
"2011","E00003251","E00003251","Total",165,118,53,65,0,5,0,5,42,39,0,2,1,0
"2011","E00003282","E00003282","Total",154,112,47,65,1,9,1,8,32,31,0,1,0,0
"2011","E00003284","E00003284","Total",130,48,13,35,0,77,15,62,5,5,0,0,0,0
"2011","E00003245","E00003245","Total",128,49,13,36,0,39,2,37,40,40,0,0,0,0
"2011","E00003247","E00003247","Total",147,28,9,19,1,67,4,63,47,42,1,3,1,4
"2011","E00003249","E00003249","Total",176,97,56,41,1,32,2,30,41,39,0,2,0,5
"2011","E00003250","E00003250","Total",162,84,31,53,0,17,0,17,57,50,0,6,1,4
"2011","E00003255","E00003255","Total",126,38,18,20,0,6,1,5,72,69,2,0,1,10
"2011","E00003256","E00003256","Total",127,60,23,37,0,46,4,42,20,20,0,0,0,1
"2011","E00003996","E00003996","Total",97,68,32,36,0,22,0,22,7,6,0,1,0,0
"2011","E00004000","E00004000","Total",132,88,42,46,0,4,0,4,38,37,0,1,0,2
"2011","E00004025","E00004025","Total",101,53,25,28,0,38,0,38,9,8,0,0,1,1
"2011","E00004026","E00004026","Total",100,80,27,53,0,4,1,3,15,15,0,0,0,1
"2011","E00004027","E00004027","Total",108,51,22,29,0,28,4,24,29,28,0,1,0,0
"2011","E00004028","E00004028","Total",105,36,13,23,0,45,1,44,23,22,0,1,0,1
"2011","E00003997","E00003997","Total",149,87,39,48,0,26,0,26,35,33,0,2,0,1
"2011","E00003999","E00003999","Total",150,96,36,60,0,18,0,18,35,29,0,6,0,1
"2011","E00004029","E00004029","Total",139,105,50,55,0,17,0,17,17,16,0,1,0,0
"2011","E00004031","E00004031","Total",140,103,34,69,1,10,0,10,22,19,0,3,0,4
"2011","E00004032","E00004032","Total",149,58,21,37,0,48,29,19,43,40,0,3,0,0
"2011","E00003998","E00003998","Total",207,112,29,83,0,35,0,35,57,52,1,3,1,3
"2011","E00004001","E00004001","Total",151,99,34,65,1,12,0,12,38,34,0,3,1,1
"2011","E00004033","E00004033","Total",136,97,44,53,0,5,0,5,33,30,0,2,1,1
"2011","E00004035","E00004035","Total",121,98,37,61,0,6,0,6,17,17,0,0,0,0
"2011","E00004040","E00004040","Total",132,91,26,65,3,4,0,4,34,31,0,2,1,0
"2011","E00004030","E00004030","Total",128,70,28,42,0,15,2,13,43,42,0,0,1,0
"2011","E00004034","E00004034","Total",150,93,24,69,0,16,0,16,38,38,0,0,0,3
"2011","E00004036","E00004036","Total",107,37,9,28,0,43,4,39,24,22,1,1,0,3
"2011","E00004037","E00004037","Total",129,113,35,78,0,6,0,6,9,9,0,0,0,1
"2011","E00004002","E00004002","Total",157,104,34,70,1,9,0,9,42,41,0,1,0,1
"2011","E00004005","E00004005","Total",172,77,50,27,9,21,1,20,63,62,0,1,0,2
"2011","E00004038","E00004038","Total",180,96,41,55,1,43,0,43,38,37,1,0,0,2
"2011","E00004039","E00004039","Total",149,95,50,45,0,10,0,10,40,39,0,1,0,4
"2011","E00004041","E00004041","Total",149,93,32,61,2,18,2,16,34,29,0,3,2,2
"2011","E00003608","E00003608","Total",161,16,4,12,0,113,27,86,31,30,0,0,1,1
"2011","E00003625","E00003625","Total",125,27,7,20,3,79,15,64,16,14,0,1,1,0
"2011","E00003630","E00003630","Total",130,17,7,10,3,68,0,68,41,38,1,2,0,1
"2011","E00003631","E00003631","Total",140,36,3,33,1,49,6,43,53,52,0,0,1,1
"2011","E00003632","E00003632","Total",103,55,24,31,2,36,9,27,9,8,0,1,0,1
"2011","E00003634","E00003634","Total",182,31,6,25,44,52,1,51,55,54,0,1,0,0
"2011","E00003609","E00003609","Total",121,34,12,22,1,68,14,54,18,18,0,0,0,0
"2011","E00003610","E00003610","Total",110,34,9,25,0,68,7,61,6,6,0,0,0,2
"2011","E00003629","E00003629","Total",118,23,9,14,0,73,5,68,19,17,1,1,0,3
"2011","E00003633","E00003633","Total",109,28,10,18,0,73,11,62,7,6,0,1,0,1
"2011","E00003635","E00003635","Total",116,47,17,30,1,47,3,44,20,18,0,2,0,1
"2011","E00003636","E00003636","Total",108,6,1,5,2,93,7,86,6,6,0,0,0,1
"2011","E00003893","E00003893","Total",115,26,8,18,0,85,15,70,3,3,0,0,0,1
"2011","E00003924","E00003924","Total",123,23,10,13,0,91,12,79,8,8,0,0,0,1
"2011","E00003929","E00003929","Total",110,15,6,9,4,84,11,73,6,6,0,0,0,1
"2011","E00003931","E00003931","Total",167,36,3,33,0,110,10,100,21,19,0,1,1,0
"2011","E00003934","E00003934","Total",123,5,0,5,0,105,8,97,12,10,0,0,2,1
"2011","E00003894","E00003894","Total",164,30,10,20,0,84,7,77,49,42,3,4,0,1
"2011","E00003921","E00003921","Total",139,35,7,28,0,70,6,64,32,30,1,1,0,2
"2011","E00003923","E00003923","Total",139,28,10,18,0,102,24,78,9,7,0,1,1,0
"2011","E00003930","E00003930","Total",139,57,22,35,1,52,0,52,28,28,0,0,0,1
"2011","E00003937","E00003937","Total",112,10,1,9,0,85,3,82,17,17,0,0,0,0
"2011","E00003920","E00003920","Total",123,39,10,29,4,53,2,51,25,25,0,0,0,2
"2011","E00003928","E00003928","Total",128,26,13,13,2,85,17,68,15,15,0,0,0,0
"2011","E00003933","E00003933","Total",138,59,9,50,4,22,2,20,53,51,0,0,2,0
"2011","E00003936","E00003936","Total",118,47,11,36,9,18,2,16,43,42,0,1,0,1
"2011","E00003939","E00003939","Total",136,76,36,40,0,23,0,23,37,36,0,0,1,0
"2011","E00003942","E00003942","Total",137,61,21,40,0,30,3,27,45,43,0,2,0,1
"2011","E00003891","E00003891","Total",216,47,18,29,8,58,9,49,101,98,1,2,0,2
"2011","E00003910","E00003910","Total",131,56,14,42,1,36,2,34,37,35,0,1,1,1
"2011","E00003911","E00003911","Total",161,37,6,31,0,45,3,42,79,77,0,2,0,0
"2011","E00003913","E00003913","Total",122,30,9,21,0,65,11,54,23,21,0,2,0,4
"2011","E00003916","E00003916","Total",138,18,3,15,1,103,20,83,16,16,0,0,0,0
"2011","E00003330","E00003330","Total",139,107,64,43,0,18,0,18,11,10,1,0,0,3
"2011","E00003339","E00003339","Total",143,122,77,45,0,3,0,3,15,15,0,0,0,3
"2011","E00003353","E00003353","Total",151,112,65,47,0,25,8,17,12,12,0,0,0,2
"2011","E00003369","E00003369","Total",137,103,64,39,0,1,0,1,23,19,1,2,1,10
"2011","E00003331","E00003331","Total",118,115,69,46,0,0,0,0,2,2,0,0,0,1
"2011","E00003332","E00003332","Total",101,98,50,48,0,1,0,1,1,1,0,0,0,1
"2011","E00003344","E00003344","Total",114,107,67,40,0,3,1,2,3,3,0,0,0,1
"2011","E00003345","E00003345","Total",106,100,63,37,0,2,0,2,2,1,0,1,0,2
"2011","E00003550","E00003550","Total",135,75,33,42,4,47,5,42,5,4,0,1,0,4
"2011","E00003577","E00003577","Total",132,100,40,60,0,28,4,24,3,3,0,0,0,1
"2011","E00003579","E00003579","Total",126,99,39,60,0,26,2,24,0,0,0,0,0,1
"2011","E00003580","E00003580","Total",115,79,30,49,0,26,3,23,9,8,0,1,0,1
"2011","E00003585","E00003585","Total",110,41,10,31,2,61,9,52,5,5,0,0,0,1
"2011","E00003551","E00003551","Total",136,47,27,20,1,77,6,71,7,5,0,0,2,4
"2011","E00003553","E00003553","Total",111,75,23,52,3,23,0,23,10,7,1,2,0,0
"2011","E00003576","E00003576","Total",96,86,41,45,0,3,0,3,6,6,0,0,0,1
"2011","E00003578","E00003578","Total",119,64,30,34,0,49,7,42,4,3,0,0,1,2
"2011","E00003590","E00003590","Total",118,70,27,43,0,34,8,26,12,11,0,1,0,2
"2011","E00003241","E00003241","Total",91,77,32,45,0,1,0,1,13,11,0,2,0,0
"2011","E00003242","E00003242","Total",197,130,70,60,1,15,1,14,51,50,0,1,0,0
"2011","E00003243","E00003243","Total",236,190,85,105,7,1,0,1,37,33,2,2,0,1
"2011","E00003281","E00003281","Total",126,109,51,58,0,5,0,5,11,11,0,0,0,1
"2011","E00003244","E00003244","Total",100,90,42,48,0,2,0,2,8,8,0,0,0,0
"2011","E00003248","E00003248","Total",107,85,30,55,1,0,0,0,21,19,2,0,0,0
"2011","E00003252","E00003252","Total",80,77,40,37,0,1,0,1,2,2,0,0,0,0
"2011","E00003253","E00003253","Total",112,83,25,58,0,4,0,4,24,23,1,0,0,1
"2011","E00003280","E00003280","Total",121,66,20,46,0,38,6,32,16,15,0,1,0,1
"2011","E00003283","E00003283","Total",110,97,48,49,0,6,1,5,7,6,0,1,0,0
"2011","E00003452","E00003452","Total",162,102,56,46,1,2,1,1,55,54,0,1,0,2
"2011","E00003453","E00003453","Total",122,91,44,47,0,11,0,11,19,18,0,0,1,1
"2011","E00003455","E00003455","Total",114,72,43,29,0,8,0,8,33,30,0,3,0,1
"2011","E00003458","E00003458","Total",118,113,69,44,1,1,0,1,3,3,0,0,0,0
"2011","E00003483","E00003483","Total",113,106,59,47,0,1,0,1,6,6,0,0,0,0
"2011","E00003484","E00003484","Total",73,41,21,20,0,20,5,15,12,11,0,1,0,0
"2011","E00003456","E00003456","Total",155,95,35,60,1,0,0,0,59,56,0,3,0,0
"2011","E00003457","E00003457","Total",140,82,23,59,0,15,0,15,43,41,1,1,0,0
"2011","E00003459","E00003459","Total",151,107,54,53,0,2,0,2,41,41,0,0,0,1
"2011","E00003476","E00003476","Total",99,66,44,22,0,9,2,7,21,18,0,3,0,3
"2011","E00003478","E00003478","Total",120,61,28,33,0,23,6,17,35,30,0,4,1,1
"2011","E00003479","E00003479","Total",114,80,45,35,2,2,0,2,30,27,0,3,0,0
"2011","E00003486","E00003486","Total",110,87,42,45,1,0,0,0,22,22,0,0,0,0
"2011","E00004043","E00004043","Total",139,85,46,39,0,26,2,24,25,24,0,1,0,3
"2011","E00004044","E00004044","Total",117,50,25,25,0,53,2,51,13,10,0,3,0,1
"2011","E00004045","E00004045","Total",118,96,64,32,0,10,0,10,11,11,0,0,0,1
"2011","E00004046","E00004046","Total",145,110,46,64,0,0,0,0,32,31,0,1,0,3
"2011","E00004047","E00004047","Total",117,110,47,63,0,1,0,1,5,4,0,1,0,1
"2011","E00004070","E00004070","Total",130,87,38,49,1,12,0,12,29,29,0,0,0,1
"2011","E00003437","E00003437","Total",108,85,38,47,0,2,0,2,20,17,0,3,0,1
"2011","E00003442","E00003442","Total",190,122,71,51,0,2,0,2,63,59,0,4,0,3
"2011","E00003445","E00003445","Total",156,117,56,61,1,2,1,1,33,29,0,3,1,3
"2011","E00003446","E00003446","Total",158,82,37,45,0,4,0,4,71,65,0,6,0,1
"2011","E00003470","E00003470","Total",141,92,44,48,0,10,0,10,38,35,0,2,1,1
"2011","E00003472","E00003472","Total",109,78,45,33,0,1,0,1,26,25,0,1,0,4
"2011","E00003440","E00003440","Total",165,109,43,66,0,7,1,6,45,42,0,3,0,4
"2011","E00003441","E00003441","Total",195,154,69,85,0,4,0,4,37,35,0,2,0,0
"2011","E00003444","E00003444","Total",164,108,48,60,0,12,0,12,42,37,1,4,0,2
"2011","E00003450","E00003450","Total",189,107,53,54,0,15,0,15,65,63,0,2,0,2
"2011","E00003468","E00003468","Total",172,125,65,60,0,0,0,0,47,43,0,3,1,0
"2011","E00003449","E00003449","Total",141,80,35,45,0,30,1,29,27,25,0,1,1,4
"2011","E00003451","E00003451","Total",142,116,76,40,1,1,0,1,24,21,0,1,2,0
"2011","E00003454","E00003454","Total",142,87,44,43,0,5,0,5,48,45,1,2,0,2
"2011","E00003475","E00003475","Total",138,100,41,59,0,0,0,0,35,33,0,2,0,3
"2011","E00003481","E00003481","Total",102,76,50,26,1,2,0,2,20,20,0,0,0,3
"2011","E00003482","E00003482","Total",113,89,35,54,0,0,0,0,23,20,1,2,0,1
"2011","E00003485","E00003485","Total",107,79,33,46,1,9,0,9,16,15,0,0,1,2
"2011","E00003759","E00003759","Total",137,125,81,44,0,1,1,0,8,8,0,0,0,3
"2011","E00003765","E00003765","Total",127,85,76,9,0,1,0,1,36,32,1,1,2,5
"2011","E00003770","E00003770","Total",153,83,30,53,1,3,0,3,64,61,0,2,1,2
"2011","E00003778","E00003778","Total",157,129,106,23,1,0,0,0,18,16,0,2,0,9
"2011","E00003781","E00003781","Total",117,107,53,54,0,1,0,1,7,6,0,0,1,2
"2011","E00003766","E00003766","Total",153,117,66,51,1,4,0,4,30,29,1,0,0,1
"2011","E00003767","E00003767","Total",150,122,90,32,2,3,0,3,23,21,0,2,0,0
"2011","E00003771","E00003771","Total",145,112,55,57,0,1,0,1,32,32,0,0,0,0
"2011","E00003774","E00003774","Total",139,136,79,57,0,1,0,1,2,2,0,0,0,0
"2011","E00003775","E00003775","Total",147,109,68,41,0,22,0,22,11,11,0,0,0,5
"2011","E00003382","E00003382","Total",90,22,7,15,2,53,3,50,11,11,0,0,0,2
"2011","E00003383","E00003383","Total",127,72,11,61,29,17,0,17,9,9,0,0,0,0
"2011","E00003385","E00003385","Total",105,75,24,51,0,16,1,15,13,13,0,0,0,1
"2011","E00003388","E00003388","Total",123,98,27,71,1,8,0,8,15,14,0,1,0,1
"2011","E00003389","E00003389","Total",124,88,25,63,1,19,2,17,15,15,0,0,0,1
"2011","E00003427","E00003427","Total",97,74,18,56,1,4,0,4,17,16,0,1,0,1
"2011","E00003416","E00003416","Total",113,88,30,58,0,6,0,6,19,19,0,0,0,0
"2011","E00003417","E00003417","Total",95,58,19,39,0,5,0,5,30,30,0,0,0,2
"2011","E00003418","E00003418","Total",132,101,40,61,0,16,1,15,14,13,0,1,0,1
"2011","E00003420","E00003420","Total",112,83,30,53,1,4,0,4,24,22,0,1,1,0
"2011","E00003421","E00003421","Total",120,83,27,56,0,15,3,12,20,20,0,0,0,2
"2011","E00003381","E00003381","Total",158,91,29,62,0,21,1,20,44,44,0,0,0,2
"2011","E00003384","E00003384","Total",137,111,48,63,0,5,0,5,21,21,0,0,0,0
"2011","E00003419","E00003419","Total",170,89,22,67,12,28,3,25,39,38,0,1,0,2
"2011","E00003423","E00003423","Total",122,48,23,25,1,11,0,11,61,55,1,4,1,1
"2011","E00003430","E00003430","Total",107,84,40,44,0,2,0,2,21,18,0,3,0,0
"2011","E00003386","E00003386","Total",113,99,30,69,0,3,0,3,10,9,0,1,0,1
"2011","E00003391","E00003391","Total",138,111,31,80,0,4,0,4,23,21,0,2,0,0
"2011","E00003402","E00003402","Total",106,60,32,28,1,38,9,29,6,6,0,0,0,1
"2011","E00003413","E00003413","Total",129,71,25,46,0,35,9,26,21,20,0,1,0,2
"2011","E00003414","E00003414","Total",105,62,27,35,0,24,2,22,19,18,0,1,0,0
"2011","E00003914","E00003914","Total",114,70,28,42,1,33,5,28,10,10,0,0,0,0
"2011","E00003919","E00003919","Total",141,113,52,61,0,14,0,14,11,10,0,0,1,3
"2011","E00003922","E00003922","Total",150,98,36,62,1,19,2,17,29,27,0,2,0,3
"2011","E00003927","E00003927","Total",147,125,53,72,0,7,0,7,11,11,0,0,0,4
"2011","E00003935","E00003935","Total",127,73,28,45,0,22,2,20,30,29,0,0,1,2
"2011","E00003549","E00003549","Total",150,40,13,27,18,88,14,74,4,3,0,1,0,0
"2011","E00003575","E00003575","Total",125,65,31,34,0,54,6,48,6,5,1,0,0,0
"2011","E00003581","E00003581","Total",163,39,22,17,14,100,18,82,9,9,0,0,0,1
"2011","E00003584","E00003584","Total",127,69,35,34,0,51,9,42,7,7,0,0,0,0
"2011","E00003586","E00003586","Total",129,18,4,14,2,104,8,96,5,5,0,0,0,0
"2011","E00003587","E00003587","Total",130,22,11,11,0,96,20,76,11,9,0,2,0,1
"2011","E00003554","E00003554","Total",137,79,21,58,1,50,8,42,7,7,0,0,0,0
"2011","E00003555","E00003555","Total",134,56,22,34,0,67,14,53,11,10,0,1,0,0
"2011","E00003557","E00003557","Total",128,43,20,23,2,74,16,58,6,4,0,2,0,3
"2011","E00003595","E00003595","Total",122,43,15,28,1,66,9,57,12,11,0,1,0,0
"2011","E00003598","E00003598","Total",128,10,1,9,9,98,11,87,9,9,0,0,0,2
"2011","E00003547","E00003547","Total",102,68,26,42,0,26,3,23,6,6,0,0,0,2
"2011","E00003548","E00003548","Total",128,71,28,43,3,40,3,37,13,10,1,2,0,1
"2011","E00003571","E00003571","Total",107,73,33,40,0,29,6,23,5,4,1,0,0,0
"2011","E00003572","E00003572","Total",100,48,24,24,0,47,4,43,5,5,0,0,0,0
"2011","E00003573","E00003573","Total",125,45,14,31,5,64,8,56,9,9,0,0,0,2
"2011","E00003574","E00003574","Total",118,73,35,38,0,40,4,36,5,4,0,1,0,0
"2011","E00003582","E00003582","Total",137,100,43,57,0,23,2,21,14,12,0,2,0,0
"2011","E00003583","E00003583","Total",127,93,36,57,1,20,3,17,11,11,0,0,0,2
"2011","E00003591","E00003591","Total",123,107,57,50,0,4,1,3,11,10,0,0,1,1
"2011","E00003592","E00003592","Total",127,104,48,56,1,8,1,7,13,11,0,2,0,1
"2011","E00003552","E00003552","Total",118,46,16,30,0,66,7,59,4,3,0,1,0,2
"2011","E00003588","E00003588","Total",124,59,14,45,3,54,2,52,8,6,0,1,1,0
"2011","E00003589","E00003589","Total",121,34,16,18,2,77,5,72,7,6,0,0,1,1
"2011","E00003593","E00003593","Total",149,79,48,31,1,57,5,52,9,8,0,1,0,3
"2011","E00003594","E00003594","Total",122,33,12,21,0,82,12,70,4,4,0,0,0,3
"2011","E00003387","E00003387","Total",124,84,21,63,3,12,0,12,24,23,0,1,0,1
"2011","E00003392","E00003392","Total",126,45,20,25,1,35,3,32,45,44,0,1,0,0
"2011","E00003398","E00003398","Total",143,70,17,53,0,58,1,57,14,12,0,2,0,1
"2011","E00003424","E00003424","Total",142,75,18,57,0,7,1,6,58,53,2,3,0,2
"2011","E00003426","E00003426","Total",113,59,19,40,0,24,1,23,30,30,0,0,0,0
"2011","E00003399","E00003399","Total",99,70,23,47,1,11,0,11,17,17,0,0,0,0
"2011","E00003425","E00003425","Total",114,102,30,72,0,2,0,2,10,10,0,0,0,0
"2011","E00003428","E00003428","Total",131,107,43,64,1,11,0,11,11,10,0,1,0,1
"2011","E00003429","E00003429","Total",112,76,21,55,1,11,0,11,23,22,0,1,0,1
"2011","E00003431","E00003431","Total",143,75,20,55,9,16,1,15,43,40,1,2,0,0
"2011","E00003395","E00003395","Total",102,72,15,57,3,7,1,6,20,19,0,1,0,0
"2011","E00003400","E00003400","Total",130,111,64,47,2,3,0,3,10,10,0,0,0,4
"2011","E00003401","E00003401","Total",122,101,30,71,2,6,0,6,12,10,0,2,0,1
"2011","E00003406","E00003406","Total",115,78,23,55,1,9,0,9,25,23,0,2,0,2
"2011","E00003410","E00003410","Total",124,105,40,65,2,5,1,4,12,10,0,2,0,0
"2011","E00003393","E00003393","Total",129,103,39,64,0,7,0,7,14,13,0,1,0,5
"2011","E00003394","E00003394","Total",123,75,17,58,2,5,1,4,40,37,0,2,1,1
"2011","E00003397","E00003397","Total",102,38,15,23,0,54,5,49,9,9,0,0,0,1
"2011","E00003404","E00003404","Total",104,77,31,46,0,9,5,4,18,17,0,1,0,0
"2011","E00003408","E00003408","Total",107,52,17,35,0,31,2,29,23,22,0,1,0,1
"2011","E00003938","E00003938","Total",135,59,15,44,2,33,2,31,41,36,0,4,1,0
"2011","E00003941","E00003941","Total",105,50,18,32,1,35,6,29,19,19,0,0,0,0
"2011","E00003943","E00003943","Total",138,108,50,58,0,4,0,4,26,22,0,4,0,0
"2011","E00003944","E00003944","Total",135,82,36,46,2,35,8,27,15,15,0,0,0,1
"2011","E00003945","E00003945","Total",137,99,44,55,1,21,1,20,16,16,0,0,0,0
"2011","E00003118","E00003118","Total",208,119,61,58,2,2,0,2,77,73,0,4,0,8
"2011","E00003132","E00003132","Total",131,83,41,42,0,28,1,27,19,16,0,3,0,1
"2011","E00003134","E00003134","Total",145,124,48,76,0,2,0,2,19,19,0,0,0,0
"2011","E00003135","E00003135","Total",125,103,52,51,1,3,1,2,17,15,0,2,0,1
"2011","E00003137","E00003137","Total",119,64,26,38,0,0,0,0,55,51,0,4,0,0
"2011","E00003136","E00003136","Total",108,87,34,53,1,1,0,1,19,18,0,1,0,0
"2011","E00003138","E00003138","Total",116,92,41,51,0,9,0,9,13,11,0,1,1,2
"2011","E00003140","E00003140","Total",138,108,35,73,0,14,4,10,15,14,0,1,0,1
"2011","E00003141","E00003141","Total",135,119,46,73,0,5,2,3,9,7,0,0,2,2
"2011","E00003142","E00003142","Total",138,102,21,81,0,2,0,2,33,30,0,3,0,1
"2011","E00003120","E00003120","Total",118,106,41,65,0,2,0,2,10,9,0,0,1,0
"2011","E00003123","E00003123","Total",143,121,40,81,1,7,1,6,14,13,0,1,0,0
"2011","E00003139","E00003139","Total",132,109,49,60,0,2,0,2,19,15,3,1,0,2
"2011","E00003144","E00003144","Total",130,94,28,66,3,4,1,3,28,25,0,2,1,1
"2011","E00003147","E00003147","Total",123,92,40,52,0,6,0,6,23,22,0,1,0,2
"2011","E00003116","E00003116","Total",127,114,66,48,0,1,0,1,12,12,0,0,0,0
"2011","E00003126","E00003126","Total",114,103,64,39,0,2,0,2,8,8,0,0,0,1
"2011","E00003127","E00003127","Total",97,38,23,15,0,56,1,55,3,2,0,1,0,0
"2011","E00003129","E00003129","Total",146,132,84,48,1,3,1,2,9,8,0,1,0,1
"2011","E00003130","E00003130","Total",124,111,66,45,0,1,0,1,10,10,0,0,0,2
"2011","E00003233","E00003233","Total",109,103,58,45,0,1,0,1,5,5,0,0,0,0
"2011","E00003234","E00003234","Total",97,89,40,49,0,2,0,2,5,5,0,0,0,1
"2011","E00003235","E00003235","Total",141,128,50,78,0,3,0,3,8,8,0,0,0,2
"2011","E00003270","E00003270","Total",191,81,32,49,15,33,0,33,61,55,0,6,0,1
"2011","E00003271","E00003271","Total",128,84,32,52,0,6,0,6,36,36,0,0,0,2
"2011","E00003238","E00003238","Total",143,103,50,53,1,1,0,1,35,34,0,1,0,3
"2011","E00003239","E00003239","Total",168,116,63,53,0,1,0,1,49,46,0,3,0,2
"2011","E00003278","E00003278","Total",134,128,76,52,0,0,0,0,6,6,0,0,0,0
"2011","E00166615","E00166615","Total",120,61,30,31,0,10,0,10,48,46,0,2,0,1
"2011","E00166619","E00166619","Total",109,20,5,15,0,59,2,57,30,29,0,1,0,0
"2011","E00166621","E00166621","Total",113,31,12,19,0,8,0,8,72,70,0,2,0,2
"2011","E00166624","E00166624","Total",77,67,32,35,0,5,0,5,4,4,0,0,0,1
"2011","E00003236","E00003236","Total",113,52,21,31,0,5,0,5,54,50,0,4,0,2
"2011","E00003254","E00003254","Total",166,64,21,43,1,9,1,8,90,89,0,1,0,2
"2011","E00003258","E00003258","Total",120,94,39,55,1,7,1,6,17,17,0,0,0,1
"2011","E00003259","E00003259","Total",101,86,53,33,0,0,0,0,12,10,0,2,0,3
"2011","E00003262","E00003262","Total",87,82,41,41,0,0,0,0,5,5,0,0,0,0
"2011","E00003264","E00003264","Total",103,56,28,28,0,4,1,3,41,38,0,1,2,2
"2011","E00003257","E00003257","Total",144,87,22,65,0,21,4,17,36,33,1,2,0,0
"2011","E00003260","E00003260","Total",88,43,9,34,2,0,0,0,42,41,0,1,0,1
"2011","E00003261","E00003261","Total",125,75,34,41,0,0,0,0,49,46,1,2,0,1
"2011","E00003263","E00003263","Total",138,117,38,79,1,1,0,1,19,19,0,0,0,0
"2011","E00003265","E00003265","Total",146,116,36,80,0,8,0,8,21,20,0,1,0,1
"2011","E00003266","E00003266","Total",159,90,37,53,2,2,1,1,62,61,0,1,0,3
"2011","E00003710","E00003710","Total",116,101,64,37,0,2,0,2,13,12,0,0,1,0
"2011","E00003738","E00003738","Total",160,103,45,58,2,1,0,1,51,49,0,2,0,3
"2011","E00003739","E00003739","Total",105,91,54,37,0,3,0,3,11,9,0,1,1,0
"2011","E00003740","E00003740","Total",122,99,49,50,2,7,0,7,13,11,0,2,0,1
"2011","E00003741","E00003741","Total",107,87,46,41,2,0,0,0,18,17,0,1,0,0
"2011","E00003742","E00003742","Total",133,116,59,57,0,3,0,3,13,13,0,0,0,1
"2011","E00004049","E00004049","Total",162,81,26,55,0,10,1,9,69,69,0,0,0,2
"2011","E00004053","E00004053","Total",160,108,42,66,0,15,0,15,36,35,0,1,0,1
"2011","E00004056","E00004056","Total",148,100,46,54,0,13,0,13,31,29,1,1,0,4
"2011","E00004071","E00004071","Total",130,116,63,53,0,3,0,3,10,10,0,0,0,1
"2011","E00004074","E00004074","Total",134,118,48,70,0,3,0,3,12,11,0,1,0,1
"2011","E00003502","E00003502","Total",124,65,15,50,8,28,2,26,22,18,0,2,2,1
"2011","E00003504","E00003504","Total",129,102,36,66,0,11,1,10,15,10,0,5,0,1
"2011","E00003507","E00003507","Total",102,67,37,30,9,4,1,3,21,18,0,3,0,1
"2011","E00003508","E00003508","Total",232,91,21,70,39,75,12,63,23,21,0,1,1,4
"2011","E00003509","E00003509","Total",144,77,35,42,2,48,7,41,17,16,1,0,0,0
"2011","E00003543","E00003543","Total",122,63,31,32,1,46,10,36,11,10,0,1,0,1
"2011","E00003503","E00003503","Total",155,41,6,35,2,91,11,80,20,18,1,0,1,1
"2011","E00003505","E00003505","Total",136,89,17,72,2,17,3,14,27,25,0,2,0,1
"2011","E00003506","E00003506","Total",128,82,34,48,1,28,7,21,16,16,0,0,0,1
"2011","E00003513","E00003513","Total",121,46,11,35,0,71,13,58,4,3,0,1,0,0
"2011","E00003520","E00003520","Total",128,91,44,47,0,12,3,9,23,17,2,4,0,2
"2011","E00003512","E00003512","Total",127,25,8,17,0,92,15,77,9,7,0,2,0,1
"2011","E00003514","E00003514","Total",127,55,10,45,8,56,8,48,7,7,0,0,0,1
"2011","E00003516","E00003516","Total",117,57,22,35,2,52,6,46,6,5,0,1,0,0
"2011","E00166117","E00166117","Total",153,38,13,25,1,101,24,77,11,11,0,0,0,2
"2011","E00003493","E00003493","Total",159,31,11,20,0,124,28,96,3,3,0,0,0,1
"2011","E00003494","E00003494","Total",140,28,10,18,0,109,17,92,3,3,0,0,0,0
"2011","E00003517","E00003517","Total",129,65,21,44,0,47,5,42,17,11,5,1,0,0
"2011","E00003521","E00003521","Total",118,86,30,56,1,27,6,21,4,3,0,0,1,0
"2011","E00003523","E00003523","Total",128,47,13,34,0,74,11,63,5,5,0,0,0,2
"2011","E00003501","E00003501","Total",123,71,34,37,0,33,10,23,16,13,0,3,0,3
"2011","E00003540","E00003540","Total",129,66,29,37,0,38,6,32,21,17,1,3,0,4
"2011","E00003541","E00003541","Total",130,101,53,48,1,16,2,14,8,8,0,0,0,4
"2011","E00003542","E00003542","Total",136,106,57,49,0,16,2,14,13,10,0,2,1,1
"2011","E00003544","E00003544","Total",139,110,53,57,1,12,3,9,16,13,0,2,1,0
"2011","E00003110","E00003110","Total",112,93,48,45,0,1,0,1,16,16,0,0,0,2
"2011","E00003113","E00003113","Total",126,110,50,60,1,10,0,10,4,3,1,0,0,1
"2011","E00003148","E00003148","Total",140,104,46,58,0,19,1,18,15,14,0,1,0,2
"2011","E00003149","E00003149","Total",133,106,52,54,0,13,1,12,13,13,0,0,0,1
"2011","E00003150","E00003150","Total",120,75,30,45,1,28,3,25,15,15,0,0,0,1
"2011","E00003189","E00003189","Total",171,118,39,79,0,15,1,14,36,34,0,2,0,2
"2011","E00003190","E00003190","Total",148,99,35,64,0,1,0,1,45,44,1,0,0,3
"2011","E00003193","E00003193","Total",118,65,31,34,0,32,0,32,20,20,0,0,0,1
"2011","E00003229","E00003229","Total",122,95,28,67,0,3,0,3,23,22,0,1,0,1
"2011","E00003230","E00003230","Total",132,110,40,70,0,4,1,3,17,16,0,1,0,1
"2011","E00003191","E00003191","Total",218,146,48,98,1,18,3,15,51,44,0,7,0,2
"2011","E00003192","E00003192","Total",123,103,34,69,2,1,0,1,16,15,0,1,0,1
"2011","E00003195","E00003195","Total",146,128,55,73,0,4,0,4,14,13,0,1,0,0
"2011","E00003200","E00003200","Total",163,119,40,79,0,21,3,18,22,21,0,1,0,1
"2011","E00003231","E00003231","Total",90,70,34,36,3,1,0,1,15,15,0,0,0,1
"2011","E00003237","E00003237","Total",167,102,43,59,27,12,1,11,24,24,0,0,0,2
"2011","E00003240","E00003240","Total",126,56,30,26,0,53,1,52,16,16,0,0,0,1
"2011","E00003268","E00003268","Total",152,134,55,79,0,4,0,4,13,13,0,0,0,1
"2011","E00003275","E00003275","Total",99,46,24,22,1,4,0,4,47,46,0,0,1,1
"2011","E00003276","E00003276","Total",130,81,30,51,0,9,0,9,40,40,0,0,0,0
"2011","E00003279","E00003279","Total",110,73,33,40,0,15,1,14,19,17,0,1,1,3
"2011","E00003267","E00003267","Total",142,125,44,81,0,3,1,2,12,11,0,1,0,2
"2011","E00003269","E00003269","Total",112,87,32,55,2,3,0,3,19,16,0,3,0,1
"2011","E00003272","E00003272","Total",149,126,42,84,1,2,0,2,18,18,0,0,0,2
"2011","E00003273","E00003273","Total",125,88,25,63,1,10,0,10,26,22,0,4,0,0
"2011","E00003277","E00003277","Total",134,112,42,70,3,1,1,0,18,15,0,3,0,0
"2011","E00004051","E00004051","Total",129,118,57,61,0,0,0,0,10,10,0,0,0,1
"2011","E00004063","E00004063","Total",104,103,55,48,0,0,0,0,1,1,0,0,0,0
"2011","E00004066","E00004066","Total",114,111,54,57,0,0,0,0,3,3,0,0,0,0
"2011","E00004068","E00004068","Total",108,104,53,51,0,0,0,0,3,3,0,0,0,1
"2011","E00004069","E00004069","Total",108,103,54,49,0,0,0,0,4,4,0,0,0,1
"2011","E00004059","E00004059","Total",134,113,78,35,0,2,0,2,19,15,0,4,0,0
"2011","E00004060","E00004060","Total",128,92,51,41,0,4,0,4,31,30,0,1,0,1
"2011","E00004062","E00004062","Total",137,96,51,45,0,1,0,1,39,37,0,2,0,1
"2011","E00004064","E00004064","Total",118,116,76,40,0,1,0,1,0,0,0,0,0,1
"2011","E00004065","E00004065","Total",169,91,46,45,0,28,0,28,46,41,0,2,3,4
"2011","E00004067","E00004067","Total",104,96,52,44,1,0,0,0,7,7,0,0,0,0
"2011","E00004048","E00004048","Total",101,96,58,38,0,1,1,0,2,2,0,0,0,2
"2011","E00004054","E00004054","Total",117,112,65,47,0,0,0,0,5,5,0,0,0,0
"2011","E00004055","E00004055","Total",103,101,54,47,0,0,0,0,0,0,0,0,0,2
"2011","E00004057","E00004057","Total",104,103,60,43,0,0,0,0,1,0,0,1,0,0
"2011","E00004061","E00004061","Total",119,112,58,54,1,1,1,0,5,5,0,0,0,0
"2011","E00004042","E00004042","Total",131,87,46,41,1,20,2,18,22,21,0,1,0,1
"2011","E00004050","E00004050","Total",129,100,60,40,1,23,1,22,5,5,0,0,0,0
"2011","E00004052","E00004052","Total",135,130,71,59,0,2,0,2,3,3,0,0,0,0
"2011","E00004058","E00004058","Total",141,129,97,32,0,2,0,2,9,9,0,0,0,1
"2011","E00004072","E00004072","Total",112,76,33,43,0,3,0,3,31,30,0,1,0,2
"2011","E00004073","E00004073","Total",141,64,34,30,1,27,1,26,48,45,0,2,1,1
"2011","E00004077","E00004077","Total",133,126,51,75,1,0,0,0,4,4,0,0,0,2
"2011","E00004104","E00004104","Total",119,112,54,58,0,1,0,1,6,5,0,0,1,0
"2011","E00004105","E00004105","Total",131,127,64,63,0,1,1,0,3,3,0,0,0,0
"2011","E00004107","E00004107","Total",114,107,53,54,0,1,0,1,5,4,0,1,0,1
"2011","E00003111","E00003111","Total",129,118,60,58,0,0,0,0,10,9,0,1,0,1
"2011","E00003112","E00003112","Total",141,57,25,32,1,73,1,72,8,8,0,0,0,2
"2011","E00003114","E00003114","Total",121,81,45,36,0,36,3,33,3,3,0,0,0,1
"2011","E00003146","E00003146","Total",219,185,97,88,0,15,0,15,17,16,0,1,0,2
"2011","E00003154","E00003154","Total",140,121,55,66,0,3,0,3,16,15,1,0,0,0
"2011","E00003115","E00003115","Total",80,75,41,34,0,1,0,1,4,3,0,1,0,0
"2011","E00003124","E00003124","Total",125,103,57,46,0,1,0,1,19,18,0,1,0,2
"2011","E00003125","E00003125","Total",118,110,55,55,0,2,0,2,6,6,0,0,0,0
"2011","E00003151","E00003151","Total",118,104,67,37,2,7,0,7,4,4,0,0,0,1
"2011","E00003152","E00003152","Total",110,109,47,62,0,0,0,0,1,1,0,0,0,0
"2011","E00003153","E00003153","Total",108,94,49,45,0,9,0,9,2,2,0,0,0,3
"2011","E00003964","E00003964","Total",121,119,68,51,0,0,0,0,2,2,0,0,0,0
"2011","E00003965","E00003965","Total",122,118,68,50,0,1,0,1,2,1,0,1,0,1
"2011","E00003969","E00003969","Total",118,115,49,66,0,0,0,0,3,3,0,0,0,0
"2011","E00003973","E00003973","Total",104,99,56,43,0,1,0,1,4,4,0,0,0,0
"2011","E00003974","E00003974","Total",130,32,13,19,1,15,0,15,78,71,2,2,3,4
"2011","E00003949","E00003949","Total",158,147,72,75,0,1,0,1,7,7,0,0,0,3
"2011","E00003957","E00003957","Total",112,108,75,33,0,0,0,0,2,2,0,0,0,2
"2011","E00003970","E00003970","Total",131,120,49,71,0,5,2,3,5,4,0,1,0,1
"2011","E00003976","E00003976","Total",123,113,51,62,0,1,0,1,7,6,0,1,0,2
"2011","E00003984","E00003984","Total",105,97,66,31,0,2,0,2,5,3,0,2,0,1
"2011","E00003510","E00003510","Total",127,99,39,60,1,8,2,6,19,17,0,2,0,0
"2011","E00003518","E00003518","Total",133,66,32,34,1,22,4,18,42,42,0,0,0,2
"2011","E00003519","E00003519","Total",140,95,39,56,3,18,3,15,22,20,0,2,0,2
"2011","E00003522","E00003522","Total",148,124,45,79,0,7,0,7,15,14,0,1,0,2
"2011","E00003524","E00003524","Total",156,108,40,68,2,32,2,30,13,11,0,2,0,1
"2011","E00003495","E00003495","Total",125,33,12,21,1,78,4,74,12,11,0,1,0,1
"2011","E00003496","E00003496","Total",136,123,61,62,2,4,0,4,6,6,0,0,0,1
"2011","E00003526","E00003526","Total",125,42,13,29,1,55,4,51,25,23,0,2,0,2
"2011","E00003528","E00003528","Total",142,96,35,61,0,23,1,22,23,19,0,4,0,0
"2011","E00003529","E00003529","Total",135,45,15,30,1,72,5,67,14,13,0,1,0,3
"2011","E00003530","E00003530","Total",112,66,26,40,1,1,0,1,42,42,0,0,0,2
"2011","E00003556","E00003556","Total",140,108,38,70,1,22,4,18,7,7,0,0,0,2
"2011","E00003560","E00003560","Total",139,79,27,52,1,53,10,43,6,6,0,0,0,0
"2011","E00003596","E00003596","Total",134,88,48,40,2,36,1,35,7,7,0,0,0,1
"2011","E00003597","E00003597","Total",119,77,39,38,2,30,3,27,9,7,0,2,0,1
"2011","E00003545","E00003545","Total",112,91,37,54,0,20,2,18,1,1,0,0,0,0
"2011","E00003559","E00003559","Total",99,82,44,38,0,10,4,6,5,3,0,2,0,2
"2011","E00003561","E00003561","Total",137,92,32,60,1,33,9,24,8,8,0,0,0,3
"2011","E00003565","E00003565","Total",130,113,62,51,0,11,1,10,5,5,0,0,0,1
"2011","E00003566","E00003566","Total",109,94,46,48,0,9,3,6,6,5,0,1,0,0
"2011","E00003558","E00003558","Total",179,82,34,48,17,71,12,59,9,7,0,2,0,0
"2011","E00003562","E00003562","Total",137,115,50,65,0,16,1,15,6,5,0,1,0,0
"2011","E00003563","E00003563","Total",113,72,38,34,1,36,3,33,4,4,0,0,0,0
"2011","E00003564","E00003564","Total",101,84,40,44,0,11,0,11,5,5,0,0,0,1
"2011","E00003567","E00003567","Total",121,104,49,55,0,3,0,3,12,10,0,2,0,2
"2011","E00003762","E00003762","Total",123,116,50,66,0,1,0,1,4,3,1,0,0,2
"2011","E00003763","E00003763","Total",93,30,7,23,0,60,1,59,3,1,0,1,1,0
"2011","E00003764","E00003764","Total",112,96,48,48,0,7,0,7,8,3,5,0,0,1
"2011","E00003802","E00003802","Total",126,120,54,66,0,1,0,1,5,5,0,0,0,0
"2011","E00003772","E00003772","Total",111,20,15,5,0,84,0,84,5,5,0,0,0,2
"2011","E00003777","E00003777","Total",115,110,55,55,0,0,0,0,4,4,0,0,0,1
"2011","E00003783","E00003783","Total",121,107,39,68,0,3,0,3,11,11,0,0,0,0
"2011","E00003790","E00003790","Total",123,110,53,57,0,2,0,2,10,7,0,3,0,1
"2011","E00003791","E00003791","Total",135,123,53,70,1,0,0,0,10,9,0,1,0,1
"2011","E00003760","E00003760","Total",109,91,46,45,0,4,0,4,14,13,0,1,0,0
"2011","E00003761","E00003761","Total",114,90,35,55,0,0,0,0,20,18,0,0,2,4
"2011","E00003788","E00003788","Total",118,79,41,38,1,26,4,22,10,9,0,1,0,2
"2011","E00003795","E00003795","Total",126,119,54,65,1,3,0,3,3,3,0,0,0,0
"2011","E00166112","E00166112","Total",134,101,38,63,0,1,0,1,30,30,0,0,0,2
"2011","E00166114","E00166114","Total",129,109,28,81,2,2,0,2,14,14,0,0,0,2
"2011","E00166115","E00166115","Total",137,121,55,66,0,2,0,2,14,14,0,0,0,0
"2011","E00003792","E00003792","Total",144,136,53,83,1,1,1,0,5,5,0,0,0,1
"2011","E00003796","E00003796","Total",156,123,54,69,0,3,0,3,28,25,1,1,1,2
"2011","E00003797","E00003797","Total",125,118,62,56,0,1,0,1,6,6,0,0,0,0
"2011","E00003803","E00003803","Total",140,121,58,63,0,3,0,3,15,15,0,0,0,1
"2011","E00003758","E00003758","Total",127,92,45,47,0,23,6,17,12,12,0,0,0,0
"2011","E00003799","E00003799","Total",117,111,45,66,0,2,1,1,4,3,0,1,0,0
"2011","E00003800","E00003800","Total",133,116,50,66,0,11,5,6,5,5,0,0,0,1
"2011","E00003801","E00003801","Total",114,61,18,43,1,44,8,36,8,8,0,0,0,0
"2011","E00003804","E00003804","Total",127,116,42,74,1,3,0,3,6,6,0,0,0,1
"2011","E00003951","E00003951","Total",132,121,60,61,0,1,0,1,8,8,0,0,0,2
"2011","E00003982","E00003982","Total",116,111,56,55,0,0,0,0,3,3,0,0,0,2
"2011","E00003987","E00003987","Total",121,78,36,42,0,33,2,31,7,7,0,0,0,3
"2011","E00003988","E00003988","Total",132,129,54,75,0,0,0,0,2,2,0,0,0,1
"2011","E00003990","E00003990","Total",124,116,70,46,0,2,0,2,5,5,0,0,0,1
"2011","E00003972","E00003972","Total",129,126,69,57,0,0,0,0,3,3,0,0,0,0
"2011","E00003975","E00003975","Total",131,124,68,56,0,0,0,0,5,5,0,0,0,2
"2011","E00003977","E00003977","Total",112,106,65,41,0,1,0,1,4,3,0,1,0,1
"2011","E00003979","E00003979","Total",115,103,59,44,0,0,0,0,12,11,0,1,0,0
"2011","E00003980","E00003980","Total",112,110,60,50,0,0,0,0,2,1,0,1,0,0
"2011","E00003948","E00003948","Total",150,140,65,75,0,1,0,1,7,6,0,1,0,2
"2011","E00003950","E00003950","Total",133,114,56,58,1,1,0,1,17,17,0,0,0,0
"2011","E00003978","E00003978","Total",147,140,67,73,0,1,0,1,6,5,0,1,0,0
"2011","E00003983","E00003983","Total",141,84,32,52,0,2,0,2,54,53,0,1,0,1
"2011","E00003960","E00003960","Total",131,126,71,55,0,0,0,0,2,2,0,0,0,3
"2011","E00003963","E00003963","Total",141,134,85,49,0,1,0,1,5,5,0,0,0,1
"2011","E00003981","E00003981","Total",113,109,66,43,0,1,0,1,3,3,0,0,0,0
"2011","E00003985","E00003985","Total",130,112,63,49,1,0,0,0,13,10,0,3,0,4
"2011","E00003986","E00003986","Total",122,113,58,55,0,3,0,3,4,4,0,0,0,2
"2011","E00003955","E00003955","Total",106,104,56,48,0,0,0,0,2,2,0,0,0,0
"2011","E00003966","E00003966","Total",102,100,56,44,0,0,0,0,1,1,0,0,0,1
"2011","E00003967","E00003967","Total",130,124,65,59,1,0,0,0,5,3,0,2,0,0
"2011","E00003968","E00003968","Total",115,111,70,41,1,2,0,2,1,1,0,0,0,0
"2011","E00003971","E00003971","Total",109,103,55,48,0,0,0,0,4,4,0,0,0,2
"2011","E00003196","E00003196","Total",152,75,31,44,2,56,8,48,17,14,2,1,0,2
"2011","E00003205","E00003205","Total",155,33,9,24,1,114,15,99,6,6,0,0,0,1
"2011","E00003206","E00003206","Total",125,49,17,32,0,67,15,52,6,6,0,0,0,3
"2011","E00003208","E00003208","Total",117,34,15,19,0,77,15,62,4,3,0,1,0,2
"2011","E00003212","E00003212","Total",122,37,15,22,0,67,6,61,16,16,0,0,0,2
"2011","E00003194","E00003194","Total",131,109,47,62,1,14,2,12,5,5,0,0,0,2
"2011","E00003197","E00003197","Total",151,91,35,56,3,46,8,38,11,10,0,1,0,0
"2011","E00003198","E00003198","Total",149,81,32,49,16,46,7,39,5,5,0,0,0,1
"2011","E00003201","E00003201","Total",123,96,46,50,0,16,3,13,11,11,0,0,0,0
"2011","E00003202","E00003202","Total",126,113,44,69,0,6,1,5,7,6,0,1,0,0
"2011","E00003199","E00003199","Total",124,75,19,56,0,42,9,33,5,5,0,0,0,2
"2011","E00003203","E00003203","Total",126,94,48,46,0,25,1,24,3,3,0,0,0,4
"2011","E00003207","E00003207","Total",121,97,39,58,0,18,3,15,4,4,0,0,0,2
"2011","E00003209","E00003209","Total",140,59,23,36,0,74,12,62,3,3,0,0,0,4
"2011","E00003211","E00003211","Total",149,112,50,62,1,25,2,23,11,11,0,0,0,0
"2011","E00003204","E00003204","Total",135,89,27,62,0,39,7,32,6,6,0,0,0,1
"2011","E00003210","E00003210","Total",132,66,34,32,0,62,13,49,2,2,0,0,0,2
"2011","E00003213","E00003213","Total",116,89,47,42,0,18,3,15,9,8,0,1,0,0
"2011","E00003216","E00003216","Total",107,97,40,57,0,4,0,4,5,4,0,1,0,1
"2011","E00003218","E00003218","Total",122,109,57,52,1,5,1,4,6,6,0,0,0,1
"2011","E00003711","E00003711","Total",128,122,57,65,0,1,0,1,4,4,0,0,0,1
"2011","E00003712","E00003712","Total",142,136,67,69,0,0,0,0,5,5,0,0,0,1
"2011","E00003744","E00003744","Total",118,114,56,58,1,0,0,0,3,2,0,1,0,0
"2011","E00003747","E00003747","Total",135,127,56,71,0,2,0,2,6,6,0,0,0,0
"2011","E00003743","E00003743","Total",125,116,58,58,0,3,1,2,6,5,0,1,0,0
"2011","E00003745","E00003745","Total",121,112,60,52,0,6,0,6,3,2,0,1,0,0
"2011","E00003746","E00003746","Total",141,108,59,49,0,28,1,27,5,4,0,1,0,0
"2011","E00003748","E00003748","Total",136,112,46,66,1,20,3,17,3,3,0,0,0,0
"2011","E00003749","E00003749","Total",110,78,32,46,0,27,4,23,5,4,0,1,0,0
"2011","E00003713","E00003713","Total",128,126,69,57,0,0,0,0,1,0,1,0,0,1
"2011","E00003715","E00003715","Total",122,118,68,50,0,1,0,1,2,2,0,0,0,1
"2011","E00003750","E00003750","Total",147,143,69,74,0,1,0,1,3,3,0,0,0,0
"2011","E00003751","E00003751","Total",124,121,55,66,0,0,0,0,3,3,0,0,0,0
"2011","E00003756","E00003756","Total",124,120,60,60,0,1,0,1,2,2,0,0,0,1
"2011","E00003714","E00003714","Total",121,109,60,49,0,2,0,2,9,9,0,0,0,1
"2011","E00003752","E00003752","Total",124,118,49,69,0,1,0,1,5,5,0,0,0,0
"2011","E00003753","E00003753","Total",130,126,64,62,0,0,0,0,4,4,0,0,0,0
"2011","E00003754","E00003754","Total",110,108,55,53,0,0,0,0,1,1,0,0,0,1
"2011","E00003755","E00003755","Total",113,106,47,59,0,0,0,0,6,6,0,0,0,1
"2011","E00004108","E00004108","Total",119,110,38,72,1,2,0,2,5,3,1,1,0,1
"2011","E00004110","E00004110","Total",102,92,32,60,1,3,0,3,6,4,0,2,0,0
"2011","E00004111","E00004111","Total",126,115,48,67,0,0,0,0,8,8,0,0,0,3
"2011","E00004114","E00004114","Total",114,111,38,73,0,0,0,0,3,2,0,1,0,0
"2011","E00003497","E00003497","Total",105,94,59,35,0,3,1,2,7,6,0,1,0,1
"2011","E00003498","E00003498","Total",202,147,79,68,2,34,0,34,19,18,0,1,0,0
"2011","E00003500","E00003500","Total",133,91,46,45,0,31,4,27,9,8,1,0,0,2
"2011","E00003531","E00003531","Total",138,92,32,60,1,6,0,6,37,34,1,1,1,2
"2011","E00003535","E00003535","Total",109,99,62,37,1,4,0,4,5,3,0,2,0,0
"2011","E00003546","E00003546","Total",136,133,77,56,0,2,2,0,1,1,0,0,0,0
"2011","E00003568","E00003568","Total",124,99,50,49,0,21,4,17,4,3,0,1,0,0
"2011","E00003569","E00003569","Total",125,89,28,61,2,13,2,11,20,18,0,2,0,1
"2011","E00003570","E00003570","Total",122,79,31,48,0,17,4,13,26,22,0,4,0,0
"2011","E00003849","E00003849","Total",139,125,76,49,1,1,0,1,10,8,0,1,1,2
"2011","E00003850","E00003850","Total",126,92,38,54,0,2,0,2,29,25,1,3,0,3
"2011","E00003852","E00003852","Total",157,96,41,55,0,14,1,13,47,46,0,1,0,0
"2011","E00003868","E00003868","Total",147,80,43,37,0,7,0,7,60,56,1,3,0,0
"2011","E00166616","E00166616","Total",171,66,27,39,22,40,3,37,41,39,0,2,0,2
"2011","E00166618","E00166618","Total",132,62,26,36,0,31,4,27,38,37,1,0,0,1
"2011","E00003952","E00003952","Total",137,114,48,66,1,3,0,3,16,14,0,2,0,3
"2011","E00003956","E00003956","Total",128,119,69,50,0,0,0,0,9,9,0,0,0,0
"2011","E00003958","E00003958","Total",144,83,23,60,1,26,3,23,32,26,0,4,2,2
"2011","E00003961","E00003961","Total",121,118,77,41,0,0,0,0,3,3,0,0,0,0
"2011","E00003989","E00003989","Total",133,81,37,44,0,42,7,35,9,9,0,0,0,1
"2011","E00003953","E00003953","Total",164,159,85,74,0,0,0,0,5,5,0,0,0,0
"2011","E00003954","E00003954","Total",136,131,63,68,1,0,0,0,4,4,0,0,0,0
"2011","E00003959","E00003959","Total",124,118,66,52,0,0,0,0,5,5,0,0,0,1
"2011","E00003962","E00003962","Total",140,136,78,58,0,0,0,0,4,3,0,1,0,0
"2011","E00003499","E00003499","Total",137,124,70,54,2,2,0,2,6,5,0,1,0,3
"2011","E00003534","E00003534","Total",105,100,50,50,0,2,0,2,3,3,0,0,0,0
"2011","E00003537","E00003537","Total",118,112,73,39,0,0,0,0,4,4,0,0,0,2
"2011","E00003538","E00003538","Total",96,86,59,27,0,4,2,2,6,5,0,1,0,0
"2011","E00003539","E00003539","Total",105,95,52,43,0,4,0,4,5,5,0,0,0,1
"2011","E00003525","E00003525","Total",125,105,59,46,1,3,0,3,16,15,0,1,0,0
"2011","E00003527","E00003527","Total",105,90,46,44,2,4,0,4,7,7,0,0,0,2
"2011","E00003532","E00003532","Total",124,101,62,39,1,2,0,2,19,19,0,0,0,1
"2011","E00003533","E00003533","Total",122,98,51,47,4,5,0,5,14,12,0,2,0,1
"2011","E00003536","E00003536","Total",114,95,39,56,1,1,0,1,16,16,0,0,0,1
"2011","E00003844","E00003844","Total",133,118,69,49,3,5,0,5,7,6,0,1,0,0
"2011","E00003845","E00003845","Total",145,113,57,56,1,7,1,6,23,23,0,0,0,1
"2011","E00003853","E00003853","Total",124,65,34,31,1,50,10,40,8,7,0,1,0,0
"2011","E00003855","E00003855","Total",134,92,38,54,1,36,4,32,4,4,0,0,0,1
"2011","E00003888","E00003888","Total",131,120,65,55,0,1,0,1,10,9,0,1,0,0
"2011","E00003847","E00003847","Total",111,102,51,51,0,2,0,2,4,4,0,0,0,3
"2011","E00003851","E00003851","Total",138,87,36,51,16,10,1,9,23,22,0,1,0,2
"2011","E00003859","E00003859","Total",126,68,26,42,1,49,9,40,8,6,0,2,0,0
"2011","E00003867","E00003867","Total",129,95,56,39,1,26,3,23,7,5,0,2,0,0
"2011","E00003870","E00003870","Total",114,109,62,47,0,2,1,1,3,3,0,0,0,0
"2011","E00003846","E00003846","Total",139,118,69,49,1,13,2,11,7,6,0,1,0,0
"2011","E00003854","E00003854","Total",126,120,71,49,0,4,0,4,2,2,0,0,0,0
"2011","E00003862","E00003862","Total",132,119,62,57,2,1,0,1,7,6,0,1,0,3
"2011","E00003866","E00003866","Total",112,105,59,46,0,1,0,1,6,4,0,2,0,0
"2011","E00003872","E00003872","Total",112,75,46,29,0,28,2,26,7,5,0,1,1,2
"2011","E00004085","E00004085","Total",121,116,57,59,1,0,0,0,1,1,0,0,0,3
"2011","E00004086","E00004086","Total",112,97,51,46,0,1,0,1,11,10,0,0,1,3
"2011","E00004106","E00004106","Total",111,106,62,44,0,0,0,0,3,3,0,0,0,2
"2011","E00004109","E00004109","Total",118,88,51,37,0,1,0,1,23,19,0,4,0,6
"2011","E00004112","E00004112","Total",110,107,55,52,0,2,0,2,1,1,0,0,0,0
"2011","E00004079","E00004079","Total",109,66,32,34,0,0,0,0,43,37,1,3,2,0
"2011","E00004080","E00004080","Total",137,122,72,50,0,3,0,3,9,9,0,0,0,3
"2011","E00004082","E00004082","Total",117,92,40,52,1,7,0,7,17,14,0,1,2,0
"2011","E00004087","E00004087","Total",120,75,39,36,0,7,0,7,37,34,1,1,1,1
"2011","E00004088","E00004088","Total",165,123,53,70,0,3,0,3,35,35,0,0,0,4
"2011","E00004113","E00004113","Total",113,107,41,66,0,0,0,0,6,4,0,2,0,0
"2011","E00004116","E00004116","Total",130,124,56,68,1,0,0,0,4,4,0,0,0,1
"2011","E00004117","E00004117","Total",135,128,53,75,0,0,0,0,5,5,0,0,0,2
"2011","E00004118","E00004118","Total",122,112,48,64,1,4,1,3,5,4,0,1,0,0
"2011","E00004078","E00004078","Total",146,135,66,69,0,0,0,0,8,8,0,0,0,3
"2011","E00004084","E00004084","Total",138,87,51,36,0,14,2,12,30,29,0,1,0,7
"2011","E00004094","E00004094","Total",117,87,44,43,0,17,2,15,11,11,0,0,0,2
"2011","E00004115","E00004115","Total",119,92,58,34,2,16,1,15,9,8,0,0,1,0
"2011","E00004119","E00004119","Total",127,118,58,60,0,3,0,3,5,4,0,0,1,1
"2011","E00004075","E00004075","Total",126,110,50,60,0,4,0,4,11,8,2,1,0,1
"2011","E00004083","E00004083","Total",149,137,70,67,0,2,0,2,10,9,0,1,0,0
"2011","E00004089","E00004089","Total",135,127,73,54,0,1,0,1,5,4,0,1,0,2
"2011","E00004092","E00004092","Total",138,133,85,48,1,1,0,1,2,2,0,0,0,1
"2011","E00004091","E00004091","Total",177,140,77,63,14,0,0,0,21,21,0,0,0,2
"2011","E00004096","E00004096","Total",133,119,56,63,0,2,0,2,11,10,0,0,1,1
"2011","E00004099","E00004099","Total",119,118,62,56,0,1,0,1,0,0,0,0,0,0
"2011","E00004100","E00004100","Total",121,117,65,52,0,1,0,1,3,2,0,1,0,0
"2011","E00004076","E00004076","Total",138,136,73,63,0,1,0,1,0,0,0,0,0,1
"2011","E00004097","E00004097","Total",123,3,3,0,0,117,1,116,3,2,0,0,1,0
"2011","E00004098","E00004098","Total",157,139,83,56,0,13,0,13,5,5,0,0,0,0
"2011","E00004101","E00004101","Total",154,136,82,54,0,13,1,12,3,2,0,1,0,2
"2011","E00004103","E00004103","Total",113,111,63,48,0,0,0,0,1,1,0,0,0,1
"2011","E00004081","E00004081","Total",131,120,56,64,0,4,1,3,6,6,0,0,0,1
"2011","E00004090","E00004090","Total",115,92,56,36,0,2,0,2,20,15,3,2,0,1
"2011","E00004093","E00004093","Total",119,103,45,58,0,1,0,1,13,12,1,0,0,2
"2011","E00004095","E00004095","Total",122,118,69,49,0,1,1,0,1,1,0,0,0,2
"2011","E00004102","E00004102","Total",119,117,72,45,0,0,0,0,2,2,0,0,0,0
"2011","E00003686","E00003686","Total",123,115,86,29,0,3,1,2,5,5,0,0,0,0
"2011","E00003693","E00003693","Total",127,124,94,30,0,0,0,0,2,2,0,0,0,1
"2011","E00003694","E00003694","Total",119,89,37,52,0,1,0,1,24,21,0,3,0,5
"2011","E00003700","E00003700","Total",119,115,66,49,0,0,0,0,4,4,0,0,0,0
"2011","E00003701","E00003701","Total",134,118,48,70,1,2,0,2,10,9,0,1,0,3
"2011","E00003706","E00003706","Total",128,124,87,37,0,0,0,0,3,2,0,1,0,1
"2011","E00003663","E00003663","Total",138,115,58,57,1,1,0,1,19,18,0,1,0,2
"2011","E00003666","E00003666","Total",108,88,44,44,0,0,0,0,20,19,0,1,0,0
"2011","E00003685","E00003685","Total",112,96,48,48,0,2,0,2,14,14,0,0,0,0
"2011","E00003687","E00003687","Total",124,121,71,50,0,1,0,1,2,2,0,0,0,0
"2011","E00003689","E00003689","Total",131,109,65,44,1,4,1,3,15,13,0,2,0,2
"2011","E00003690","E00003690","Total",130,111,69,42,1,4,0,4,13,12,0,1,0,1
"2011","E00003664","E00003664","Total",138,124,58,66,0,2,0,2,12,12,0,0,0,0
"2011","E00003688","E00003688","Total",118,100,50,50,0,2,0,2,13,12,0,0,1,3
"2011","E00003691","E00003691","Total",117,111,57,54,0,0,0,0,6,6,0,0,0,0
"2011","E00003692","E00003692","Total",124,116,84,32,0,2,0,2,6,4,0,2,0,0
"2011","E00003696","E00003696","Total",118,116,60,56,0,1,0,1,1,0,0,1,0,0
"2011","E00003672","E00003672","Total",112,112,67,45,0,0,0,0,0,0,0,0,0,0
"2011","E00003697","E00003697","Total",114,111,57,54,0,0,0,0,1,1,0,0,0,2
"2011","E00003698","E00003698","Total",119,111,66,45,0,2,0,2,5,5,0,0,0,1
"2011","E00003702","E00003702","Total",124,119,83,36,1,0,0,0,3,2,0,1,0,1
"2011","E00003705","E00003705","Total",132,125,72,53,0,1,0,1,5,5,0,0,0,1
"2011","E00003668","E00003668","Total",124,117,59,58,0,0,0,0,6,6,0,0,0,1
"2011","E00003671","E00003671","Total",104,94,52,42,1,0,0,0,8,7,0,1,0,1
"2011","E00003673","E00003673","Total",118,110,48,62,0,1,0,1,5,4,0,1,0,2
"2011","E00003699","E00003699","Total",116,112,58,54,0,1,0,1,2,1,0,0,1,1
"2011","E00003703","E00003703","Total",129,87,61,26,1,34,4,30,5,4,0,1,0,2
"2011","E00003841","E00003841","Total",125,117,69,48,0,4,0,4,3,3,0,0,0,1
"2011","E00003842","E00003842","Total",134,129,83,46,0,3,1,2,2,1,0,1,0,0
"2011","E00003871","E00003871","Total",130,114,85,29,0,10,1,9,5,3,0,1,1,1
"2011","E00003877","E00003877","Total",121,102,56,46,0,8,0,8,10,9,0,1,0,1
"2011","E00003881","E00003881","Total",117,114,91,23,0,2,1,1,0,0,0,0,0,1
"2011","E00003856","E00003856","Total",109,22,10,12,0,85,7,78,2,2,0,0,0,0
"2011","E00003857","E00003857","Total",135,40,5,35,1,74,12,62,20,19,0,1,0,0
"2011","E00003860","E00003860","Total",103,53,22,31,0,39,5,34,10,10,0,0,0,1
"2011","E00003861","E00003861","Total",164,22,10,12,11,124,15,109,4,4,0,0,0,3
"2011","E00003863","E00003863","Total",146,12,1,11,1,126,20,106,5,5,0,0,0,2
"2011","E00003848","E00003848","Total",112,103,65,38,1,2,0,2,6,5,0,1,0,0
"2011","E00003864","E00003864","Total",63,35,17,18,0,20,2,18,8,5,0,3,0,0
"2011","E00003865","E00003865","Total",56,16,7,9,7,29,7,22,4,3,0,1,0,0
"2011","E00003869","E00003869","Total",131,122,75,47,0,1,1,0,7,7,0,0,0,1
"2011","E00003875","E00003875","Total",121,106,68,38,0,9,0,9,6,6,0,0,0,0
"2011","E00003873","E00003873","Total",125,117,63,54,1,2,1,1,5,5,0,0,0,0
"2011","E00003874","E00003874","Total",120,111,64,47,0,4,1,3,5,4,0,1,0,0
"2011","E00003876","E00003876","Total",128,123,74,49,0,2,0,2,2,2,0,0,0,1
"2011","E00003878","E00003878","Total",125,120,67,53,0,1,0,1,4,4,0,0,0,0
"2011","E00003882","E00003882","Total",145,136,79,57,0,1,0,1,7,6,0,1,0,1
"2011","E00003843","E00003843","Total",151,138,82,56,1,5,0,5,6,6,0,0,0,1
"2011","E00003885","E00003885","Total",129,56,23,33,0,67,12,55,6,5,0,0,1,0
"2011","E00003886","E00003886","Total",130,105,25,80,0,19,1,18,5,5,0,0,0,1
"2011","E00003887","E00003887","Total",132,102,57,45,0,25,2,23,5,4,0,1,0,0
"2011","E00003214","E00003214","Total",109,91,45,46,0,1,1,0,16,14,0,1,1,1
"2011","E00003215","E00003215","Total",154,91,38,53,11,30,3,27,22,22,0,0,0,0
"2011","E00003217","E00003217","Total",122,106,40,66,1,2,0,2,12,11,0,1,0,1
"2011","E00003219","E00003219","Total",130,108,58,50,3,4,0,4,13,12,0,0,1,2
"2011","E00003220","E00003220","Total",108,91,33,58,0,2,1,1,15,14,0,0,1,0
"2011","E00003221","E00003221","Total",134,114,64,50,0,3,0,3,15,14,0,1,0,2
"2011","E00003186","E00003186","Total",100,87,45,42,0,1,0,1,11,11,0,0,0,1
"2011","E00003188","E00003188","Total",212,180,103,77,0,1,0,1,29,28,0,1,0,2
"2011","E00003223","E00003223","Total",118,116,77,39,0,0,0,0,2,1,0,1,0,0
"2011","E00003226","E00003226","Total",123,115,72,43,0,0,0,0,8,7,0,0,1,0
"2011","E00003227","E00003227","Total",105,97,63,34,0,0,0,0,6,6,0,0,0,2
"2011","E00003228","E00003228","Total",118,96,53,43,0,3,0,3,17,17,0,0,0,2
"2011","E00003185","E00003185","Total",121,111,56,55,0,3,0,3,6,6,0,0,0,1
"2011","E00003187","E00003187","Total",134,121,66,55,0,4,0,4,8,8,0,0,0,1
"2011","E00003222","E00003222","Total",122,119,69,50,0,0,0,0,3,3,0,0,0,0
"2011","E00003224","E00003224","Total",123,123,69,54,0,0,0,0,0,0,0,0,0,0
"2011","E00003225","E00003225","Total",122,119,72,47,0,0,0,0,3,2,0,0,1,0
"2011","E00003665","E00003665","Total",130,112,61,51,0,5,2,3,11,11,0,0,0,2
"2011","E00003667","E00003667","Total",109,89,55,34,0,1,0,1,15,15,0,0,0,4
"2011","E00003669","E00003669","Total",127,123,71,52,0,4,0,4,0,0,0,0,0,0
"2011","E00003695","E00003695","Total",116,110,65,45,0,1,0,1,2,2,0,0,0,3
"2011","E00003704","E00003704","Total",112,103,56,47,0,1,1,0,8,8,0,0,0,0
"2011","E00003709","E00003709","Total",130,122,61,61,0,1,0,1,5,4,1,0,0,2
"2011","E00003725","E00003725","Total",57,49,28,21,0,2,1,1,5,4,0,1,0,1
"2011","E00003731","E00003731","Total",120,115,55,60,0,1,0,1,3,3,0,0,0,1
"2011","E00003734","E00003734","Total",128,117,57,60,0,1,0,1,10,8,1,1,0,0
"2011","E00003736","E00003736","Total",114,109,44,65,1,1,1,0,3,2,0,1,0,0
"2011","E00003724","E00003724","Total",105,98,52,46,0,1,0,1,3,1,0,2,0,3
"2011","E00003727","E00003727","Total",103,97,52,45,0,1,0,1,5,5,0,0,0,0
"2011","E00003728","E00003728","Total",118,65,38,27,0,8,2,6,43,39,2,2,0,2
"2011","E00003730","E00003730","Total",115,111,46,65,0,0,0,0,3,3,0,0,0,1
"2011","E00003733","E00003733","Total",109,95,38,57,0,4,0,4,9,9,0,0,0,1
"2011","E00003726","E00003726","Total",128,123,63,60,0,0,0,0,4,4,0,0,0,1
"2011","E00003729","E00003729","Total",142,131,53,78,0,0,0,0,11,11,0,0,0,0
"2011","E00003732","E00003732","Total",90,88,38,50,0,1,0,1,1,1,0,0,0,0
"2011","E00003735","E00003735","Total",115,108,43,65,0,1,1,0,5,4,0,1,0,1
"2011","E00003737","E00003737","Total",102,98,46,52,0,0,0,0,3,3,0,0,0,1
"2011","E00003707","E00003707","Total",145,119,53,66,1,4,0,4,19,12,1,6,0,2
"2011","E00003716","E00003716","Total",113,97,45,52,1,9,1,8,6,5,0,0,1,0
"2011","E00003717","E00003717","Total",116,88,41,47,0,4,1,3,22,21,1,0,0,2
"2011","E00003718","E00003718","Total",149,142,84,58,0,0,0,0,7,7,0,0,0,0
"2011","E00003719","E00003719","Total",156,111,42,69,0,2,0,2,40,39,0,1,0,3
"2011","E00003708","E00003708","Total",136,103,61,42,1,2,0,2,26,26,0,0,0,4
"2011","E00003720","E00003720","Total",115,99,56,43,0,1,0,1,12,10,0,1,1,3
"2011","E00003721","E00003721","Total",114,62,29,33,0,34,1,33,18,18,0,0,0,0
"2011","E00003722","E00003722","Total",107,98,57,41,0,0,0,0,9,7,2,0,0,0
"2011","E00003723","E00003723","Total",141,131,73,58,0,2,0,2,7,5,1,1,0,1
"2011","E00003312","E00003312","Total",138,131,60,71,0,0,0,0,6,6,0,0,0,1
"2011","E00003313","E00003313","Total",123,117,58,59,0,0,0,0,6,6,0,0,0,0
"2011","E00003314","E00003314","Total",128,118,47,71,0,0,0,0,10,7,0,3,0,0
"2011","E00003315","E00003315","Total",128,125,65,60,0,2,0,2,1,1,0,0,0,0
"2011","E00003319","E00003319","Total",137,133,61,72,0,1,0,1,1,1,0,0,0,2
"2011","E00003322","E00003322","Total",126,114,76,38,0,0,0,0,9,9,0,0,0,3
"2011","E00003323","E00003323","Total",117,99,52,47,0,0,0,0,17,14,3,0,0,1
"2011","E00003325","E00003325","Total",133,131,74,57,0,0,0,0,2,2,0,0,0,0
"2011","E00003327","E00003327","Total",136,129,85,44,0,1,1,0,6,5,0,1,0,0
"2011","E00003328","E00003328","Total",130,127,55,72,0,1,0,1,2,2,0,0,0,0
"2011","E00003311","E00003311","Total",124,111,49,62,3,1,0,1,9,9,0,0,0,0
"2011","E00003316","E00003316","Total",190,143,52,91,1,4,0,4,40,37,0,2,1,2
"2011","E00003318","E00003318","Total",131,100,33,67,0,24,1,23,7,6,0,1,0,0
"2011","E00003320","E00003320","Total",134,103,50,53,0,22,4,18,7,7,0,0,0,2
"2011","E00003321","E00003321","Total",126,106,49,57,1,2,0,2,17,15,0,1,1,0
"2011","E00003294","E00003294","Total",119,107,55,52,0,4,2,2,7,7,0,0,0,1
"2011","E00003296","E00003296","Total",122,119,73,46,0,0,0,0,3,3,0,0,0,0
"2011","E00003297","E00003297","Total",126,105,40,65,1,3,1,2,17,17,0,0,0,0
"2011","E00003326","E00003326","Total",128,124,56,68,0,0,0,0,3,3,0,0,0,1
"2011","E00166110","E00166110","Total",134,122,46,76,1,0,0,0,9,7,0,2,0,2
"2011","E00166623","E00166623","Total",128,111,30,81,0,2,1,1,13,12,0,1,0,2
"2011","E00003840","E00003840","Total",122,116,61,55,0,3,0,3,3,3,0,0,0,0
"2011","E00003879","E00003879","Total",126,116,72,44,1,1,0,1,7,6,1,0,0,1
"2011","E00003880","E00003880","Total",107,106,69,37,0,0,0,0,1,1,0,0,0,0
"2011","E00003883","E00003883","Total",122,116,64,52,0,4,0,4,1,0,0,1,0,1
"2011","E00003884","E00003884","Total",134,123,81,42,0,1,0,1,8,6,0,2,0,2
"2011","E00003645","E00003645","Total",136,121,74,47,0,7,1,6,6,5,1,0,0,2
"2011","E00003647","E00003647","Total",102,64,29,35,0,31,3,28,6,4,0,2,0,1
"2011","E00003648","E00003648","Total",126,114,71,43,0,5,0,5,7,6,1,0,0,0
"2011","E00003657","E00003657","Total",142,126,63,63,0,2,0,2,12,12,0,0,0,2
"2011","E00003658","E00003658","Total",133,125,65,60,0,2,0,2,5,3,0,2,0,1
"2011","E00003660","E00003660","Total",125,3,1,2,0,118,1,117,2,1,0,0,1,2
"2011","E00003661","E00003661","Total",149,11,5,6,0,132,3,129,6,6,0,0,0,0
"2011","E00003674","E00003674","Total",125,44,16,28,1,75,2,73,4,4,0,0,0,1
"2011","E00003677","E00003677","Total",140,130,77,53,1,1,0,1,6,6,0,0,0,2
"2011","E00003681","E00003681","Total",126,90,41,49,0,32,3,29,3,3,0,0,0,1
"2011","E00003659","E00003659","Total",144,134,65,69,0,3,0,3,7,6,1,0,0,0
"2011","E00003670","E00003670","Total",218,154,79,75,0,28,3,25,34,30,0,2,2,2
"2011","E00003675","E00003675","Total",172,142,93,49,3,15,0,15,10,8,2,0,0,2
"2011","E00003676","E00003676","Total",134,110,45,65,2,0,0,0,21,18,1,2,0,1
"2011","E00003679","E00003679","Total",139,125,56,69,0,5,0,5,8,8,0,0,0,1
"2011","E00003662","E00003662","Total",128,110,71,39,0,2,0,2,15,14,0,1,0,1
"2011","E00003678","E00003678","Total",129,91,56,35,0,30,1,29,8,7,0,1,0,0
"2011","E00003680","E00003680","Total",123,113,71,42,0,8,0,8,2,1,0,1,0,0
"2011","E00003682","E00003682","Total",118,97,69,28,1,12,0,12,5,5,0,0,0,3
"2011","E00003683","E00003683","Total",133,128,87,41,0,1,0,1,4,3,0,1,0,0
"2011","E00003684","E00003684","Total",147,108,58,50,0,4,0,4,33,27,0,3,3,2
"2011","E00003291","E00003291","Total",129,98,43,55,1,4,0,4,26,21,0,2,3,0
"2011","E00003302","E00003302","Total",118,113,71,42,0,1,0,1,4,4,0,0,0,0
"2011","E00003308","E00003308","Total",140,118,65,53,0,8,0,8,11,8,0,2,1,3
"2011","E00003309","E00003309","Total",126,120,71,49,0,1,0,1,4,3,0,1,0,1
"2011","E00003310","E00003310","Total",133,117,64,53,1,2,1,1,10,8,0,1,1,3
"2011","E00003293","E00003293","Total",123,88,33,55,1,26,2,24,7,6,0,0,1,1
"2011","E00003295","E00003295","Total",124,94,33,61,1,21,4,17,8,7,0,1,0,0
"2011","E00003299","E00003299","Total",103,74,34,40,0,4,0,4,24,23,0,1,0,1
"2011","E00003300","E00003300","Total",127,93,39,54,2,27,4,23,5,2,1,2,0,0
"2011","E00003324","E00003324","Total",141,130,69,61,1,5,1,4,5,5,0,0,0,0
"2011","E00003285","E00003285","Total",121,96,52,44,0,3,0,3,22,19,0,3,0,0
"2011","E00003289","E00003289","Total",121,114,54,60,0,1,0,1,6,6,0,0,0,0
"2011","E00003290","E00003290","Total",140,137,73,64,0,1,0,1,2,2,0,0,0,0
"2011","E00003292","E00003292","Total",129,33,14,19,15,71,10,61,4,3,0,1,0,6
"2011","E00003298","E00003298","Total",137,133,73,60,2,2,1,1,0,0,0,0,0,0
"2011","E00003286","E00003286","Total",129,118,67,51,0,0,0,0,11,9,0,2,0,0
"2011","E00003304","E00003304","Total",124,108,72,36,0,1,0,1,14,12,0,2,0,1
"2011","E00003305","E00003305","Total",139,116,63,53,2,8,1,7,13,12,0,1,0,0
"2011","E00003306","E00003306","Total",141,117,60,57,0,4,1,3,19,19,0,0,0,1
"2011","E00003307","E00003307","Total",123,117,51,66,0,0,0,0,5,5,0,0,0,1
"2011","E00003287","E00003287","Total",134,128,66,62,0,1,0,1,4,3,0,0,1,1
"2011","E00003288","E00003288","Total",132,123,68,55,0,5,0,5,3,3,0,0,0,1
"2011","E00003301","E00003301","Total",116,108,50,58,0,1,1,0,6,4,2,0,0,1
"2011","E00003303","E00003303","Total",122,104,49,55,0,6,0,6,10,10,0,0,0,2
"2011","E00003174","E00003174","Total",123,121,59,62,0,0,0,0,1,1,0,0,0,1
"2011","E00003176","E00003176","Total",131,117,34,83,1,2,0,2,10,9,0,1,0,1
"2011","E00003177","E00003177","Total",113,103,37,66,2,2,0,2,6,6,0,0,0,0
"2011","E00003178","E00003178","Total",119,108,35,73,1,1,0,1,9,8,1,0,0,0
"2011","E00003172","E00003172","Total",131,113,43,70,1,11,0,11,6,6,0,0,0,0
"2011","E00003173","E00003173","Total",124,112,40,72,1,2,0,2,6,6,0,0,0,3
"2011","E00003179","E00003179","Total",118,107,36,71,0,3,0,3,7,7,0,0,0,1
"2011","E00003180","E00003180","Total",121,106,45,61,2,2,0,2,10,9,0,1,0,1
"2011","E00003160","E00003160","Total",120,116,66,50,0,0,0,0,2,2,0,0,0,2
"2011","E00003163","E00003163","Total",127,121,41,80,0,2,1,1,4,4,0,0,0,0
"2011","E00003181","E00003181","Total",144,134,60,74,0,4,2,2,5,5,0,0,0,1
"2011","E00003182","E00003182","Total",126,118,39,79,2,0,0,0,5,5,0,0,0,1
"2011","E00003155","E00003155","Total",142,113,46,67,0,18,2,16,11,10,0,1,0,0
"2011","E00003156","E00003156","Total",122,111,46,65,2,2,0,2,6,5,0,1,0,1
"2011","E00003157","E00003157","Total",147,132,55,77,1,7,1,6,5,5,0,0,0,2
"2011","E00003161","E00003161","Total",142,101,49,52,2,14,0,14,22,19,0,3,0,3
"2011","E00003162","E00003162","Total",121,43,13,30,12,52,5,47,13,13,0,0,0,1
"2011","E00003165","E00003165","Total",129,125,48,77,0,0,0,0,4,4,0,0,0,0
"2011","E00003166","E00003166","Total",147,134,42,92,0,2,0,2,11,10,1,0,0,0
"2011","E00003167","E00003167","Total",129,120,52,68,0,3,0,3,5,2,0,2,1,1
"2011","E00003171","E00003171","Total",115,109,32,77,0,3,1,2,3,3,0,0,0,0
"2011","E00004003","E00004003","Total",144,115,50,65,1,20,0,20,7,7,0,0,0,1
"2011","E00004007","E00004007","Total",120,102,46,56,1,4,0,4,12,9,0,3,0,1
"2011","E00004009","E00004009","Total",114,102,58,44,1,3,0,3,8,7,0,1,0,0
"2011","E00004010","E00004010","Total",107,79,32,47,0,15,3,12,13,12,0,0,1,0
"2011","E00004018","E00004018","Total",107,98,40,58,1,2,0,2,6,5,0,1,0,0
"2011","E00004006","E00004006","Total",110,98,45,53,1,4,0,4,7,6,0,1,0,0
"2011","E00004008","E00004008","Total",103,95,54,41,0,1,0,1,7,6,0,1,0,0
"2011","E00004011","E00004011","Total",117,110,51,59,0,1,0,1,6,4,1,1,0,0
"2011","E00004013","E00004013","Total",115,106,40,66,0,5,0,5,4,3,0,0,1,0
"2011","E00004014","E00004014","Total",123,94,53,41,0,22,3,19,4,4,0,0,0,3
"2011","E00003991","E00003991","Total",146,42,15,27,1,92,4,88,8,8,0,0,0,3
"2011","E00003993","E00003993","Total",90,65,18,47,0,11,1,10,13,12,0,1,0,1
"2011","E00004015","E00004015","Total",85,6,2,4,1,77,3,74,1,1,0,0,0,0
"2011","E00004017","E00004017","Total",189,106,41,65,18,36,1,35,27,24,0,3,0,2
"2011","E00004020","E00004020","Total",117,52,23,29,0,54,10,44,9,9,0,0,0,2
"2011","E00004022","E00004022","Total",113,84,37,47,0,7,1,6,21,17,0,3,1,1
"2011","E00003992","E00003992","Total",132,54,23,31,0,67,9,58,9,9,0,0,0,2
"2011","E00004004","E00004004","Total",118,52,23,29,0,55,8,47,8,7,0,1,0,3
"2011","E00004012","E00004012","Total",130,65,29,36,1,59,10,49,4,2,1,1,0,1
"2011","E00004016","E00004016","Total",110,44,20,24,0,55,10,45,10,8,0,2,0,1
"2011","E00165787","E00165787","Total",133,86,39,47,0,31,5,26,16,12,0,4,0,0
"2011","E00003994","E00003994","Total",148,132,91,41,0,6,0,6,8,6,0,1,1,2
"2011","E00003995","E00003995","Total",125,111,66,45,0,2,0,2,12,11,0,1,0,0
"2011","E00004023","E00004023","Total",104,94,48,46,1,1,0,1,8,8,0,0,0,0
"2011","E00004024","E00004024","Total",106,90,44,46,0,0,0,0,16,15,0,0,1,0
"2011","E00165788","E00165788","Total",85,75,39,36,1,3,1,2,3,3,0,0,0,3
"2011","E00003390","E00003390","Total",133,120,30,90,0,2,0,2,11,9,1,1,0,0
"2011","E00003396","E00003396","Total",133,125,43,82,0,2,0,2,6,5,0,1,0,0
"2011","E00003403","E00003403","Total",143,113,40,73,1,4,0,4,25,25,0,0,0,0
"2011","E00003405","E00003405","Total",127,119,44,75,1,1,0,1,6,5,0,1,0,0
"2011","E00003377","E00003377","Total",144,81,25,56,5,32,0,32,23,19,0,4,0,3
"2011","E00003407","E00003407","Total",134,103,32,71,1,2,0,2,27,25,0,2,0,1
"2011","E00003409","E00003409","Total",140,107,66,41,3,9,0,9,20,19,0,1,0,1
"2011","E00003411","E00003411","Total",114,106,45,61,0,1,0,1,4,4,0,0,0,3
"2011","E00003412","E00003412","Total",118,106,42,64,0,2,1,1,10,9,0,1,0,0
"2011","E00003768","E00003768","Total",123,118,70,48,0,0,0,0,3,3,0,0,0,2
"2011","E00003769","E00003769","Total",112,90,37,53,0,3,1,2,18,17,0,1,0,1
"2011","E00003773","E00003773","Total",135,111,52,59,0,2,0,2,20,19,0,1,0,2
"2011","E00003776","E00003776","Total",128,119,59,60,1,4,0,4,2,2,0,0,0,2
"2011","E00003779","E00003779","Total",122,113,51,62,0,3,1,2,4,4,0,0,0,2
"2011","E00003780","E00003780","Total",103,96,51,45,0,2,0,2,3,3,0,0,0,2
"2011","E00003782","E00003782","Total",118,75,24,51,1,5,1,4,33,33,0,0,0,4
"2011","E00003785","E00003785","Total",116,100,44,56,1,9,1,8,5,5,0,0,0,1
"2011","E00003786","E00003786","Total",130,117,53,64,1,2,1,1,9,9,0,0,0,1
"2011","E00003793","E00003793","Total",114,97,44,53,1,3,0,3,12,11,0,1,0,1
"2011","E00003784","E00003784","Total",162,101,38,63,7,41,7,34,13,12,0,1,0,0
"2011","E00003787","E00003787","Total",147,90,30,60,0,14,3,11,43,41,0,2,0,0
"2011","E00003789","E00003789","Total",113,73,26,47,2,21,2,19,15,13,0,2,0,2
"2011","E00003798","E00003798","Total",129,79,36,43,0,47,5,42,1,1,0,0,0,2
"2011","E00165793","E00165793","Total",96,18,9,9,0,70,1,69,8,8,0,0,0,0
"2011","E00003164","E00003164","Total",136,122,73,49,0,10,2,8,4,3,0,1,0,0
"2011","E00003169","E00003169","Total",136,129,89,40,0,1,1,0,4,2,0,2,0,2
"2011","E00003183","E00003183","Total",140,129,75,54,1,2,0,2,7,7,0,0,0,1
"2011","E00003184","E00003184","Total",138,128,76,52,1,0,0,0,7,6,0,1,0,2
"2011","E00003646","E00003646","Total",150,114,66,48,1,12,3,9,21,20,1,0,0,2
"2011","E00003649","E00003649","Total",125,106,54,52,0,5,0,5,14,14,0,0,0,0
"2011","E00003650","E00003650","Total",135,104,54,50,0,9,0,9,21,14,3,1,3,1
"2011","E00003653","E00003653","Total",127,117,89,28,3,1,0,1,5,4,0,0,1,1
"2011","E00166118","E00166118","Total",118,67,13,54,10,23,0,23,17,15,1,1,0,1
"2011","E00166613","E00166613","Total",118,72,18,54,0,5,0,5,40,9,25,0,6,1
"2011","E00003644","E00003644","Total",120,109,66,43,1,3,0,3,5,5,0,0,0,2
"2011","E00003651","E00003651","Total",154,136,75,61,0,2,0,2,11,9,1,0,1,5
"2011","E00003654","E00003654","Total",132,111,64,47,2,3,0,3,8,7,1,0,0,8
"2011","E00003655","E00003655","Total",135,119,73,46,0,2,1,1,12,11,0,1,0,2
"2011","E00003656","E00003656","Total",129,121,83,38,0,2,0,2,5,4,1,0,0,1
"2011","E00003158","E00003158","Total",167,123,61,62,0,28,1,27,13,12,1,0,0,3
"2011","E00003159","E00003159","Total",122,114,34,80,0,3,0,3,4,4,0,0,0,1
"2011","E00003168","E00003168","Total",125,113,76,37,0,1,0,1,7,5,1,1,0,4
"2011","E00003170","E00003170","Total",131,99,64,35,5,4,0,4,22,19,0,3,0,1
"2011","E00165795","E00165795","Total",124,117,61,56,0,1,0,1,5,4,1,0,0,1
"2011","E00005656","E00005656","Total",141,87,56,31,6,1,1,0,46,43,0,2,1,1
"2011","E00005682","E00005682","Total",115,80,46,34,0,0,0,0,34,31,1,2,0,1
"2011","E00005683","E00005683","Total",124,67,28,39,2,19,18,1,32,29,0,2,1,4
"2011","E00005685","E00005685","Total",144,90,38,52,0,6,1,5,46,44,0,1,1,2
"2011","E00005686","E00005686","Total",108,47,28,19,0,45,43,2,14,13,0,1,0,2
"2011","E00005687","E00005687","Total",155,85,30,55,4,11,2,9,48,45,0,3,0,7
"2011","E00005689","E00005689","Total",88,22,3,19,0,62,59,3,4,3,0,1,0,0
"2011","E00005657","E00005657","Total",127,96,48,48,1,4,1,3,25,24,1,0,0,1
"2011","E00005658","E00005658","Total",175,85,16,69,3,32,3,29,53,47,0,3,3,2
"2011","E00005684","E00005684","Total",97,70,32,38,1,8,1,7,17,16,0,1,0,1
"2011","E00005688","E00005688","Total",122,55,23,32,15,15,3,12,36,34,1,1,0,1
"2011","E00005690","E00005690","Total",124,46,11,35,0,54,53,1,22,22,0,0,0,2
"2011","E00005691","E00005691","Total",129,63,30,33,1,32,2,30,33,32,0,1,0,0
"2011","E00005772","E00005772","Total",153,47,14,33,1,87,83,4,18,17,0,0,1,0
"2011","E00005778","E00005778","Total",131,97,33,64,1,5,0,5,27,26,0,1,0,1
"2011","E00005781","E00005781","Total",146,90,33,57,1,25,13,12,30,27,0,2,1,0
"2011","E00005784","E00005784","Total",136,51,21,30,1,55,2,53,23,23,0,0,0,6
"2011","E00005788","E00005788","Total",155,56,26,30,0,76,38,38,23,21,0,1,1,0
"2011","E00005767","E00005767","Total",128,46,19,27,0,50,36,14,32,32,0,0,0,0
"2011","E00005768","E00005768","Total",123,49,8,41,2,54,52,2,17,16,0,0,1,1
"2011","E00005771","E00005771","Total",162,48,16,32,7,60,5,55,47,44,0,3,0,0
"2011","E00005807","E00005807","Total",115,98,44,54,0,11,10,1,5,4,0,1,0,1
"2011","E00005809","E00005809","Total",120,51,18,33,2,57,53,4,10,9,1,0,0,0
"2011","E00005810","E00005810","Total",119,45,9,36,3,28,5,23,43,41,0,2,0,0
"2011","E00005769","E00005769","Total",124,48,14,34,1,42,8,34,32,29,0,1,2,1
"2011","E00005770","E00005770","Total",181,67,13,54,0,46,35,11,67,62,0,2,3,1
"2011","E00005774","E00005774","Total",211,59,13,46,0,52,3,49,98,93,0,4,1,2
"2011","E00005775","E00005775","Total",155,53,20,33,0,5,4,1,96,91,4,1,0,1
"2011","E00005776","E00005776","Total",136,79,20,59,0,23,3,20,33,31,0,2,0,1
"2011","E00005808","E00005808","Total",155,63,21,42,0,37,16,21,54,52,0,2,0,1
"2011","E00005419","E00005419","Total",154,103,48,55,1,17,4,13,31,31,0,0,0,2
"2011","E00005420","E00005420","Total",112,71,38,33,0,1,1,0,32,29,1,2,0,8
"2011","E00005421","E00005421","Total",108,95,55,40,0,1,0,1,10,10,0,0,0,2
"2011","E00005422","E00005422","Total",136,114,57,57,2,4,0,4,15,15,0,0,0,1
"2011","E00005424","E00005424","Total",155,141,80,61,0,1,0,1,13,11,1,1,0,0
"2011","E00005765","E00005765","Total",180,118,43,75,0,19,12,7,42,41,1,0,0,1
"2011","E00005780","E00005780","Total",109,50,18,32,0,46,41,5,13,11,0,0,2,0
"2011","E00005782","E00005782","Total",117,107,43,64,0,0,0,0,10,9,0,1,0,0
"2011","E00005785","E00005785","Total",119,93,28,65,0,10,8,2,14,13,1,0,0,2
"2011","E00005790","E00005790","Total",90,73,34,39,0,5,5,0,10,9,0,0,1,2
"2011","E00005773","E00005773","Total",142,113,58,55,2,0,0,0,25,23,0,1,1,2
"2011","E00005779","E00005779","Total",124,51,23,28,1,5,0,5,67,64,0,2,1,0
"2011","E00005783","E00005783","Total",134,77,40,37,0,35,2,33,20,17,0,2,1,2
"2011","E00005786","E00005786","Total",101,88,45,43,0,1,1,0,12,10,0,1,1,0
"2011","E00005806","E00005806","Total",116,90,46,44,2,1,1,0,23,22,1,0,0,0
"2011","E00005811","E00005811","Total",124,76,28,48,0,25,25,0,23,19,0,4,0,0
"2011","E00005764","E00005764","Total",138,106,44,62,0,5,0,5,23,21,0,2,0,4
"2011","E00005789","E00005789","Total",124,110,56,54,0,0,0,0,11,8,0,2,1,3
"2011","E00005791","E00005791","Total",123,110,59,51,0,1,1,0,10,8,0,1,1,2
"2011","E00005792","E00005792","Total",136,85,36,49,7,7,0,7,34,34,0,0,0,3
"2011","E00005798","E00005798","Total",106,79,34,45,0,7,3,4,18,17,0,1,0,2
"2011","E00005777","E00005777","Total",195,113,43,70,18,19,2,17,44,42,0,2,0,1
"2011","E00005802","E00005802","Total",120,95,49,46,2,5,3,2,17,14,0,3,0,1
"2011","E00005803","E00005803","Total",183,106,26,80,10,15,5,10,52,50,0,2,0,0
"2011","E00005804","E00005804","Total",123,77,31,46,2,31,31,0,9,8,0,1,0,4
"2011","E00005805","E00005805","Total",177,127,40,87,4,3,1,2,41,36,0,5,0,2
"2011","E00005396","E00005396","Total",121,107,57,50,1,0,0,0,13,12,0,1,0,0
"2011","E00005397","E00005397","Total",144,115,57,58,0,5,3,2,21,19,0,2,0,3
"2011","E00005423","E00005423","Total",135,122,60,62,0,3,1,2,10,10,0,0,0,0
"2011","E00005425","E00005425","Total",136,121,63,58,0,2,1,1,13,12,0,1,0,0
"2011","E00005399","E00005399","Total",110,88,39,49,0,2,1,1,17,15,0,1,1,3
"2011","E00005407","E00005407","Total",125,98,30,68,1,8,5,3,18,18,0,0,0,0
"2011","E00005410","E00005410","Total",120,96,38,58,0,5,3,2,18,18,0,0,0,1
"2011","E00005412","E00005412","Total",126,99,41,58,0,6,5,1,21,21,0,0,0,0
"2011","E00005415","E00005415","Total",122,90,44,46,0,7,7,0,24,24,0,0,0,1
"2011","E00005405","E00005405","Total",165,108,47,61,1,17,3,14,36,34,0,2,0,3
"2011","E00005426","E00005426","Total",102,24,15,9,0,66,62,4,9,9,0,0,0,3
"2011","E00005430","E00005430","Total",145,63,25,38,1,30,15,15,48,48,0,0,0,3
"2011","E00005433","E00005433","Total",176,72,30,42,0,23,5,18,77,70,1,5,1,4
"2011","E00174927","E00174927","Total",145,13,1,12,31,0,0,0,98,91,2,4,1,3
"2011","E00174928","E00174928","Total",115,58,30,28,4,8,2,6,45,43,0,2,0,0
"2011","E00005766","E00005766","Total",107,45,13,32,1,50,45,5,10,9,0,1,0,1
"2011","E00005793","E00005793","Total",123,49,11,38,1,52,44,8,21,19,0,2,0,0
"2011","E00005797","E00005797","Total",97,21,12,9,2,67,22,45,6,6,0,0,0,1
"2011","E00005800","E00005800","Total",115,54,19,35,0,38,24,14,22,19,0,3,0,1
"2011","E00005801","E00005801","Total",124,53,23,30,1,57,49,8,13,11,0,2,0,0
"2011","E00005427","E00005427","Total",119,89,50,39,1,0,0,0,28,28,0,0,0,1
"2011","E00005428","E00005428","Total",163,53,23,30,2,41,9,32,62,61,0,0,1,5
"2011","E00005429","E00005429","Total",116,43,22,21,0,46,2,44,25,23,0,1,1,2
"2011","E00005431","E00005431","Total",112,93,49,44,0,0,0,0,19,18,0,1,0,0
"2011","E00005432","E00005432","Total",102,72,30,42,1,4,2,2,25,24,0,1,0,0
"2011","E00005400","E00005400","Total",118,88,38,50,2,18,15,3,10,10,0,0,0,0
"2011","E00005406","E00005406","Total",136,58,22,36,0,65,62,3,13,11,0,1,1,0
"2011","E00005408","E00005408","Total",110,72,21,51,0,19,18,1,19,19,0,0,0,0
"2011","E00005411","E00005411","Total",124,90,28,62,2,4,2,2,27,26,0,1,0,1
"2011","E00005438","E00005438","Total",104,78,35,43,0,3,2,1,22,22,0,0,0,1
"2011","E00005402","E00005402","Total",135,56,22,34,0,51,51,0,26,24,0,0,2,2
"2011","E00005404","E00005404","Total",166,52,14,38,0,82,78,4,30,29,0,1,0,2
"2011","E00005435","E00005435","Total",170,60,22,38,1,3,1,2,100,96,0,4,0,6
"2011","E00005436","E00005436","Total",110,50,20,30,0,49,49,0,9,9,0,0,0,2
"2011","E00005437","E00005437","Total",134,90,41,49,0,3,3,0,41,39,0,2,0,0
"2011","E00005398","E00005398","Total",150,75,27,48,1,38,28,10,35,32,0,3,0,1
"2011","E00005401","E00005401","Total",141,40,15,25,0,78,71,7,23,22,0,1,0,0
"2011","E00005409","E00005409","Total",151,76,35,41,0,34,0,34,37,35,0,2,0,4
"2011","E00005439","E00005439","Total",134,71,27,44,1,31,29,2,31,29,0,2,0,0
"2011","E00174926","E00174926","Total",119,32,20,12,2,39,5,34,43,41,1,1,0,3
"2011","E00174929","E00174929","Total",98,25,7,18,29,4,1,3,40,36,0,4,0,0
"2011","E00174930","E00174930","Total",129,43,8,35,5,7,6,1,74,71,0,2,1,0
"2011","E00005413","E00005413","Total",111,90,43,47,0,1,1,0,20,19,0,1,0,0
"2011","E00005414","E00005414","Total",107,88,44,44,0,4,2,2,14,14,0,0,0,1
"2011","E00005416","E00005416","Total",110,44,15,29,0,3,1,2,59,56,0,2,1,4
"2011","E00005417","E00005417","Total",120,104,59,45,0,0,0,0,12,12,0,0,0,4
"2011","E00005418","E00005418","Total",114,91,30,61,1,4,4,0,15,13,0,2,0,3
"2011","E00005722","E00005722","Total",142,98,31,67,0,6,1,5,38,36,0,2,0,0
"2011","E00005755","E00005755","Total",96,44,11,33,0,23,17,6,28,26,0,0,2,1
"2011","E00005756","E00005756","Total",110,41,15,26,1,36,8,28,30,28,0,2,0,2
"2011","E00005758","E00005758","Total",125,41,12,29,1,66,60,6,15,13,0,1,1,2
"2011","E00005760","E00005760","Total",147,58,24,34,0,39,8,31,47,44,0,3,0,3
"2011","E00005718","E00005718","Total",119,76,16,60,0,8,3,5,32,29,0,2,1,3
"2011","E00005719","E00005719","Total",175,127,47,80,2,17,2,15,28,24,0,3,1,1
"2011","E00005721","E00005721","Total",141,98,35,63,2,14,2,12,25,23,0,2,0,2
"2011","E00005723","E00005723","Total",130,85,29,56,2,12,9,3,31,29,0,2,0,0
"2011","E00005754","E00005754","Total",108,38,10,28,7,30,25,5,33,33,0,0,0,0
"2011","E00005713","E00005713","Total",157,44,17,27,0,73,7,66,38,37,0,0,1,2
"2011","E00005727","E00005727","Total",136,50,13,37,1,57,48,9,25,24,0,0,1,3
"2011","E00005730","E00005730","Total",108,66,18,48,0,28,23,5,14,12,0,1,1,0
"2011","E00005732","E00005732","Total",146,59,23,36,0,41,12,29,43,43,0,0,0,3
"2011","E00005737","E00005737","Total",124,57,22,35,0,35,5,30,30,29,0,1,0,2
"2011","E00005714","E00005714","Total",156,53,18,35,0,43,28,15,57,54,2,1,0,3
"2011","E00005728","E00005728","Total",120,60,16,44,0,11,4,7,47,40,0,6,1,2
"2011","E00005729","E00005729","Total",142,59,24,35,1,23,1,22,58,55,1,1,1,1
"2011","E00005738","E00005738","Total",131,69,26,43,1,13,1,12,47,43,0,3,1,1
"2011","E00005739","E00005739","Total",125,53,23,30,0,21,4,17,48,42,0,5,1,3
"2011","E00005787","E00005787","Total",142,67,23,44,0,58,32,26,17,16,0,1,0,0
"2011","E00005794","E00005794","Total",133,93,36,57,0,15,5,10,23,21,0,2,0,2
"2011","E00005795","E00005795","Total",137,62,15,47,14,8,5,3,50,48,1,0,1,3
"2011","E00005796","E00005796","Total",144,68,14,54,0,18,0,18,56,53,0,2,1,2
"2011","E00005799","E00005799","Total",144,85,24,61,1,23,10,13,32,25,0,6,1,3
"2011","E00005724","E00005724","Total",143,99,38,61,0,7,0,7,35,33,0,2,0,2
"2011","E00005731","E00005731","Total",116,84,15,69,0,10,3,7,20,19,0,1,0,2
"2011","E00005751","E00005751","Total",123,84,19,65,0,12,5,7,25,22,0,3,0,2
"2011","E00005752","E00005752","Total",118,67,25,42,0,25,17,8,26,24,0,1,1,0
"2011","E00005762","E00005762","Total",107,77,36,41,0,9,3,6,18,15,0,3,0,3
"2011","E00005720","E00005720","Total",139,121,53,68,0,1,1,0,14,11,0,3,0,3
"2011","E00005725","E00005725","Total",167,101,22,79,3,18,7,11,42,41,0,1,0,3
"2011","E00005753","E00005753","Total",109,65,15,50,1,16,1,15,25,19,0,5,1,2
"2011","E00005757","E00005757","Total",112,73,24,49,0,6,2,4,31,30,0,1,0,2
"2011","E00005763","E00005763","Total",92,67,15,52,0,8,1,7,17,17,0,0,0,0
"2011","E00005733","E00005733","Total",94,75,20,55,2,2,1,1,14,14,0,0,0,1
"2011","E00005736","E00005736","Total",146,57,18,39,2,21,2,19,64,60,1,2,1,2
"2011","E00005740","E00005740","Total",162,128,38,90,4,3,0,3,27,23,0,4,0,0
"2011","E00005759","E00005759","Total",119,106,39,67,0,4,0,4,9,6,1,0,2,0
"2011","E00005761","E00005761","Total",99,87,27,60,0,2,0,2,9,7,0,2,0,1
"2011","E00005726","E00005726","Total",125,96,42,54,1,7,1,6,18,13,1,4,0,3
"2011","E00005734","E00005734","Total",111,61,22,39,0,15,3,12,34,32,0,2,0,1
"2011","E00005735","E00005735","Total",101,80,27,53,0,4,2,2,17,17,0,0,0,0
"2011","E00005741","E00005741","Total",128,71,24,47,1,26,13,13,29,26,0,3,0,1
"2011","E00005742","E00005742","Total",126,86,26,60,0,18,5,13,19,18,0,1,0,3
"2011","E00005715","E00005715","Total",154,59,19,40,1,46,4,42,47,46,0,0,1,1
"2011","E00005743","E00005743","Total",153,96,36,60,0,23,3,20,28,27,0,1,0,6
"2011","E00005745","E00005745","Total",121,69,28,41,1,18,9,9,33,33,0,0,0,0
"2011","E00005747","E00005747","Total",149,88,24,64,1,24,4,20,35,33,0,1,1,1
"2011","E00005749","E00005749","Total",158,59,19,40,1,26,3,23,64,60,1,2,1,8
"2011","E00005670","E00005670","Total",117,53,13,40,2,12,2,10,43,42,0,1,0,7
"2011","E00005671","E00005671","Total",139,52,11,41,0,14,0,14,72,72,0,0,0,1
"2011","E00005677","E00005677","Total",223,63,19,44,1,43,23,20,112,108,1,1,2,4
"2011","E00005678","E00005678","Total",125,57,16,41,1,9,2,7,56,51,1,1,3,2
"2011","E00005680","E00005680","Total",174,50,22,28,0,18,2,16,103,103,0,0,0,3
"2011","E00005681","E00005681","Total",149,47,12,35,8,29,1,28,63,61,0,1,1,2
"2011","E00005669","E00005669","Total",120,72,27,45,2,19,6,13,27,26,0,1,0,0
"2011","E00005699","E00005699","Total",106,70,21,49,1,3,0,3,32,31,0,1,0,0
"2011","E00005701","E00005701","Total",110,68,23,45,1,1,0,1,40,38,0,2,0,0
"2011","E00005708","E00005708","Total",116,98,35,63,1,4,0,4,13,12,1,0,0,0
"2011","E00005709","E00005709","Total",120,75,29,46,1,2,0,2,41,40,0,1,0,1
"2011","E00005710","E00005710","Total",122,89,34,55,0,3,0,3,30,28,0,2,0,0
"2011","E00005659","E00005659","Total",153,81,18,63,0,24,1,23,47,45,0,2,0,1
"2011","E00005692","E00005692","Total",121,91,29,62,0,2,0,2,27,23,0,3,1,1
"2011","E00005693","E00005693","Total",128,96,31,65,1,8,1,7,22,20,0,2,0,1
"2011","E00005694","E00005694","Total",114,73,22,51,0,2,0,2,39,36,0,3,0,0
"2011","E00005695","E00005695","Total",117,77,33,44,0,17,2,15,22,22,0,0,0,1
"2011","E00005696","E00005696","Total",140,77,23,54,0,20,18,2,42,41,0,0,1,1
"2011","E00005664","E00005664","Total",132,60,20,40,1,22,4,18,46,44,1,0,1,3
"2011","E00005700","E00005700","Total",113,85,27,58,0,0,0,0,25,25,0,0,0,3
"2011","E00005703","E00005703","Total",121,110,47,63,0,2,2,0,7,6,0,1,0,2
"2011","E00005704","E00005704","Total",126,110,42,68,1,2,1,1,9,8,0,1,0,4
"2011","E00005707","E00005707","Total",128,67,32,35,2,29,0,29,26,25,0,1,0,4
"2011","E00005655","E00005655","Total",145,66,24,42,1,30,2,28,47,45,0,1,1,1
"2011","E00005665","E00005665","Total",134,62,16,46,2,12,0,12,55,51,0,4,0,3
"2011","E00005673","E00005673","Total",154,65,21,44,0,57,45,12,32,30,0,2,0,0
"2011","E00005675","E00005675","Total",191,54,15,39,1,62,20,42,74,70,0,2,2,0
"2011","E00005676","E00005676","Total",173,68,4,64,1,27,9,18,76,73,0,1,2,1
"2011","E00005660","E00005660","Total",108,45,15,30,0,49,16,33,12,12,0,0,0,2
"2011","E00005661","E00005661","Total",126,61,16,45,12,27,23,4,26,23,0,2,1,0
"2011","E00005697","E00005697","Total",97,41,9,32,5,20,12,8,31,29,0,2,0,0
"2011","E00005698","E00005698","Total",106,25,7,18,0,50,2,48,31,30,0,1,0,0
"2011","E00005702","E00005702","Total",131,37,11,26,0,37,10,27,55,54,0,0,1,2
"2011","E00005667","E00005667","Total",148,43,14,29,0,90,27,63,12,11,0,0,1,3
"2011","E00005668","E00005668","Total",113,56,17,39,0,19,2,17,37,34,0,2,1,1
"2011","E00005705","E00005705","Total",127,41,4,37,0,67,64,3,13,11,0,2,0,6
"2011","E00005706","E00005706","Total",225,70,19,51,1,58,10,48,95,95,0,0,0,1
"2011","E00005711","E00005711","Total",116,75,24,51,0,15,10,5,23,23,0,0,0,3
"2011","E00005712","E00005712","Total",119,90,26,64,1,10,2,8,17,17,0,0,0,1
"2011","E00005662","E00005662","Total",141,53,30,23,1,63,42,21,21,19,0,2,0,3
"2011","E00005663","E00005663","Total",134,15,3,12,0,107,101,6,11,11,0,0,0,1
"2011","E00005666","E00005666","Total",221,21,5,16,0,133,90,43,61,52,0,2,7,6
"2011","E00005672","E00005672","Total",110,42,14,28,0,26,4,22,41,39,0,1,1,1
"2011","E00005674","E00005674","Total",139,36,7,29,0,39,7,32,63,60,0,3,0,1
"2011","E00005679","E00005679","Total",103,25,8,17,0,29,20,9,47,44,0,2,1,2
"2011","E00005913","E00005913","Total",147,75,18,57,1,12,3,9,57,55,0,2,0,2
"2011","E00005942","E00005942","Total",191,38,14,24,2,47,6,41,102,101,0,0,1,2
"2011","E00005944","E00005944","Total",130,51,10,41,0,23,1,22,55,53,1,1,0,1
"2011","E00005945","E00005945","Total",101,42,17,25,1,10,0,10,46,44,0,2,0,2
"2011","E00005946","E00005946","Total",134,47,12,35,1,11,4,7,75,73,1,1,0,0
"2011","E00005947","E00005947","Total",120,73,29,44,0,8,2,6,36,34,0,2,0,3
"2011","E00005912","E00005912","Total",211,59,12,47,0,62,20,42,87,87,0,0,0,3
"2011","E00005940","E00005940","Total",130,53,16,37,0,55,10,45,21,21,0,0,0,1
"2011","E00005941","E00005941","Total",147,76,29,47,1,37,25,12,32,32,0,0,0,1
"2011","E00005943","E00005943","Total",130,83,23,60,0,14,4,10,31,31,0,0,0,2
"2011","E00005949","E00005949","Total",109,64,17,47,0,6,2,4,37,37,0,0,0,2
"2011","E00004962","E00004962","Total",94,71,26,45,1,2,0,2,19,17,0,2,0,1
"2011","E00004963","E00004963","Total",104,72,31,41,0,3,1,2,26,23,0,3,0,3
"2011","E00004975","E00004975","Total",116,66,25,41,0,8,4,4,36,36,0,0,0,6
"2011","E00004976","E00004976","Total",109,95,45,50,0,2,2,0,11,10,0,0,1,1
"2011","E00004978","E00004978","Total",113,74,30,44,0,10,8,2,28,25,0,3,0,1
"2011","E00004964","E00004964","Total",123,84,34,50,2,8,8,0,28,27,0,1,0,1
"2011","E00004979","E00004979","Total",126,86,43,43,2,11,8,3,25,24,0,1,0,2
"2011","E00004982","E00004982","Total",117,62,27,35,0,1,0,1,52,46,0,4,2,2
"2011","E00004986","E00004986","Total",110,61,28,33,0,3,2,1,46,43,0,3,0,0
"2011","E00004993","E00004993","Total",121,62,29,33,1,6,3,3,50,48,0,2,0,2
"2011","E00004980","E00004980","Total",126,92,42,50,0,1,0,1,33,32,0,1,0,0
"2011","E00004983","E00004983","Total",100,66,22,44,4,2,0,2,26,26,0,0,0,2
"2011","E00004985","E00004985","Total",98,76,23,53,1,1,0,1,20,20,0,0,0,0
"2011","E00004990","E00004990","Total",119,97,42,55,1,2,2,0,18,17,0,1,0,1
"2011","E00004989","E00004989","Total",106,76,30,46,0,7,2,5,22,20,0,2,0,1
"2011","E00004995","E00004995","Total",125,91,34,57,1,6,3,3,27,25,0,2,0,0
"2011","E00004999","E00004999","Total",118,81,43,38,0,4,3,1,31,30,0,1,0,2
"2011","E00005000","E00005000","Total",122,72,32,40,0,15,6,9,34,33,0,0,1,1
"2011","E00004992","E00004992","Total",119,94,48,46,0,5,1,4,19,17,0,2,0,1
"2011","E00004994","E00004994","Total",116,79,36,43,0,4,1,3,29,27,0,2,0,4
"2011","E00004996","E00004996","Total",90,67,30,37,1,6,2,4,16,16,0,0,0,0
"2011","E00004998","E00004998","Total",111,83,33,50,1,7,2,5,19,18,0,1,0,1
"2011","E00004959","E00004959","Total",140,107,34,73,3,8,3,5,20,18,0,2,0,2
"2011","E00004961","E00004961","Total",90,58,16,42,0,4,1,3,28,28,0,0,0,0
"2011","E00004966","E00004966","Total",124,50,16,34,0,31,0,31,41,38,0,2,1,2
"2011","E00004968","E00004968","Total",144,92,36,56,3,6,1,5,43,40,0,3,0,0
"2011","E00004977","E00004977","Total",138,56,11,45,1,23,1,22,58,48,0,9,1,0
"2011","E00004981","E00004981","Total",75,49,19,30,0,6,3,3,20,17,0,3,0,0
"2011","E00004984","E00004984","Total",95,37,12,25,2,14,1,13,40,36,0,4,0,2
"2011","E00004987","E00004987","Total",171,77,27,50,0,12,2,10,82,78,1,3,0,0
"2011","E00004988","E00004988","Total",150,52,21,31,6,53,36,17,37,37,0,0,0,2
"2011","E00004956","E00004956","Total",107,74,35,39,1,8,1,7,24,24,0,0,0,0
"2011","E00004958","E00004958","Total",104,81,27,54,1,3,0,3,17,17,0,0,0,2
"2011","E00005001","E00005001","Total",104,52,26,26,0,9,6,3,43,39,0,2,2,0
"2011","E00174952","E00174952","Total",139,49,16,33,1,11,6,5,77,72,0,5,0,1
"2011","E00004957","E00004957","Total",128,34,15,19,21,29,0,29,44,42,0,0,2,0
"2011","E00004965","E00004965","Total",86,64,24,40,1,6,5,1,15,14,0,1,0,0
"2011","E00004967","E00004967","Total",105,53,25,28,0,39,5,34,12,12,0,0,0,1
"2011","E00004971","E00004971","Total",164,61,23,38,14,35,2,33,53,40,10,2,1,1
"2011","E00005004","E00005004","Total",125,52,20,32,1,22,3,19,47,47,0,0,0,3
"2011","E00005534","E00005534","Total",143,79,23,56,0,19,1,18,44,41,0,1,2,1
"2011","E00005535","E00005535","Total",114,59,22,37,0,29,24,5,25,22,0,3,0,1
"2011","E00005536","E00005536","Total",124,80,21,59,1,8,1,7,33,32,0,1,0,2
"2011","E00005537","E00005537","Total",112,90,34,56,0,7,2,5,15,13,0,2,0,0
"2011","E00005538","E00005538","Total",117,80,29,51,1,9,6,3,26,25,0,1,0,1
"2011","E00005716","E00005716","Total",129,66,21,45,1,10,9,1,52,51,0,1,0,0
"2011","E00005744","E00005744","Total",143,44,10,34,17,28,10,18,54,53,0,1,0,0
"2011","E00005746","E00005746","Total",125,12,2,10,0,100,100,0,13,13,0,0,0,0
"2011","E00005748","E00005748","Total",159,38,11,27,1,97,67,30,20,20,0,0,0,3
"2011","E00174940","E00174940","Total",205,61,24,37,1,110,87,23,29,27,0,2,0,4
"2011","E00005889","E00005889","Total",83,63,33,30,1,3,0,3,16,14,0,2,0,0
"2011","E00005893","E00005893","Total",119,94,40,54,1,6,0,6,18,18,0,0,0,0
"2011","E00005894","E00005894","Total",101,61,18,43,0,12,0,12,28,28,0,0,0,0
"2011","E00005895","E00005895","Total",106,67,36,31,0,14,2,12,23,20,0,3,0,2
"2011","E00005896","E00005896","Total",114,81,34,47,0,5,0,5,28,27,0,1,0,0
"2011","E00005862","E00005862","Total",108,58,22,36,1,22,20,2,23,22,0,0,1,4
"2011","E00005865","E00005865","Total",106,66,33,33,0,3,0,3,35,34,0,1,0,2
"2011","E00005892","E00005892","Total",115,71,30,41,1,6,1,5,37,37,0,0,0,0
"2011","E00005898","E00005898","Total",98,69,13,56,0,3,0,3,26,25,0,1,0,0
"2011","E00005899","E00005899","Total",100,64,27,37,0,9,2,7,26,25,0,1,0,1
"2011","E00005861","E00005861","Total",149,70,24,46,1,36,3,33,40,35,0,5,0,2
"2011","E00005863","E00005863","Total",109,70,28,42,0,6,0,6,32,31,0,1,0,1
"2011","E00005864","E00005864","Total",154,53,11,42,32,41,16,25,22,20,1,1,0,6
"2011","E00005900","E00005900","Total",108,75,35,40,0,9,2,7,23,23,0,0,0,1
"2011","E00005903","E00005903","Total",108,69,33,36,0,4,1,3,35,32,0,3,0,0
"2011","E00005880","E00005880","Total",139,78,36,42,0,4,0,4,56,53,1,1,1,1
"2011","E00005881","E00005881","Total",104,61,30,31,0,6,1,5,34,33,0,0,1,3
"2011","E00005882","E00005882","Total",128,96,48,48,1,1,1,0,23,22,0,1,0,7
"2011","E00005883","E00005883","Total",91,59,27,32,0,0,0,0,23,21,0,2,0,9
"2011","E00005867","E00005867","Total",146,57,17,40,0,15,2,13,72,69,0,1,2,2
"2011","E00005887","E00005887","Total",99,79,39,40,0,2,1,1,17,17,0,0,0,1
"2011","E00005890","E00005890","Total",100,83,39,44,1,1,0,1,15,13,0,2,0,0
"2011","E00005891","E00005891","Total",205,81,30,51,0,41,10,31,79,77,0,2,0,4
"2011","E00005884","E00005884","Total",140,112,54,58,0,1,0,1,24,22,0,2,0,3
"2011","E00005885","E00005885","Total",88,61,25,36,0,5,3,2,20,18,0,2,0,2
"2011","E00005886","E00005886","Total",119,89,44,45,0,8,3,5,22,19,0,3,0,0
"2011","E00005888","E00005888","Total",109,87,38,49,0,3,0,3,18,15,0,3,0,1
"2011","E00004960","E00004960","Total",132,94,24,70,1,6,2,4,30,29,0,0,1,1
"2011","E00005002","E00005002","Total",120,50,12,38,0,17,6,11,50,44,0,5,1,3
"2011","E00005003","E00005003","Total",108,64,25,39,1,8,2,6,33,33,0,0,0,2
"2011","E00005005","E00005005","Total",133,51,18,33,2,60,57,3,17,16,0,1,0,3
"2011","E00005521","E00005521","Total",137,64,19,45,1,19,6,13,50,45,0,4,1,3
"2011","E00005526","E00005526","Total",103,47,17,30,0,10,6,4,44,43,0,0,1,2
"2011","E00005533","E00005533","Total",110,22,10,12,0,74,70,4,7,7,0,0,0,7
"2011","E00005555","E00005555","Total",194,59,13,46,10,90,42,48,34,33,0,0,1,1
"2011","E00005560","E00005560","Total",175,69,16,53,6,47,12,35,51,45,1,5,0,2
"2011","E00005563","E00005563","Total",126,52,20,32,0,31,19,12,43,39,0,1,3,0
"2011","E00005525","E00005525","Total",112,31,9,22,7,32,9,23,39,38,0,0,1,3
"2011","E00005539","E00005539","Total",117,45,14,31,0,36,6,30,36,36,0,0,0,0
"2011","E00005541","E00005541","Total",108,36,7,29,0,22,6,16,47,45,0,2,0,3
"2011","E00005542","E00005542","Total",154,27,9,18,6,102,25,77,17,16,0,0,1,2
"2011","E00005543","E00005543","Total",131,51,17,34,10,60,3,57,10,9,0,0,1,0
"2011","E00005544","E00005544","Total",141,78,30,48,6,2,1,1,53,52,0,1,0,2
"2011","E00005540","E00005540","Total",125,65,21,44,0,19,0,19,40,39,0,1,0,1
"2011","E00005545","E00005545","Total",121,77,20,57,1,13,4,9,26,20,0,6,0,4
"2011","E00005547","E00005547","Total",162,66,20,46,1,34,6,28,60,59,0,1,0,1
"2011","E00005548","E00005548","Total",90,32,10,22,0,29,24,5,25,24,0,1,0,4
"2011","E00005551","E00005551","Total",126,69,25,44,0,8,5,3,47,47,0,0,0,2
"2011","E00005557","E00005557","Total",171,52,9,43,1,17,4,13,101,99,0,2,0,0
"2011","E00005546","E00005546","Total",111,11,2,9,1,71,68,3,26,25,0,1,0,2
"2011","E00005549","E00005549","Total",115,58,22,36,1,28,13,15,25,23,0,2,0,3
"2011","E00005550","E00005550","Total",114,55,17,38,3,23,8,15,32,31,1,0,0,1
"2011","E00005553","E00005553","Total",160,50,13,37,1,62,20,42,46,46,0,0,0,1
"2011","E00005554","E00005554","Total",85,17,2,15,1,57,56,1,7,6,0,0,1,3
"2011","E00005556","E00005556","Total",116,55,21,34,0,10,1,9,46,44,0,2,0,5
"2011","E00005558","E00005558","Total",97,57,10,47,0,18,1,17,22,22,0,0,0,0
"2011","E00005559","E00005559","Total",105,57,21,36,0,19,13,6,27,24,0,2,1,2
"2011","E00005561","E00005561","Total",93,51,10,41,0,21,9,12,18,17,1,0,0,3
"2011","E00005562","E00005562","Total",117,83,22,61,1,4,1,3,27,26,0,0,1,2
"2011","E00004920","E00004920","Total",128,13,2,11,1,108,95,13,5,5,0,0,0,1
"2011","E00004921","E00004921","Total",124,73,26,47,1,48,38,10,2,1,0,1,0,0
"2011","E00004922","E00004922","Total",136,82,29,53,0,26,6,20,27,26,0,1,0,1
"2011","E00004924","E00004924","Total",100,53,17,36,1,33,23,10,10,8,0,0,2,3
"2011","E00174953","E00174953","Total",138,67,25,42,2,58,43,15,10,8,0,2,0,1
"2011","E00174954","E00174954","Total",97,39,6,33,1,36,16,20,20,20,0,0,0,1
"2011","E00005911","E00005911","Total",106,53,16,37,0,12,3,9,40,38,0,2,0,1
"2011","E00005925","E00005925","Total",111,68,19,49,0,7,5,2,35,35,0,0,0,1
"2011","E00005929","E00005929","Total",116,84,32,52,0,15,2,13,16,15,0,0,1,1
"2011","E00005930","E00005930","Total",104,68,14,54,0,4,1,3,32,32,0,0,0,0
"2011","E00005931","E00005931","Total",142,104,30,74,1,9,3,6,28,28,0,0,0,0
"2011","E00005932","E00005932","Total",138,70,28,42,0,10,1,9,58,53,0,4,1,0
"2011","E00005917","E00005917","Total",141,79,29,50,1,11,4,7,50,47,0,3,0,0
"2011","E00005919","E00005919","Total",117,63,17,46,2,9,2,7,42,42,0,0,0,1
"2011","E00005921","E00005921","Total",86,38,9,29,0,33,6,27,12,10,0,2,0,3
"2011","E00005922","E00005922","Total",117,88,26,62,5,5,1,4,16,16,0,0,0,3
"2011","E00005923","E00005923","Total",129,40,12,28,0,59,5,54,30,28,0,0,2,0
"2011","E00005958","E00005958","Total",114,29,11,18,0,54,38,16,27,26,0,1,0,4
"2011","E00005961","E00005961","Total",137,57,14,43,0,15,6,9,63,61,0,2,0,2
"2011","E00005950","E00005950","Total",121,51,17,34,2,30,0,30,37,36,0,1,0,1
"2011","E00005952","E00005952","Total",124,50,24,26,1,53,5,48,18,17,0,1,0,2
"2011","E00005953","E00005953","Total",130,101,31,70,0,3,1,2,23,22,0,1,0,3
"2011","E00005955","E00005955","Total",103,66,28,38,0,7,3,4,27,27,0,0,0,3
"2011","E00005956","E00005956","Total",108,49,17,32,0,12,2,10,45,44,0,1,0,2
"2011","E00005959","E00005959","Total",142,55,17,38,12,49,43,6,23,23,0,0,0,3
"2011","E00005920","E00005920","Total",125,23,1,22,38,58,2,56,6,5,0,1,0,0
"2011","E00005962","E00005962","Total",121,98,31,67,0,6,2,4,16,15,0,1,0,1
"2011","E00005963","E00005963","Total",187,20,8,12,3,154,3,151,10,8,0,1,1,0
"2011","E00005965","E00005965","Total",150,40,11,29,24,83,2,81,3,3,0,0,0,0
"2011","E00004969","E00004969","Total",100,60,21,39,0,23,2,21,17,17,0,0,0,0
"2011","E00004970","E00004970","Total",90,60,11,49,2,7,0,7,21,21,0,0,0,0
"2011","E00004973","E00004973","Total",121,74,30,44,1,13,2,11,32,31,0,1,0,1
"2011","E00004974","E00004974","Total",117,58,12,46,3,18,4,14,38,35,0,2,1,0
"2011","E00174942","E00174942","Total",122,24,2,22,3,51,0,51,43,41,0,2,0,1
"2011","E00174943","E00174943","Total",113,37,5,32,21,4,4,0,50,50,0,0,0,1
"2011","E00174944","E00174944","Total",124,34,10,24,0,66,2,64,22,22,0,0,0,2
"2011","E00005520","E00005520","Total",171,83,15,68,1,60,37,23,19,19,0,0,0,8
"2011","E00005522","E00005522","Total",126,25,6,19,2,82,80,2,15,14,0,1,0,2
"2011","E00005552","E00005552","Total",113,43,14,29,0,50,39,11,15,14,0,1,0,5
"2011","E00005568","E00005568","Total",112,39,11,28,0,48,34,14,24,24,0,0,0,1
"2011","E00005572","E00005572","Total",135,57,17,40,0,38,25,13,33,33,0,0,0,7
"2011","E00005519","E00005519","Total",132,71,29,42,2,15,7,8,44,41,0,3,0,0
"2011","E00005528","E00005528","Total",205,50,17,33,0,56,20,36,93,91,0,1,1,6
"2011","E00005566","E00005566","Total",221,39,14,25,26,92,39,53,61,60,0,1,0,3
"2011","E00005570","E00005570","Total",111,61,20,41,0,7,1,6,42,41,0,1,0,1
"2011","E00174923","E00174923","Total",157,54,13,41,3,42,5,37,55,54,1,0,0,3
"2011","E00174924","E00174924","Total",223,102,5,97,27,7,4,3,86,84,0,1,1,1
"2011","E00174925","E00174925","Total",64,21,6,15,12,1,0,1,30,28,0,2,0,0
"2011","E00005901","E00005901","Total",113,22,7,15,0,39,4,35,46,41,0,0,5,6
"2011","E00005902","E00005902","Total",125,41,14,27,0,35,3,32,48,46,1,1,0,1
"2011","E00005906","E00005906","Total",118,25,12,13,3,43,21,22,36,31,0,1,4,11
"2011","E00005909","E00005909","Total",149,49,15,34,1,26,4,22,71,70,0,0,1,2
"2011","E00005868","E00005868","Total",174,29,14,15,25,78,35,43,38,37,0,1,0,4
"2011","E00005874","E00005874","Total",87,37,10,27,1,30,28,2,19,19,0,0,0,0
"2011","E00005877","E00005877","Total",128,74,25,49,0,19,6,13,35,34,0,0,1,0
"2011","E00005904","E00005904","Total",109,19,7,12,0,60,22,38,26,22,1,0,3,4
"2011","E00174931","E00174931","Total",136,34,10,24,8,47,25,22,43,40,0,1,2,4
"2011","E00174941","E00174941","Total",125,0,0,0,33,56,3,53,33,30,0,0,3,3
"2011","E00005012","E00005012","Total",150,76,13,63,0,5,1,4,69,64,0,4,1,0
"2011","E00005021","E00005021","Total",147,61,11,50,0,65,4,61,19,18,0,1,0,2
"2011","E00005024","E00005024","Total",103,6,6,0,0,91,1,90,6,6,0,0,0,0
"2011","E00005047","E00005047","Total",120,82,24,58,2,8,2,6,25,21,0,4,0,3
"2011","E00005052","E00005052","Total",96,66,24,42,2,7,2,5,20,17,0,3,0,1
"2011","E00005039","E00005039","Total",122,83,29,54,1,13,2,11,25,19,0,4,2,0
"2011","E00005040","E00005040","Total",118,66,19,47,2,18,5,13,29,28,0,0,1,3
"2011","E00005042","E00005042","Total",124,90,40,50,1,8,3,5,24,21,0,3,0,1
"2011","E00005043","E00005043","Total",121,76,28,48,0,22,13,9,23,21,0,0,2,0
"2011","E00005044","E00005044","Total",120,79,30,49,0,10,3,7,30,30,0,0,0,1
"2011","E00005871","E00005871","Total",136,85,26,59,0,22,3,19,27,27,0,0,0,2
"2011","E00005872","E00005872","Total",121,68,23,45,1,19,4,15,33,31,0,2,0,0
"2011","E00005873","E00005873","Total",124,74,18,56,1,24,2,22,24,22,0,0,2,1
"2011","E00005897","E00005897","Total",170,36,12,24,0,120,70,50,12,9,1,1,1,2
"2011","E00005866","E00005866","Total",112,73,24,49,2,8,2,6,29,29,0,0,0,0
"2011","E00005869","E00005869","Total",121,72,15,57,1,10,0,10,37,36,0,0,1,1
"2011","E00005905","E00005905","Total",96,67,31,36,1,5,2,3,23,21,0,1,1,0
"2011","E00005907","E00005907","Total",103,74,36,38,0,2,2,0,27,25,0,0,2,0
"2011","E00005910","E00005910","Total",106,74,26,48,1,5,1,4,25,23,0,2,0,1
"2011","E00005875","E00005875","Total",109,52,19,33,2,8,0,8,46,41,0,4,1,1
"2011","E00005876","E00005876","Total",119,59,19,40,1,8,1,7,51,47,0,2,2,0
"2011","E00005878","E00005878","Total",141,77,20,57,4,10,2,8,47,46,0,1,0,3
"2011","E00005879","E00005879","Total",113,71,22,49,0,8,0,8,29,28,0,1,0,5
"2011","E00005908","E00005908","Total",127,88,24,64,0,8,6,2,31,30,0,1,0,0
"2011","E00004854","E00004854","Total",132,105,29,76,0,3,1,2,23,22,1,0,0,1
"2011","E00004863","E00004863","Total",108,87,24,63,1,2,1,1,18,18,0,0,0,0
"2011","E00004865","E00004865","Total",128,82,31,51,1,16,1,15,28,26,0,2,0,1
"2011","E00004866","E00004866","Total",125,76,23,53,0,21,5,16,26,24,0,0,2,2
"2011","E00004913","E00004913","Total",73,32,10,22,0,36,1,35,4,3,1,0,0,1
"2011","E00004862","E00004862","Total",109,96,33,63,0,2,0,2,10,9,0,1,0,1
"2011","E00004864","E00004864","Total",118,80,26,54,6,10,2,8,17,15,0,1,1,5
"2011","E00004867","E00004867","Total",110,73,17,56,2,17,13,4,16,15,1,0,0,2
"2011","E00004868","E00004868","Total",89,67,20,47,0,7,3,4,14,12,0,1,1,1
"2011","E00004871","E00004871","Total",127,80,25,55,6,11,1,10,28,27,0,1,0,2
"2011","E00004875","E00004875","Total",94,80,24,56,0,6,1,5,8,6,0,1,1,0
"2011","E00004855","E00004855","Total",118,67,20,47,0,16,3,13,34,33,0,1,0,1
"2011","E00004869","E00004869","Total",102,76,25,51,1,4,1,3,21,19,0,2,0,0
"2011","E00004870","E00004870","Total",97,64,27,37,0,7,2,5,22,19,0,3,0,4
"2011","E00004874","E00004874","Total",147,87,21,66,1,31,10,21,28,25,0,3,0,0
"2011","E00004877","E00004877","Total",111,71,26,45,2,10,3,7,28,25,0,2,1,0
"2011","E00004879","E00004879","Total",109,63,23,40,1,4,0,4,41,39,0,2,0,0
"2011","E00004856","E00004856","Total",110,87,37,50,1,7,2,5,14,14,0,0,0,1
"2011","E00004878","E00004878","Total",134,112,46,66,0,8,3,5,14,12,0,1,1,0
"2011","E00004882","E00004882","Total",120,98,38,60,0,7,3,4,15,13,0,1,1,0
"2011","E00004883","E00004883","Total",113,77,26,51,1,3,1,2,32,31,0,1,0,0
"2011","E00004884","E00004884","Total",188,114,38,76,4,7,2,5,63,58,0,4,1,0
"2011","E00005914","E00005914","Total",127,44,16,28,1,58,52,6,21,20,0,1,0,3
"2011","E00005926","E00005926","Total",130,64,13,51,0,3,1,2,63,62,0,0,1,0
"2011","E00005927","E00005927","Total",152,71,20,51,28,40,13,27,12,12,0,0,0,1
"2011","E00005928","E00005928","Total",111,82,31,51,0,15,12,3,14,14,0,0,0,0
"2011","E00005933","E00005933","Total",149,92,31,61,2,19,6,13,34,31,0,3,0,2
"2011","E00005934","E00005934","Total",140,85,23,62,3,7,1,6,42,41,0,1,0,3
"2011","E00004947","E00004947","Total",125,113,48,65,0,7,2,5,4,4,0,0,0,1
"2011","E00004948","E00004948","Total",129,116,45,71,0,2,0,2,11,11,0,0,0,0
"2011","E00004949","E00004949","Total",110,98,37,61,0,3,1,2,9,9,0,0,0,0
"2011","E00004951","E00004951","Total",126,105,26,79,1,2,0,2,17,17,0,0,0,1
"2011","E00004952","E00004952","Total",138,113,49,64,0,9,2,7,16,15,1,0,0,0
"2011","E00004923","E00004923","Total",115,111,47,64,1,1,1,0,2,2,0,0,0,0
"2011","E00004925","E00004925","Total",145,139,79,60,0,2,1,1,4,4,0,0,0,0
"2011","E00004927","E00004927","Total",118,102,49,53,0,3,0,3,12,9,0,3,0,1
"2011","E00004954","E00004954","Total",138,120,53,67,1,5,0,5,11,10,0,1,0,1
"2011","E00004955","E00004955","Total",146,133,80,53,0,3,0,3,9,8,0,1,0,1
"2011","E00005610","E00005610","Total",165,131,44,87,1,21,2,19,10,9,0,1,0,2
"2011","E00005611","E00005611","Total",150,126,46,80,0,5,1,4,18,16,0,2,0,1
"2011","E00005645","E00005645","Total",111,28,12,16,0,74,2,72,8,6,0,1,1,1
"2011","E00005646","E00005646","Total",128,116,47,69,0,1,1,0,10,9,0,1,0,1
"2011","E00005647","E00005647","Total",131,111,36,75,1,1,0,1,18,15,0,3,0,0
"2011","E00005615","E00005615","Total",123,115,59,56,0,0,0,0,8,8,0,0,0,0
"2011","E00005648","E00005648","Total",117,100,62,38,0,8,1,7,9,8,1,0,0,0
"2011","E00005649","E00005649","Total",126,119,75,44,0,1,1,0,6,6,0,0,0,0
"2011","E00005650","E00005650","Total",116,93,67,26,0,15,0,15,8,7,1,0,0,0
"2011","E00005651","E00005651","Total",125,117,56,61,1,0,0,0,7,6,0,1,0,0
"2011","E00005612","E00005612","Total",118,109,54,55,0,1,0,1,7,6,0,1,0,1
"2011","E00005613","E00005613","Total",117,100,44,56,0,9,0,9,8,8,0,0,0,0
"2011","E00005616","E00005616","Total",108,105,45,60,0,2,1,1,0,0,0,0,0,1
"2011","E00005623","E00005623","Total",119,78,31,47,0,14,0,14,25,23,0,1,1,2
"2011","E00005652","E00005652","Total",121,82,33,49,0,9,2,7,28,25,1,2,0,2
"2011","E00005654","E00005654","Total",114,100,40,60,0,2,0,2,11,11,0,0,0,1
"2011","E00005006","E00005006","Total",110,72,23,49,2,6,2,4,30,28,0,0,2,0
"2011","E00005045","E00005045","Total",127,59,18,41,1,7,3,4,59,58,0,1,0,1
"2011","E00005050","E00005050","Total",118,70,27,43,0,8,2,6,40,38,0,2,0,0
"2011","E00005053","E00005053","Total",103,62,20,42,0,4,0,4,35,34,0,1,0,2
"2011","E00005054","E00005054","Total",78,42,13,29,0,8,3,5,27,26,0,1,0,1
"2011","E00005013","E00005013","Total",125,53,14,39,0,60,54,6,12,12,0,0,0,0
"2011","E00005014","E00005014","Total",123,67,19,48,1,11,4,7,43,41,0,2,0,1
"2011","E00005017","E00005017","Total",96,39,14,25,0,35,30,5,20,19,0,1,0,2
"2011","E00005022","E00005022","Total",79,29,10,19,1,38,35,3,11,9,0,2,0,0
"2011","E00005051","E00005051","Total",115,57,26,31,0,42,32,10,14,14,0,0,0,2
"2011","E00005025","E00005025","Total",102,51,20,31,0,14,5,9,36,33,0,2,1,1
"2011","E00005041","E00005041","Total",168,60,23,37,26,51,16,35,30,28,0,1,1,1
"2011","E00005046","E00005046","Total",103,61,15,46,0,14,0,14,26,25,0,0,1,2
"2011","E00005048","E00005048","Total",111,76,27,49,1,10,2,8,23,21,0,2,0,1
"2011","E00005049","E00005049","Total",125,52,19,33,0,20,14,6,52,48,0,2,2,1
"2011","E00005009","E00005009","Total",147,57,23,34,0,72,58,14,15,14,0,0,1,3
"2011","E00005010","E00005010","Total",203,102,38,64,0,82,66,16,19,17,0,2,0,0
"2011","E00005026","E00005026","Total",64,25,9,16,0,29,23,6,9,9,0,0,0,1
"2011","E00005029","E00005029","Total",125,49,21,28,1,54,25,29,21,20,0,1,0,0
"2011","E00005007","E00005007","Total",129,66,29,37,1,21,13,8,41,37,0,3,1,0
"2011","E00005008","E00005008","Total",108,57,11,46,1,8,7,1,40,35,0,3,2,2
"2011","E00005020","E00005020","Total",234,76,21,55,25,75,10,65,55,53,0,2,0,3
"2011","E00005023","E00005023","Total",159,41,20,21,3,14,6,8,99,96,0,3,0,2
"2011","E00005027","E00005027","Total",125,35,7,28,1,57,48,9,31,30,0,1,0,1
"2011","E00005015","E00005015","Total",164,78,32,46,0,13,3,10,70,69,0,1,0,3
"2011","E00005016","E00005016","Total",144,31,14,17,0,34,5,29,78,76,0,2,0,1
"2011","E00005018","E00005018","Total",141,49,21,28,1,11,8,3,80,77,0,2,1,0
"2011","E00005019","E00005019","Total",145,41,12,29,0,25,6,19,77,76,0,1,0,2
"2011","E00005028","E00005028","Total",152,27,6,21,0,38,2,36,82,82,0,0,0,5
"2011","E00005030","E00005030","Total",139,28,9,19,1,98,95,3,11,9,0,2,0,1
"2011","E00005031","E00005031","Total",227,50,17,33,5,59,28,31,110,107,3,0,0,3
"2011","E00005032","E00005032","Total",134,38,6,32,0,72,67,5,22,16,1,5,0,2
"2011","E00005033","E00005033","Total",138,11,4,7,0,115,114,1,9,9,0,0,0,3
"2011","E00005034","E00005034","Total",135,37,16,21,1,81,77,4,12,12,0,0,0,4
"2011","E00005035","E00005035","Total",126,19,5,14,2,14,1,13,90,85,1,3,1,1
"2011","E00005195","E00005195","Total",144,44,18,26,12,20,19,1,65,64,0,1,0,3
"2011","E00005196","E00005196","Total",99,27,13,14,0,3,1,2,68,63,2,3,0,1
"2011","E00005224","E00005224","Total",141,30,9,21,3,32,1,31,75,71,0,3,1,1
"2011","E00005225","E00005225","Total",167,36,11,25,0,28,17,11,102,100,0,1,1,1
"2011","E00005226","E00005226","Total",139,35,6,29,12,13,6,7,76,75,0,1,0,3
"2011","E00005227","E00005227","Total",141,44,17,27,0,39,0,39,54,53,0,0,1,4
"2011","E00005228","E00005228","Total",118,39,17,22,5,15,1,14,59,57,0,2,0,0
"2011","E00005524","E00005524","Total",129,52,16,36,0,41,34,7,35,34,0,0,1,1
"2011","E00005527","E00005527","Total",167,69,23,46,0,13,2,11,84,78,0,6,0,1
"2011","E00005530","E00005530","Total",160,27,4,23,18,75,8,67,39,37,0,2,0,1
"2011","E00005531","E00005531","Total",177,37,9,28,0,52,1,51,84,82,0,2,0,4
"2011","E00005532","E00005532","Total",138,36,11,25,3,9,0,9,86,84,0,2,0,4
"2011","E00005523","E00005523","Total",138,57,16,41,0,40,31,9,41,39,0,2,0,0
"2011","E00005529","E00005529","Total",105,23,11,12,1,64,50,14,17,17,0,0,0,0
"2011","E00005564","E00005564","Total",160,51,9,42,3,42,37,5,52,47,0,5,0,12
"2011","E00005565","E00005565","Total",106,42,16,26,2,24,16,8,35,34,0,1,0,3
"2011","E00005567","E00005567","Total",145,76,25,51,3,39,26,13,27,26,0,1,0,0
"2011","E00005571","E00005571","Total",141,32,12,20,0,92,78,14,16,15,0,1,0,1
"2011","E00004928","E00004928","Total",133,127,58,69,0,2,1,1,3,3,0,0,0,1
"2011","E00004937","E00004937","Total",144,109,53,56,0,20,1,19,14,11,0,3,0,1
"2011","E00004940","E00004940","Total",117,105,44,61,0,3,1,2,8,8,0,0,0,1
"2011","E00004941","E00004941","Total",121,114,62,52,1,0,0,0,5,4,0,1,0,1
"2011","E00004936","E00004936","Total",180,82,31,51,20,35,7,28,41,38,0,2,1,2
"2011","E00004938","E00004938","Total",150,116,69,47,0,12,2,10,21,18,0,2,1,1
"2011","E00004939","E00004939","Total",114,101,49,52,0,1,0,1,9,9,0,0,0,3
"2011","E00004942","E00004942","Total",118,78,37,41,1,4,3,1,35,34,0,1,0,0
"2011","E00004943","E00004943","Total",115,111,66,45,0,0,0,0,4,4,0,0,0,0
"2011","E00004914","E00004914","Total",127,120,65,55,1,2,1,1,4,3,0,1,0,0
"2011","E00004931","E00004931","Total",133,119,50,69,1,1,0,1,10,10,0,0,0,2
"2011","E00004932","E00004932","Total",126,106,53,53,0,0,0,0,19,18,0,1,0,1
"2011","E00004935","E00004935","Total",127,120,43,77,0,2,0,2,4,2,0,2,0,1
"2011","E00004926","E00004926","Total",116,99,44,55,0,6,1,5,11,10,0,1,0,0
"2011","E00004929","E00004929","Total",98,73,37,36,1,12,1,11,10,10,0,0,0,2
"2011","E00004930","E00004930","Total",129,103,40,63,4,10,2,8,12,11,0,1,0,0
"2011","E00004933","E00004933","Total",140,54,23,31,9,18,7,11,59,55,0,4,0,0
"2011","E00004934","E00004934","Total",133,117,50,67,2,1,1,0,11,11,0,0,0,2
"2011","E00004889","E00004889","Total",143,45,18,27,0,28,14,14,70,68,0,2,0,0
"2011","E00004902","E00004902","Total",133,73,26,47,0,8,4,4,52,50,1,1,0,0
"2011","E00004903","E00004903","Total",66,31,14,17,0,3,1,2,28,26,0,2,0,4
"2011","E00004905","E00004905","Total",130,58,21,37,0,5,1,4,67,65,0,2,0,0
"2011","E00004910","E00004910","Total",113,72,33,39,0,4,3,1,37,37,0,0,0,0
"2011","E00004911","E00004911","Total",125,84,37,47,1,2,2,0,36,34,1,0,1,2
"2011","E00004873","E00004873","Total",131,78,27,51,0,9,6,3,43,39,0,4,0,1
"2011","E00004876","E00004876","Total",122,67,22,45,0,6,2,4,49,46,0,2,1,0
"2011","E00004881","E00004881","Total",89,19,14,5,0,54,53,1,15,13,0,2,0,1
"2011","E00004885","E00004885","Total",148,44,14,30,0,14,8,6,87,84,1,2,0,3
"2011","E00004888","E00004888","Total",81,53,21,32,0,12,2,10,13,10,0,3,0,3
"2011","E00004892","E00004892","Total",141,45,16,29,2,13,5,8,79,75,1,2,1,2
"2011","E00004894","E00004894","Total",112,51,16,35,2,9,1,8,49,47,1,1,0,1
"2011","E00004886","E00004886","Total",124,61,15,46,0,13,0,13,49,47,0,2,0,1
"2011","E00004887","E00004887","Total",134,39,15,24,0,34,4,30,59,53,0,4,2,2
"2011","E00004891","E00004891","Total",112,43,16,27,1,43,39,4,25,22,0,2,1,0
"2011","E00004893","E00004893","Total",127,15,5,10,1,94,90,4,11,11,0,0,0,6
"2011","E00004897","E00004897","Total",151,76,35,41,2,3,2,1,66,65,0,1,0,4
"2011","E00004899","E00004899","Total",139,48,14,34,1,35,31,4,54,52,0,2,0,1
"2011","E00004904","E00004904","Total",131,68,37,31,0,7,0,7,55,53,0,1,1,1
"2011","E00004861","E00004861","Total",155,41,7,34,1,40,0,40,69,65,0,3,1,4
"2011","E00004895","E00004895","Total",132,44,17,27,0,14,8,6,74,73,0,1,0,0
"2011","E00004900","E00004900","Total",150,74,25,49,1,9,1,8,64,61,0,2,1,2
"2011","E00004901","E00004901","Total",163,73,20,53,0,7,2,5,80,80,0,0,0,3
"2011","E00004907","E00004907","Total",168,62,24,38,0,17,3,14,86,84,0,2,0,3
"2011","E00004912","E00004912","Total",159,73,23,50,1,14,8,6,70,65,1,3,1,1
"2011","E00004890","E00004890","Total",110,21,9,12,0,25,6,19,63,63,0,0,0,1
"2011","E00004896","E00004896","Total",123,91,43,48,1,2,0,2,29,28,0,1,0,0
"2011","E00004898","E00004898","Total",120,68,29,39,0,4,1,3,46,46,0,0,0,2
"2011","E00004906","E00004906","Total",135,48,15,33,2,4,3,1,80,76,0,4,0,1
"2011","E00004908","E00004908","Total",124,91,39,52,0,2,1,1,30,30,0,0,0,1
"2011","E00004909","E00004909","Total",178,67,27,40,18,21,3,18,70,65,0,5,0,2
"2011","E00004857","E00004857","Total",149,56,16,40,0,18,0,18,73,71,0,2,0,2
"2011","E00004858","E00004858","Total",132,8,3,5,0,107,58,49,12,11,0,1,0,5
"2011","E00004859","E00004859","Total",221,86,19,67,10,68,25,43,57,50,1,0,6,0
"2011","E00004860","E00004860","Total",89,15,4,11,9,37,26,11,27,27,0,0,0,1
"2011","E00004872","E00004872","Total",115,82,30,52,1,5,0,5,27,25,0,1,1,0
"2011","E00004880","E00004880","Total",116,55,25,30,0,10,0,10,47,45,0,2,0,4
"2011","E00005190","E00005190","Total",131,101,75,26,0,2,0,2,28,28,0,0,0,0
"2011","E00005192","E00005192","Total",121,92,51,41,0,2,2,0,23,22,0,1,0,4
"2011","E00005194","E00005194","Total",137,53,13,40,1,2,0,2,79,77,0,2,0,2
"2011","E00005205","E00005205","Total",141,96,67,29,0,2,1,1,43,41,0,2,0,0
"2011","E00005211","E00005211","Total",127,88,52,36,0,4,3,1,32,31,0,1,0,3
"2011","E00005218","E00005218","Total",128,54,19,35,0,17,1,16,53,51,0,2,0,4
"2011","E00005219","E00005219","Total",86,64,32,32,0,4,1,3,17,15,0,2,0,1
"2011","E00005187","E00005187","Total",91,63,37,26,0,0,0,0,27,26,0,1,0,1
"2011","E00005188","E00005188","Total",108,75,45,30,0,0,0,0,32,32,0,0,0,1
"2011","E00005200","E00005200","Total",126,48,29,19,0,0,0,0,74,73,0,1,0,4
"2011","E00005203","E00005203","Total",128,56,33,23,0,1,0,1,70,70,0,0,0,1
"2011","E00005236","E00005236","Total",120,62,30,32,0,2,0,2,54,51,0,2,1,2
"2011","E00005241","E00005241","Total",134,59,35,24,0,2,0,2,73,71,0,2,0,0
"2011","E00005242","E00005242","Total",143,78,50,28,0,2,1,1,63,59,0,3,1,0
"2011","E00005198","E00005198","Total",90,67,37,30,0,1,0,1,20,19,0,1,0,2
"2011","E00005212","E00005212","Total",112,86,52,34,0,2,1,1,23,21,0,2,0,1
"2011","E00005229","E00005229","Total",101,95,59,36,0,4,1,3,2,2,0,0,0,0
"2011","E00005230","E00005230","Total",84,78,52,26,0,1,0,1,5,5,0,0,0,0
"2011","E00005238","E00005238","Total",118,103,64,39,0,1,0,1,13,13,0,0,0,1
"2011","E00005199","E00005199","Total",159,15,8,7,0,124,6,118,18,17,0,1,0,2
"2011","E00005231","E00005231","Total",126,30,18,12,1,13,1,12,81,77,0,3,1,1
"2011","E00005232","E00005232","Total",86,48,23,25,0,3,1,2,33,31,0,2,0,2
"2011","E00005234","E00005234","Total",121,84,45,39,0,4,1,3,32,31,0,1,0,1
"2011","E00005235","E00005235","Total",87,7,2,5,0,69,2,67,11,10,0,1,0,0
"2011","E00005237","E00005237","Total",117,64,37,27,1,12,0,12,39,37,0,1,1,1
"2011","E00005239","E00005239","Total",106,7,3,4,1,76,1,75,19,19,0,0,0,3
"2011","E00005011","E00005011","Total",186,64,28,36,0,74,54,20,45,43,0,2,0,3
"2011","E00005036","E00005036","Total",137,47,17,30,0,62,59,3,27,24,1,2,0,1
"2011","E00174932","E00174932","Total",159,84,18,66,1,32,24,8,40,40,0,0,0,2
"2011","E00174933","E00174933","Total",108,32,12,20,2,13,7,6,61,61,0,0,0,0
"2011","E00174934","E00174934","Total",119,22,10,12,3,54,43,11,40,40,0,0,0,0
"2011","E00174935","E00174935","Total",113,30,9,21,1,31,18,13,49,48,0,0,1,2
"2011","E00174936","E00174936","Total",206,156,11,145,12,11,1,10,23,22,0,1,0,4
"2011","E00174937","E00174937","Total",158,10,0,10,34,108,4,104,6,6,0,0,0,0
"2011","E00005202","E00005202","Total",182,22,9,13,12,64,2,62,81,76,2,1,2,3
"2011","E00005208","E00005208","Total",101,61,24,37,0,11,1,10,28,26,0,2,0,1
"2011","E00005209","E00005209","Total",178,75,19,56,1,51,6,45,50,45,0,2,3,1
"2011","E00005210","E00005210","Total",111,20,5,15,0,65,30,35,25,24,0,1,0,1
"2011","E00005243","E00005243","Total",163,39,10,29,17,2,1,1,104,100,0,3,1,1
"2011","E00005244","E00005244","Total",101,50,20,30,0,14,11,3,34,32,0,2,0,3
"2011","E00005850","E00005850","Total",190,105,25,80,4,19,0,19,60,60,0,0,0,2
"2011","E00005852","E00005852","Total",120,78,25,53,0,15,1,14,27,23,0,4,0,0
"2011","E00005853","E00005853","Total",136,83,31,52,1,9,1,8,42,37,0,4,1,1
"2011","E00005856","E00005856","Total",113,68,23,45,0,9,4,5,32,31,0,1,0,4
"2011","E00005859","E00005859","Total",117,90,37,53,2,6,0,6,19,19,0,0,0,0
"2011","E00005825","E00005825","Total",150,73,23,50,3,14,10,4,59,52,2,4,1,1
"2011","E00005849","E00005849","Total",152,76,18,58,0,24,9,15,52,51,0,1,0,0
"2011","E00005851","E00005851","Total",161,57,17,40,1,18,9,9,82,78,2,1,1,3
"2011","E00005854","E00005854","Total",130,82,24,58,3,15,2,13,26,23,0,1,2,4
"2011","E00005858","E00005858","Total",109,8,1,7,0,78,35,43,21,17,0,0,4,2
"2011","E00005860","E00005860","Total",133,12,5,7,0,98,98,0,19,18,0,0,1,4
"2011","E00005812","E00005812","Total",149,113,42,71,3,7,3,4,26,24,0,2,0,0
"2011","E00005813","E00005813","Total",151,106,42,64,0,13,6,7,30,26,3,1,0,2
"2011","E00005821","E00005821","Total",145,104,42,62,1,3,0,3,36,36,0,0,0,1
"2011","E00005855","E00005855","Total",154,75,18,57,0,22,3,19,57,53,0,2,2,0
"2011","E00005857","E00005857","Total",141,94,28,66,2,11,3,8,34,32,0,2,0,0
"2011","E00005629","E00005629","Total",115,108,49,59,0,4,3,1,3,3,0,0,0,0
"2011","E00005630","E00005630","Total",124,115,57,58,0,7,5,2,2,2,0,0,0,0
"2011","E00005632","E00005632","Total",106,66,24,42,0,25,24,1,12,8,2,1,1,3
"2011","E00005637","E00005637","Total",113,111,55,56,0,2,2,0,0,0,0,0,0,0
"2011","E00005642","E00005642","Total",116,111,60,51,0,3,1,2,2,1,0,1,0,0
"2011","E00005633","E00005633","Total",124,74,30,44,0,43,2,41,6,6,0,0,0,1
"2011","E00005635","E00005635","Total",109,45,18,27,0,54,39,15,8,7,1,0,0,2
"2011","E00005636","E00005636","Total",108,36,15,21,1,67,57,10,3,3,0,0,0,1
"2011","E00005639","E00005639","Total",112,32,13,19,0,76,63,13,3,3,0,0,0,1
"2011","E00005640","E00005640","Total",113,32,14,18,2,70,62,8,9,8,0,1,0,0
"2011","E00005609","E00005609","Total",151,24,5,19,1,118,106,12,8,8,0,0,0,0
"2011","E00005638","E00005638","Total",91,11,3,8,0,68,65,3,10,7,0,3,0,2
"2011","E00005641","E00005641","Total",86,21,8,13,0,59,51,8,5,5,0,0,0,1
"2011","E00005643","E00005643","Total",120,14,5,9,0,99,95,4,4,3,0,1,0,3
"2011","E00005644","E00005644","Total",150,24,8,16,1,114,105,9,11,11,0,0,0,0
"2011","E00005617","E00005617","Total",129,81,34,47,0,6,4,2,39,35,1,2,1,3
"2011","E00005619","E00005619","Total",128,119,58,61,0,2,0,2,6,6,0,0,0,1
"2011","E00005620","E00005620","Total",129,120,60,60,0,5,4,1,3,3,0,0,0,1
"2011","E00005624","E00005624","Total",118,113,70,43,0,1,1,0,3,2,0,1,0,1
"2011","E00005625","E00005625","Total",127,121,63,58,0,3,2,1,2,1,0,1,0,1
"2011","E00005278","E00005278","Total",107,91,56,35,0,6,0,6,7,6,0,1,0,3
"2011","E00005287","E00005287","Total",105,100,53,47,0,1,0,1,3,3,0,0,0,1
"2011","E00005288","E00005288","Total",112,88,52,36,0,7,0,7,13,9,3,1,0,4
"2011","E00005289","E00005289","Total",108,100,45,55,1,1,1,0,6,6,0,0,0,0
"2011","E00005296","E00005296","Total",139,119,64,55,0,2,1,1,17,15,0,0,2,1
"2011","E00005290","E00005290","Total",119,84,38,46,0,1,0,1,33,31,1,1,0,1
"2011","E00005291","E00005291","Total",118,113,52,61,0,0,0,0,5,4,0,1,0,0
"2011","E00005292","E00005292","Total",115,100,47,53,0,5,1,4,10,10,0,0,0,0
"2011","E00005293","E00005293","Total",112,91,44,47,0,4,1,3,16,15,0,1,0,1
"2011","E00005294","E00005294","Total",123,117,55,62,0,1,0,1,5,4,0,1,0,0
"2011","E00005295","E00005295","Total",126,113,54,59,0,0,0,0,12,11,0,0,1,1
"2011","E00005297","E00005297","Total",124,118,75,43,0,0,0,0,4,4,0,0,0,2
"2011","E00005298","E00005298","Total",128,111,63,48,0,6,5,1,7,6,1,0,0,4
"2011","E00005300","E00005300","Total",127,109,52,57,0,3,3,0,13,12,0,0,1,2
"2011","E00005301","E00005301","Total",108,98,44,54,0,4,4,0,5,5,0,0,0,1
"2011","E00005626","E00005626","Total",127,121,64,57,0,1,0,1,4,3,0,0,1,1
"2011","E00005628","E00005628","Total",117,113,54,59,1,1,0,1,2,2,0,0,0,0
"2011","E00005631","E00005631","Total",129,123,52,71,1,1,1,0,3,2,0,0,1,1
"2011","E00005634","E00005634","Total",129,122,52,70,1,1,0,1,4,4,0,0,0,1
"2011","E00005614","E00005614","Total",143,126,77,49,0,4,0,4,8,6,0,2,0,5
"2011","E00005618","E00005618","Total",120,103,70,33,1,0,0,0,13,10,0,3,0,3
"2011","E00005621","E00005621","Total",112,89,71,18,1,13,11,2,6,6,0,0,0,3
"2011","E00005622","E00005622","Total",132,124,74,50,1,0,0,0,3,3,0,0,0,4
"2011","E00005627","E00005627","Total",129,126,76,50,0,0,0,0,2,2,0,0,0,1
"2011","E00005653","E00005653","Total",90,63,38,25,0,22,2,20,3,3,0,0,0,2
"2011","E00005134","E00005134","Total",119,62,28,34,12,16,0,16,28,28,0,0,0,1
"2011","E00005140","E00005140","Total",161,71,33,38,0,14,3,11,75,73,0,1,1,1
"2011","E00005141","E00005141","Total",126,57,28,29,1,12,0,12,54,50,1,1,2,2
"2011","E00005144","E00005144","Total",156,72,19,53,0,7,1,6,77,76,0,1,0,0
"2011","E00005146","E00005146","Total",120,37,6,31,2,13,0,13,67,65,0,2,0,1
"2011","E00005147","E00005147","Total",152,63,24,39,1,1,0,1,84,80,0,2,2,3
"2011","E00005206","E00005206","Total",248,29,7,22,29,57,3,54,125,111,3,3,8,8
"2011","E00005213","E00005213","Total",139,58,17,41,8,19,9,10,52,50,0,1,1,2
"2011","E00005214","E00005214","Total",208,50,11,39,1,20,8,12,131,122,3,5,1,6
"2011","E00005215","E00005215","Total",113,59,21,38,2,7,1,6,44,43,0,0,1,1
"2011","E00005216","E00005216","Total",146,38,11,27,2,74,72,2,31,31,0,0,0,1
"2011","E00174938","E00174938","Total",68,13,6,7,8,15,2,13,31,29,0,2,0,1
"2011","E00174939","E00174939","Total",188,48,15,33,16,47,3,44,75,73,1,1,0,2
"2011","E00174945","E00174945","Total",92,25,8,17,2,7,3,4,56,49,4,2,1,2
"2011","E00005189","E00005189","Total",114,30,11,19,2,24,12,12,58,58,0,0,0,0
"2011","E00005191","E00005191","Total",155,47,10,37,2,2,2,0,101,97,1,3,0,3
"2011","E00005197","E00005197","Total",158,38,18,20,2,37,34,3,78,75,1,2,0,3
"2011","E00005201","E00005201","Total",137,35,13,22,1,3,0,3,96,95,0,1,0,2
"2011","E00005233","E00005233","Total",142,31,16,15,1,31,2,29,77,74,0,1,2,2
"2011","E00005240","E00005240","Total",247,69,46,23,72,62,4,58,43,39,0,3,1,1
"2011","E00005193","E00005193","Total",103,41,12,29,0,29,7,22,33,33,0,0,0,0
"2011","E00005204","E00005204","Total",135,46,14,32,5,31,1,30,52,51,0,1,0,1
"2011","E00005217","E00005217","Total",123,60,18,42,0,12,1,11,49,47,0,2,0,2
"2011","E00005220","E00005220","Total",134,66,15,51,0,0,0,0,68,67,0,1,0,0
"2011","E00005221","E00005221","Total",104,53,19,34,0,7,0,7,40,38,1,1,0,4
"2011","E00005222","E00005222","Total",151,49,10,39,0,9,0,9,92,91,0,1,0,1
"2011","E00005223","E00005223","Total",119,35,10,25,1,13,1,12,69,67,0,0,2,1
"2011","E00005814","E00005814","Total",154,56,11,45,0,51,44,7,44,41,0,2,1,3
"2011","E00005826","E00005826","Total",154,41,13,28,2,48,46,2,61,58,0,3,0,2
"2011","E00005831","E00005831","Total",148,59,18,41,1,8,0,8,78,75,0,3,0,2
"2011","E00005832","E00005832","Total",135,61,21,40,0,32,3,29,41,39,2,0,0,1
"2011","E00005834","E00005834","Total",204,94,69,25,3,39,0,39,65,55,9,1,0,3
"2011","E00005838","E00005838","Total",194,83,37,46,4,9,0,9,97,93,0,3,1,1
"2011","E00005823","E00005823","Total",147,134,52,82,0,5,2,3,7,6,0,1,0,1
"2011","E00005824","E00005824","Total",137,75,22,53,0,15,1,14,44,41,1,2,0,3
"2011","E00005827","E00005827","Total",138,128,61,67,0,3,2,1,6,6,0,0,0,1
"2011","E00005833","E00005833","Total",107,74,34,40,1,6,1,5,24,20,2,2,0,2
"2011","E00174949","E00174949","Total",117,44,8,36,7,34,5,29,32,31,0,1,0,0
"2011","E00174950","E00174950","Total",106,56,8,48,0,29,15,14,20,19,0,0,1,1
"2011","E00174958","E00174958","Total",77,39,4,35,1,21,18,3,14,12,0,2,0,2
"2011","E00005819","E00005819","Total",149,35,11,24,1,102,73,29,10,9,0,0,1,1
"2011","E00005830","E00005830","Total",117,66,30,36,1,28,28,0,20,19,0,1,0,2
"2011","E00005835","E00005835","Total",122,69,25,44,1,46,40,6,6,6,0,0,0,0
"2011","E00005837","E00005837","Total",124,43,17,26,0,72,65,7,6,5,0,1,0,3
"2011","E00005840","E00005840","Total",139,76,29,47,0,55,46,9,4,4,0,0,0,4
"2011","E00005816","E00005816","Total",135,100,51,49,0,2,1,1,33,30,1,2,0,0
"2011","E00005817","E00005817","Total",126,81,29,52,0,35,19,16,9,6,0,2,1,1
"2011","E00005822","E00005822","Total",145,30,11,19,0,95,93,2,19,19,0,0,0,1
"2011","E00005828","E00005828","Total",140,15,7,8,0,112,110,2,9,9,0,0,0,4
"2011","E00005829","E00005829","Total",135,71,23,48,0,5,4,1,56,52,0,4,0,3
"2011","E00005818","E00005818","Total",118,51,16,35,0,58,54,4,8,8,0,0,0,1
"2011","E00005836","E00005836","Total",113,41,12,29,0,64,52,12,6,6,0,0,0,2
"2011","E00005839","E00005839","Total",83,14,2,12,1,61,47,14,5,5,0,0,0,2
"2011","E00005841","E00005841","Total",110,32,8,24,0,69,61,8,7,7,0,0,0,2
"2011","E00005842","E00005842","Total",96,34,7,27,0,54,39,15,6,6,0,0,0,2
"2011","E00005843","E00005843","Total",96,39,15,24,1,46,35,11,10,9,0,1,0,0
"2011","E00005820","E00005820","Total",144,70,35,35,12,11,3,8,45,38,6,1,0,6
"2011","E00005844","E00005844","Total",200,89,44,45,2,66,29,37,39,37,0,2,0,4
"2011","E00005845","E00005845","Total",148,91,41,50,3,10,5,5,43,42,0,1,0,1
"2011","E00005846","E00005846","Total",149,53,23,30,8,55,1,54,32,30,0,2,0,1
"2011","E00005848","E00005848","Total",135,85,34,51,0,19,2,17,28,27,0,1,0,3
"2011","E00174947","E00174947","Total",102,44,17,27,0,20,4,16,37,36,1,0,0,1
"2011","E00174948","E00174948","Total",111,35,8,27,20,42,1,41,14,14,0,0,0,0
"2011","E00174951","E00174951","Total",100,60,17,43,0,24,1,23,13,11,0,2,0,3
"2011","E00005142","E00005142","Total",121,55,22,33,0,18,1,17,46,45,0,1,0,2
"2011","E00005143","E00005143","Total",113,88,44,44,0,1,0,1,24,23,0,1,0,0
"2011","E00005145","E00005145","Total",112,97,65,32,0,1,0,1,13,12,1,0,0,1
"2011","E00005154","E00005154","Total",161,125,71,54,0,2,1,1,32,31,0,1,0,2
"2011","E00005156","E00005156","Total",121,109,60,49,0,1,1,0,10,9,1,0,0,1
"2011","E00005135","E00005135","Total",105,13,3,10,0,66,1,65,26,26,0,0,0,0
"2011","E00005137","E00005137","Total",151,82,22,60,5,21,3,18,42,40,0,2,0,1
"2011","E00005148","E00005148","Total",115,58,16,42,1,28,19,9,26,26,0,0,0,2
"2011","E00005153","E00005153","Total",133,87,29,58,1,3,1,2,42,40,0,1,1,0
"2011","E00005155","E00005155","Total",120,78,22,56,3,11,0,11,27,27,0,0,0,1
"2011","E00005136","E00005136","Total",217,94,25,69,1,31,1,30,87,82,1,4,0,4
"2011","E00005149","E00005149","Total",156,70,19,51,0,19,6,13,65,63,0,1,1,2
"2011","E00005150","E00005150","Total",148,63,16,47,0,10,3,7,72,69,0,3,0,3
"2011","E00005151","E00005151","Total",170,91,22,69,6,1,0,1,72,67,1,4,0,0
"2011","E00005152","E00005152","Total",125,54,15,39,8,3,1,2,60,55,0,5,0,0
"2011","E00005158","E00005158","Total",125,35,16,19,14,45,0,45,29,29,0,0,0,2
"2011","E00005138","E00005138","Total",129,94,38,56,6,5,1,4,23,21,0,2,0,1
"2011","E00005161","E00005161","Total",97,81,42,39,0,4,0,4,10,10,0,0,0,2
"2011","E00005166","E00005166","Total",126,103,45,58,1,5,0,5,15,14,0,1,0,2
"2011","E00005170","E00005170","Total",107,90,52,38,0,1,0,1,16,15,0,1,0,0
"2011","E00005176","E00005176","Total",124,115,72,43,0,5,0,5,3,2,0,0,1,1
"2011","E00005157","E00005157","Total",129,89,24,65,1,7,3,4,32,27,0,4,1,0
"2011","E00005159","E00005159","Total",122,80,33,47,1,13,7,6,27,26,0,1,0,1
"2011","E00005162","E00005162","Total",159,57,20,37,4,22,8,14,75,70,0,5,0,1
"2011","E00005163","E00005163","Total",118,80,21,59,1,3,1,2,34,33,0,1,0,0
"2011","E00005165","E00005165","Total",120,94,32,62,2,2,1,1,22,22,0,0,0,0
"2011","E00005174","E00005174","Total",115,60,17,43,1,15,2,13,38,36,0,2,0,1
"2011","E00005269","E00005269","Total",124,45,18,27,0,69,61,8,8,8,0,0,0,2
"2011","E00005272","E00005272","Total",115,43,19,24,0,68,46,22,4,4,0,0,0,0
"2011","E00005273","E00005273","Total",123,59,20,39,0,56,47,9,8,8,0,0,0,0
"2011","E00005274","E00005274","Total",120,2,0,2,0,111,107,4,6,6,0,0,0,1
"2011","E00005275","E00005275","Total",99,11,5,6,0,87,79,8,1,1,0,0,0,0
"2011","E00005265","E00005265","Total",121,27,8,19,0,87,69,18,5,5,0,0,0,2
"2011","E00005266","E00005266","Total",117,50,25,25,2,55,42,13,8,8,0,0,0,2
"2011","E00005267","E00005267","Total",108,48,23,25,0,53,44,9,7,7,0,0,0,0
"2011","E00005268","E00005268","Total",124,33,5,28,0,87,79,8,3,3,0,0,0,1
"2011","E00005248","E00005248","Total",131,68,27,41,0,57,48,9,6,6,0,0,0,0
"2011","E00005250","E00005250","Total",133,39,17,22,1,82,75,7,11,11,0,0,0,0
"2011","E00005251","E00005251","Total",104,52,20,32,0,47,40,7,3,2,0,1,0,2
"2011","E00005264","E00005264","Total",113,66,34,32,0,40,35,5,7,5,0,1,1,0
"2011","E00005277","E00005277","Total",113,58,25,33,0,40,33,7,12,11,0,1,0,3
"2011","E00005247","E00005247","Total",113,29,12,17,0,79,64,15,3,3,0,0,0,2
"2011","E00005252","E00005252","Total",120,18,7,11,0,95,87,8,5,4,0,0,1,2
"2011","E00005253","E00005253","Total",128,30,11,19,1,85,71,14,8,7,0,1,0,4
"2011","E00005256","E00005256","Total",112,14,3,11,1,95,91,4,2,2,0,0,0,0
"2011","E00005257","E00005257","Total",120,33,10,23,0,80,66,14,7,6,0,0,1,0
"2011","E00005255","E00005255","Total",125,13,5,8,1,106,97,9,5,5,0,0,0,0
"2011","E00005258","E00005258","Total",114,16,5,11,0,91,88,3,7,7,0,0,0,0
"2011","E00005259","E00005259","Total",117,20,8,12,0,90,85,5,6,6,0,0,0,1
"2011","E00005261","E00005261","Total",127,10,4,6,0,117,95,22,0,0,0,0,0,0
"2011","E00005262","E00005262","Total",154,12,3,9,0,137,130,7,3,3,0,0,0,2
"2011","E00005132","E00005132","Total",150,130,54,76,0,0,0,0,19,16,0,2,1,1
"2011","E00005172","E00005172","Total",98,64,29,35,0,18,2,16,16,14,0,1,1,0
"2011","E00005177","E00005177","Total",119,57,16,41,2,7,1,6,52,50,1,1,0,1
"2011","E00005178","E00005178","Total",122,73,23,50,2,11,8,3,33,31,0,1,1,3
"2011","E00005181","E00005181","Total",114,65,22,43,1,11,2,9,37,36,0,0,1,0
"2011","E00005182","E00005182","Total",91,66,26,40,0,6,0,6,19,19,0,0,0,0
"2011","E00005133","E00005133","Total",214,117,44,73,2,4,0,4,90,85,0,5,0,1
"2011","E00005167","E00005167","Total",111,66,14,52,12,2,1,1,30,27,1,2,0,1
"2011","E00005175","E00005175","Total",106,76,24,52,1,8,4,4,21,20,0,1,0,0
"2011","E00005179","E00005179","Total",132,85,24,61,0,10,0,10,34,33,0,1,0,3
"2011","E00005184","E00005184","Total",97,76,34,42,0,4,2,2,17,16,0,1,0,0
"2011","E00005160","E00005160","Total",134,69,23,46,0,2,0,2,61,59,0,2,0,2
"2011","E00005164","E00005164","Total",155,58,14,44,1,11,3,8,85,85,0,0,0,0
"2011","E00005168","E00005168","Total",99,43,12,31,0,8,0,8,46,42,1,2,1,2
"2011","E00005169","E00005169","Total",103,72,30,42,2,2,1,1,27,27,0,0,0,0
"2011","E00005171","E00005171","Total",166,56,20,36,1,48,8,40,60,60,0,0,0,1
"2011","E00005173","E00005173","Total",95,50,15,35,0,24,0,24,20,20,0,0,0,1
"2011","E00005442","E00005442","Total",126,93,23,70,0,0,0,0,29,26,0,3,0,4
"2011","E00005450","E00005450","Total",118,67,24,43,9,2,1,1,38,37,0,1,0,2
"2011","E00005456","E00005456","Total",119,78,23,55,0,18,3,15,20,20,0,0,0,3
"2011","E00005461","E00005461","Total",122,59,13,46,0,12,3,9,48,45,1,2,0,3
"2011","E00005480","E00005480","Total",99,72,21,51,1,2,0,2,24,24,0,0,0,0
"2011","E00005440","E00005440","Total",133,122,63,59,0,2,1,1,8,7,0,1,0,1
"2011","E00005446","E00005446","Total",151,61,24,37,8,28,23,5,49,49,0,0,0,5
"2011","E00005447","E00005447","Total",118,106,47,59,0,3,1,2,6,6,0,0,0,3
"2011","E00005448","E00005448","Total",115,84,26,58,0,2,2,0,28,23,0,4,1,1
"2011","E00005449","E00005449","Total",102,82,30,52,0,1,0,1,17,14,0,3,0,2
"2011","E00005246","E00005246","Total",131,65,28,37,1,59,39,20,5,5,0,0,0,1
"2011","E00005254","E00005254","Total",129,60,18,42,0,65,44,21,3,3,0,0,0,1
"2011","E00005260","E00005260","Total",149,101,42,59,1,40,37,3,6,6,0,0,0,1
"2011","E00005263","E00005263","Total",118,77,37,40,0,37,31,6,4,4,0,0,0,0
"2011","E00005245","E00005245","Total",100,50,26,24,0,42,37,5,8,8,0,0,0,0
"2011","E00005249","E00005249","Total",117,50,20,30,1,52,36,16,13,12,0,1,0,1
"2011","E00005270","E00005270","Total",119,56,24,32,1,53,38,15,9,8,0,1,0,0
"2011","E00005271","E00005271","Total",123,44,20,24,1,73,60,13,4,2,0,2,0,1
"2011","E00005276","E00005276","Total",126,38,15,23,1,81,63,18,4,4,0,0,0,2
"2011","E00005367","E00005367","Total",142,120,43,77,1,7,2,5,13,13,0,0,0,1
"2011","E00005392","E00005392","Total",124,107,42,65,1,8,3,5,8,7,0,1,0,0
"2011","E00005393","E00005393","Total",130,95,50,45,4,25,11,14,5,4,0,1,0,1
"2011","E00005394","E00005394","Total",127,100,46,54,2,14,6,8,11,11,0,0,0,0
"2011","E00005368","E00005368","Total",133,53,22,31,1,66,62,4,12,11,0,0,1,1
"2011","E00005374","E00005374","Total",130,14,6,8,3,108,27,81,4,4,0,0,0,1
"2011","E00005376","E00005376","Total",114,68,28,40,1,33,15,18,10,9,0,0,1,2
"2011","E00005390","E00005390","Total",136,113,52,61,1,17,12,5,5,5,0,0,0,0
"2011","E00005366","E00005366","Total",143,46,14,32,0,90,81,9,6,5,0,1,0,1
"2011","E00005389","E00005389","Total",129,94,43,51,1,19,10,9,12,10,0,2,0,3
"2011","E00005391","E00005391","Total",155,90,28,62,0,62,39,23,3,2,0,1,0,0
"2011","E00005395","E00005395","Total",133,63,26,37,2,61,52,9,7,6,0,1,0,0
"2011","E00005588","E00005588","Total",120,115,53,62,0,0,0,0,5,5,0,0,0,0
"2011","E00005589","E00005589","Total",119,111,45,66,0,2,2,0,5,5,0,0,0,1
"2011","E00005604","E00005604","Total",117,109,46,63,1,1,1,0,6,6,0,0,0,0
"2011","E00005608","E00005608","Total",124,103,43,60,5,0,0,0,16,15,0,1,0,0
"2011","E00005594","E00005594","Total",97,81,34,47,0,6,0,6,7,4,3,0,0,3
"2011","E00005595","E00005595","Total",156,126,53,73,0,0,0,0,28,26,1,0,1,2
"2011","E00005596","E00005596","Total",129,126,59,67,0,0,0,0,2,2,0,0,0,1
"2011","E00005600","E00005600","Total",125,120,57,63,0,0,0,0,4,4,0,0,0,1
"2011","E00005593","E00005593","Total",115,104,68,36,1,1,0,1,9,8,0,1,0,0
"2011","E00005597","E00005597","Total",116,114,73,41,0,0,0,0,1,1,0,0,0,1
"2011","E00005598","E00005598","Total",115,109,55,54,0,0,0,0,5,4,0,0,1,1
"2011","E00005599","E00005599","Total",129,127,64,63,0,1,0,1,1,1,0,0,0,0
"2011","E00005602","E00005602","Total",123,108,53,55,0,5,3,2,8,5,0,3,0,2
"2011","E00005575","E00005575","Total",125,116,70,46,0,2,1,1,7,7,0,0,0,0
"2011","E00005581","E00005581","Total",128,126,71,55,0,0,0,0,0,0,0,0,0,2
"2011","E00005583","E00005583","Total",122,117,63,54,0,1,1,0,4,3,1,0,0,0
"2011","E00005584","E00005584","Total",111,106,68,38,0,0,0,0,5,5,0,0,0,0
"2011","E00005601","E00005601","Total",123,118,73,45,0,1,0,1,3,3,0,0,0,1
"2011","E00005582","E00005582","Total",108,91,39,52,0,0,0,0,16,16,0,0,0,1
"2011","E00005587","E00005587","Total",118,101,42,59,0,9,9,0,8,7,0,1,0,0
"2011","E00005603","E00005603","Total",125,116,59,57,0,1,1,0,7,7,0,0,0,1
"2011","E00005606","E00005606","Total",131,77,37,40,0,1,1,0,51,48,2,1,0,2
"2011","E00005607","E00005607","Total",120,114,62,52,0,0,0,0,3,3,0,0,0,3
"2011","E00005311","E00005311","Total",141,124,59,65,1,3,0,3,12,12,0,0,0,1
"2011","E00005315","E00005315","Total",130,116,46,70,2,5,1,4,7,7,0,0,0,0
"2011","E00005316","E00005316","Total",131,115,59,56,1,6,3,3,8,7,0,1,0,1
"2011","E00005321","E00005321","Total",119,95,33,62,3,8,2,6,12,11,0,0,1,1
"2011","E00005284","E00005284","Total",117,93,42,51,1,5,0,5,17,14,0,3,0,1
"2011","E00005317","E00005317","Total",141,101,35,66,1,2,1,1,37,35,0,2,0,0
"2011","E00005318","E00005318","Total",138,95,41,54,1,5,1,4,34,31,0,1,2,3
"2011","E00005319","E00005319","Total",134,113,51,62,1,7,0,7,13,12,0,1,0,0
"2011","E00005320","E00005320","Total",162,114,42,72,0,3,3,0,45,43,0,2,0,0
"2011","E00005280","E00005280","Total",135,98,45,53,1,28,22,6,7,6,0,1,0,1
"2011","E00005282","E00005282","Total",122,101,33,68,2,6,0,6,13,12,0,1,0,0
"2011","E00005283","E00005283","Total",133,107,43,64,1,4,1,3,21,16,0,5,0,0
"2011","E00005285","E00005285","Total",123,102,37,65,2,5,0,5,13,9,0,4,0,1
"2011","E00005286","E00005286","Total",144,96,32,64,2,5,2,3,40,37,0,3,0,1
"2011","E00005307","E00005307","Total",116,92,34,58,0,14,10,4,10,7,1,2,0,0
"2011","E00005308","E00005308","Total",117,73,27,46,1,31,28,3,10,8,0,2,0,2
"2011","E00005309","E00005309","Total",96,54,18,36,1,33,27,6,8,7,0,1,0,0
"2011","E00005312","E00005312","Total",145,103,30,73,0,6,1,5,34,30,0,4,0,2
"2011","E00005314","E00005314","Total",168,92,28,64,0,7,0,7,68,63,0,5,0,1
"2011","E00005299","E00005299","Total",140,128,75,53,0,3,3,0,8,4,2,2,0,1
"2011","E00005302","E00005302","Total",138,82,31,51,0,2,0,2,51,48,1,2,0,3
"2011","E00005303","E00005303","Total",115,70,20,50,1,1,0,1,43,40,0,3,0,0
"2011","E00005304","E00005304","Total",145,141,72,69,0,1,0,1,3,3,0,0,0,0
"2011","E00005310","E00005310","Total",134,85,31,54,1,8,3,5,40,37,0,3,0,0
"2011","E00005279","E00005279","Total",81,21,11,10,0,54,49,5,6,6,0,0,0,0
"2011","E00005281","E00005281","Total",126,43,13,30,4,68,56,12,7,5,0,2,0,4
"2011","E00005305","E00005305","Total",76,30,16,14,0,43,35,8,3,3,0,0,0,0
"2011","E00005306","E00005306","Total",109,44,10,34,0,61,49,12,4,4,0,0,0,0
"2011","E00005313","E00005313","Total",101,40,13,27,0,44,25,19,17,16,0,1,0,0
"2011","E00005576","E00005576","Total",137,128,71,57,0,7,1,6,2,2,0,0,0,0
"2011","E00005577","E00005577","Total",149,136,63,73,0,6,2,4,5,5,0,0,0,2
"2011","E00005578","E00005578","Total",153,141,62,79,1,5,1,4,5,2,0,3,0,1
"2011","E00005579","E00005579","Total",137,119,53,66,1,6,1,5,11,10,0,1,0,0
"2011","E00005573","E00005573","Total",158,131,67,64,1,1,0,1,24,22,0,2,0,1
"2011","E00005574","E00005574","Total",100,94,50,44,0,1,1,0,4,4,0,0,0,1
"2011","E00005585","E00005585","Total",118,106,45,61,0,4,3,1,6,4,1,1,0,2
"2011","E00005586","E00005586","Total",116,100,39,61,0,8,2,6,7,7,0,0,0,1
"2011","E00005605","E00005605","Total",106,99,56,43,1,4,2,2,1,1,0,0,0,1
"2011","E00005139","E00005139","Total",108,102,59,43,0,0,0,0,5,4,1,0,0,1
"2011","E00005180","E00005180","Total",130,113,57,56,0,0,0,0,17,16,0,1,0,0
"2011","E00005183","E00005183","Total",96,89,51,38,0,0,0,0,6,6,0,0,0,1
"2011","E00005185","E00005185","Total",89,80,55,25,0,1,0,1,8,8,0,0,0,0
"2011","E00005186","E00005186","Total",97,96,55,41,0,1,1,0,0,0,0,0,0,0
"2011","E00005488","E00005488","Total",123,114,56,58,0,0,0,0,8,8,0,0,0,1
"2011","E00005514","E00005514","Total",130,123,68,55,0,2,2,0,4,4,0,0,0,1
"2011","E00005515","E00005515","Total",134,128,60,68,0,1,1,0,4,4,0,0,0,1
"2011","E00005516","E00005516","Total",122,117,56,61,1,2,1,1,1,1,0,0,0,1
"2011","E00005485","E00005485","Total",125,111,56,55,0,8,6,2,4,4,0,0,0,2
"2011","E00005490","E00005490","Total",121,47,28,19,0,35,30,5,36,34,1,1,0,3
"2011","E00005510","E00005510","Total",118,113,81,32,0,0,0,0,3,3,0,0,0,2
"2011","E00005517","E00005517","Total",127,118,70,48,0,0,0,0,8,7,0,1,0,1
"2011","E00005518","E00005518","Total",114,113,61,52,0,0,0,0,1,0,0,1,0,0
"2011","E00005481","E00005481","Total",152,92,44,48,0,2,2,0,56,53,0,3,0,2
"2011","E00005506","E00005506","Total",113,79,42,37,0,1,0,1,31,27,0,4,0,2
"2011","E00005507","E00005507","Total",139,136,79,57,0,1,1,0,2,2,0,0,0,0
"2011","E00005508","E00005508","Total",122,110,60,50,0,3,2,1,9,7,0,1,1,0
"2011","E00005511","E00005511","Total",136,118,69,49,1,8,0,8,8,8,0,0,0,1
"2011","E00005482","E00005482","Total",124,114,57,57,0,1,0,1,8,6,1,1,0,1
"2011","E00005483","E00005483","Total",130,122,56,66,0,0,0,0,8,8,0,0,0,0
"2011","E00005509","E00005509","Total",132,125,70,55,0,4,2,2,1,1,0,0,0,2
"2011","E00005512","E00005512","Total",118,109,55,54,0,4,4,0,2,2,0,0,0,3
"2011","E00005513","E00005513","Total",124,118,65,53,0,2,0,2,3,3,0,0,0,1
"2011","E00005365","E00005365","Total",90,28,12,16,0,14,10,4,46,46,0,0,0,2
"2011","E00005369","E00005369","Total",107,70,24,46,0,29,22,7,8,8,0,0,0,0
"2011","E00005370","E00005370","Total",121,49,15,34,2,52,48,4,17,17,0,0,0,1
"2011","E00005378","E00005378","Total",133,75,34,41,2,47,40,7,8,7,0,1,0,1
"2011","E00005380","E00005380","Total",130,71,27,44,1,48,42,6,10,9,1,0,0,0
"2011","E00005372","E00005372","Total",117,44,21,23,2,57,29,28,13,12,0,0,1,1
"2011","E00005373","E00005373","Total",136,87,39,48,1,37,29,8,11,10,1,0,0,0
"2011","E00005375","E00005375","Total",127,19,4,15,0,99,75,24,9,9,0,0,0,0
"2011","E00005383","E00005383","Total",135,80,30,50,2,43,33,10,9,9,0,0,0,1
"2011","E00005384","E00005384","Total",124,55,18,37,1,49,44,5,15,11,0,4,0,4
"2011","E00005371","E00005371","Total",147,17,7,10,1,120,111,9,7,7,0,0,0,2
"2011","E00005377","E00005377","Total",134,22,11,11,1,100,81,19,8,8,0,0,0,3
"2011","E00005379","E00005379","Total",139,44,23,21,1,88,52,36,4,3,0,0,1,2
"2011","E00005382","E00005382","Total",127,11,2,9,0,110,66,44,5,4,0,0,1,1
"2011","E00005387","E00005387","Total",140,31,9,22,0,98,85,13,11,10,0,1,0,0
"2011","E00005381","E00005381","Total",129,85,30,55,1,35,29,6,8,5,0,3,0,0
"2011","E00005385","E00005385","Total",136,77,38,39,4,48,34,14,7,7,0,0,0,0
"2011","E00005386","E00005386","Total",112,57,21,36,1,41,33,8,11,9,2,0,0,2
"2011","E00005388","E00005388","Total",129,53,19,34,2,66,53,13,4,4,0,0,0,4
"2011","E00005322","E00005322","Total",126,85,46,39,0,1,1,0,38,38,0,0,0,2
"2011","E00005323","E00005323","Total",123,120,47,73,0,0,0,0,3,2,0,1,0,0
"2011","E00005333","E00005333","Total",127,70,32,38,0,2,2,0,54,53,0,1,0,1
"2011","E00005340","E00005340","Total",125,72,23,49,0,19,2,17,31,29,0,2,0,3
"2011","E00005341","E00005341","Total",117,80,26,54,0,26,1,25,11,11,0,0,0,0
"2011","E00005453","E00005453","Total",117,104,58,46,0,4,3,1,7,6,0,1,0,2
"2011","E00005455","E00005455","Total",152,112,54,58,0,7,1,6,32,30,1,1,0,1
"2011","E00005458","E00005458","Total",134,99,39,60,0,2,1,1,32,30,1,1,0,1
"2011","E00005464","E00005464","Total",185,136,69,67,1,16,0,16,26,23,0,2,1,6
"2011","E00005444","E00005444","Total",166,108,50,58,20,18,4,14,19,18,0,1,0,1
"2011","E00005445","E00005445","Total",155,88,30,58,1,24,22,2,40,39,0,1,0,2
"2011","E00005451","E00005451","Total",132,107,35,72,0,2,0,2,23,20,0,2,1,0
"2011","E00005452","E00005452","Total",123,108,56,52,0,3,2,1,12,10,0,2,0,0
"2011","E00005465","E00005465","Total",118,96,32,64,1,3,1,2,17,14,0,2,1,1
"2011","E00005441","E00005441","Total",140,113,56,57,0,12,2,10,14,13,0,1,0,1
"2011","E00005459","E00005459","Total",130,113,53,60,0,4,1,3,13,11,0,2,0,0
"2011","E00005462","E00005462","Total",143,128,62,66,0,2,1,1,12,12,0,0,0,1
"2011","E00005463","E00005463","Total",117,110,62,48,0,0,0,0,6,6,0,0,0,1
"2011","E00005466","E00005466","Total",107,68,38,30,2,1,0,1,34,30,0,3,1,2
"2011","E00005468","E00005468","Total",218,58,12,46,6,18,2,16,131,129,0,2,0,5
"2011","E00005473","E00005473","Total",123,80,23,57,3,11,0,11,29,28,0,1,0,0
"2011","E00005474","E00005474","Total",196,102,40,62,1,48,14,34,41,41,0,0,0,4
"2011","E00005475","E00005475","Total",149,87,54,33,0,7,5,2,54,52,0,2,0,1
"2011","E00174946","E00174946","Total",95,45,41,4,0,39,0,39,9,8,0,1,0,2
"2011","E00174955","E00174955","Total",81,27,7,20,31,2,1,1,21,20,0,1,0,0
"2011","E00174956","E00174956","Total",90,49,13,36,1,0,0,0,40,39,0,1,0,0
"2011","E00005469","E00005469","Total",136,124,59,65,0,2,2,0,10,9,0,1,0,0
"2011","E00005470","E00005470","Total",128,119,66,53,0,0,0,0,8,8,0,0,0,1
"2011","E00005471","E00005471","Total",121,115,41,74,0,1,0,1,5,5,0,0,0,0
"2011","E00005472","E00005472","Total",130,115,51,64,2,3,2,1,8,8,0,0,0,2
"2011","E00005094","E00005094","Total",177,164,75,89,0,4,0,4,7,4,1,1,1,2
"2011","E00005119","E00005119","Total",108,102,44,58,0,0,0,0,6,6,0,0,0,0
"2011","E00005120","E00005120","Total",125,115,64,51,0,3,1,2,7,6,0,0,1,0
"2011","E00005123","E00005123","Total",118,103,51,52,0,1,1,0,14,13,0,1,0,0
"2011","E00005115","E00005115","Total",156,135,71,64,0,0,0,0,20,19,0,1,0,1
"2011","E00005116","E00005116","Total",140,127,58,69,0,1,1,0,11,8,0,1,2,1
"2011","E00005117","E00005117","Total",117,74,32,42,0,8,2,6,34,34,0,0,0,1
"2011","E00005118","E00005118","Total",128,70,29,41,0,14,9,5,43,40,0,1,2,1
"2011","E00005121","E00005121","Total",128,115,51,64,1,2,2,0,10,8,0,1,1,0
"2011","E00005122","E00005122","Total",115,111,54,57,0,0,0,0,4,4,0,0,0,0
"2011","E00005124","E00005124","Total",114,107,52,55,0,1,0,1,6,6,0,0,0,0
"2011","E00005125","E00005125","Total",105,91,38,53,0,1,1,0,11,11,0,0,0,2
"2011","E00005098","E00005098","Total",123,118,61,57,0,0,0,0,5,5,0,0,0,0
"2011","E00005126","E00005126","Total",115,104,52,52,0,1,0,1,8,8,0,0,0,2
"2011","E00005128","E00005128","Total",130,124,50,74,1,0,0,0,4,4,0,0,0,1
"2011","E00005129","E00005129","Total",123,106,43,63,0,0,0,0,17,17,0,0,0,0
"2011","E00005443","E00005443","Total",133,123,69,54,0,1,0,1,9,6,0,3,0,0
"2011","E00005454","E00005454","Total",119,107,59,48,0,1,0,1,9,7,0,2,0,2
"2011","E00005457","E00005457","Total",149,126,62,64,0,2,0,2,19,16,0,3,0,2
"2011","E00005467","E00005467","Total",120,111,57,54,0,0,0,0,7,6,1,0,0,2
"2011","E00005486","E00005486","Total",122,117,73,44,0,1,0,1,4,4,0,0,0,0
"2011","E00005487","E00005487","Total",122,113,66,47,0,2,1,1,7,6,1,0,0,0
"2011","E00005491","E00005491","Total",129,126,63,63,0,0,0,0,3,3,0,0,0,0
"2011","E00005496","E00005496","Total",145,123,75,48,2,3,1,2,17,17,0,0,0,0
"2011","E00005497","E00005497","Total",133,102,47,55,0,26,23,3,5,5,0,0,0,0
"2011","E00005492","E00005492","Total",124,62,19,43,2,53,48,5,6,6,0,0,0,1
"2011","E00005499","E00005499","Total",127,81,36,45,0,35,33,2,8,6,1,1,0,3
"2011","E00005501","E00005501","Total",130,97,39,58,0,27,26,1,6,6,0,0,0,0
"2011","E00005502","E00005502","Total",125,107,51,56,0,10,9,1,6,6,0,0,0,2
"2011","E00005503","E00005503","Total",126,109,38,71,0,14,10,4,3,3,0,0,0,0
"2011","E00005484","E00005484","Total",148,122,49,73,0,12,12,0,11,11,0,0,0,3
"2011","E00005500","E00005500","Total",133,106,41,65,1,19,6,13,3,3,0,0,0,4
"2011","E00005504","E00005504","Total",128,103,41,62,0,16,16,0,8,8,0,0,0,1
"2011","E00005505","E00005505","Total",131,96,49,47,0,9,9,0,25,22,1,2,0,1
"2011","E00005580","E00005580","Total",128,122,63,59,0,3,2,1,3,2,1,0,0,0
"2011","E00005590","E00005590","Total",121,111,72,39,0,8,8,0,2,2,0,0,0,0
"2011","E00005591","E00005591","Total",123,113,65,48,0,4,3,1,5,5,0,0,0,1
"2011","E00005592","E00005592","Total",129,121,66,55,1,1,1,0,6,6,0,0,0,0
"2011","E00005327","E00005327","Total",122,108,32,76,1,3,3,0,10,10,0,0,0,0
"2011","E00005351","E00005351","Total",126,102,29,73,0,15,14,1,9,9,0,0,0,0
"2011","E00005355","E00005355","Total",135,112,56,56,0,6,5,1,17,17,0,0,0,0
"2011","E00005359","E00005359","Total",117,103,43,60,0,5,5,0,8,7,0,1,0,1
"2011","E00005335","E00005335","Total",127,55,14,41,1,64,59,5,5,5,0,0,0,2
"2011","E00005336","E00005336","Total",157,103,26,77,0,30,13,17,21,21,0,0,0,3
"2011","E00005357","E00005357","Total",129,111,43,68,0,11,9,2,6,6,0,0,0,1
"2011","E00005361","E00005361","Total",118,114,75,39,0,1,0,1,3,2,0,1,0,0
"2011","E00005362","E00005362","Total",128,110,50,60,1,14,14,0,1,1,0,0,0,2
"2011","E00005324","E00005324","Total",139,108,38,70,0,2,1,1,26,25,0,1,0,3
"2011","E00005328","E00005328","Total",150,106,55,51,1,19,18,1,23,19,0,4,0,1
"2011","E00005343","E00005343","Total",116,99,30,69,1,2,2,0,13,13,0,0,0,1
"2011","E00005346","E00005346","Total",120,84,20,64,3,22,9,13,9,9,0,0,0,2
"2011","E00005347","E00005347","Total",121,69,17,52,0,10,9,1,41,40,0,1,0,1
"2011","E00005476","E00005476","Total",133,110,57,53,0,15,1,14,7,7,0,0,0,1
"2011","E00005477","E00005477","Total",179,140,43,97,0,1,1,0,38,32,0,5,1,0
"2011","E00005478","E00005478","Total",132,35,10,25,0,77,44,33,20,19,0,1,0,0
"2011","E00005479","E00005479","Total",142,89,16,73,2,36,3,33,15,13,0,2,0,0
"2011","E00005055","E00005055","Total",135,113,46,67,0,4,3,1,15,15,0,0,0,3
"2011","E00005066","E00005066","Total",131,21,9,12,1,99,18,81,9,8,0,1,0,1
"2011","E00005069","E00005069","Total",117,59,15,44,1,49,38,11,8,8,0,0,0,0
"2011","E00005072","E00005072","Total",132,118,60,58,4,2,2,0,7,7,0,0,0,1
"2011","E00005061","E00005061","Total",150,105,38,67,1,30,29,1,11,11,0,0,0,3
"2011","E00005063","E00005063","Total",124,121,69,52,0,1,0,1,2,2,0,0,0,0
"2011","E00005064","E00005064","Total",135,116,60,56,0,1,0,1,17,14,1,2,0,1
"2011","E00005065","E00005065","Total",144,108,58,50,17,5,4,1,12,11,0,1,0,2
"2011","E00005067","E00005067","Total",112,101,51,50,0,6,3,3,3,3,0,0,0,2
"2011","E00005099","E00005099","Total",131,37,9,28,1,5,2,3,85,81,1,3,0,3
"2011","E00005102","E00005102","Total",121,62,25,37,3,20,17,3,36,33,0,2,1,0
"2011","E00005127","E00005127","Total",102,78,34,44,0,5,3,2,18,17,0,1,0,1
"2011","E00005130","E00005130","Total",125,87,50,37,3,20,19,1,13,13,0,0,0,2
"2011","E00005131","E00005131","Total",96,80,27,53,0,1,0,1,13,13,0,0,0,2
"2011","E00005349","E00005349","Total",124,119,52,67,1,0,0,0,3,2,0,1,0,1
"2011","E00005350","E00005350","Total",107,96,42,54,1,0,0,0,10,10,0,0,0,0
"2011","E00005352","E00005352","Total",126,114,63,51,1,0,0,0,9,7,0,1,1,2
"2011","E00005354","E00005354","Total",113,109,39,70,0,1,0,1,3,3,0,0,0,0
"2011","E00005356","E00005356","Total",108,100,43,57,0,2,2,0,5,4,0,0,1,1
"2011","E00005325","E00005325","Total",137,84,26,58,4,9,2,7,40,38,0,2,0,0
"2011","E00005326","E00005326","Total",210,121,35,86,17,42,5,37,28,27,0,1,0,2
"2011","E00005342","E00005342","Total",140,53,13,40,23,26,5,21,38,36,0,2,0,0
"2011","E00005345","E00005345","Total",229,71,26,45,1,79,1,78,74,70,0,4,0,4
"2011","E00005348","E00005348","Total",112,102,38,64,0,1,0,1,9,9,0,0,0,0
"2011","E00005329","E00005329","Total",153,86,45,41,0,54,4,50,12,11,0,1,0,1
"2011","E00005330","E00005330","Total",146,138,78,60,0,1,0,1,7,7,0,0,0,0
"2011","E00005344","E00005344","Total",132,91,15,76,1,30,28,2,8,7,0,1,0,2
"2011","E00005353","E00005353","Total",204,89,31,58,20,64,2,62,31,28,0,3,0,0
"2011","E00005360","E00005360","Total",149,116,53,63,0,4,4,0,27,26,0,0,1,2
"2011","E00005337","E00005337","Total",119,108,52,56,0,5,5,0,5,5,0,0,0,1
"2011","E00005358","E00005358","Total",118,96,35,61,0,3,3,0,15,14,0,1,0,4
"2011","E00005363","E00005363","Total",109,70,24,46,0,34,32,2,5,5,0,0,0,0
"2011","E00005364","E00005364","Total",159,76,17,59,16,50,29,21,17,15,0,2,0,0
"2011","E00174957","E00174957","Total",115,106,48,58,1,2,1,1,6,6,0,0,0,0
"2011","E00174959","E00174959","Total",115,102,40,62,0,5,4,1,8,8,0,0,0,0
"2011","E00005331","E00005331","Total",129,123,66,57,0,1,1,0,5,5,0,0,0,0
"2011","E00005332","E00005332","Total",138,123,67,56,0,2,0,2,11,11,0,0,0,2
"2011","E00005334","E00005334","Total",121,115,52,63,0,1,1,0,5,4,0,0,1,0
"2011","E00005339","E00005339","Total",145,140,80,60,0,1,1,0,3,2,0,1,0,1
"2011","E00005489","E00005489","Total",121,89,38,51,0,18,13,5,13,11,0,2,0,1
"2011","E00005493","E00005493","Total",132,125,58,67,0,3,1,2,4,4,0,0,0,0
"2011","E00005494","E00005494","Total",123,115,44,71,0,1,1,0,7,6,0,1,0,0
"2011","E00005495","E00005495","Total",138,122,48,74,0,3,3,0,12,11,1,0,0,1
"2011","E00005498","E00005498","Total",128,124,55,69,0,0,0,0,2,1,1,0,0,2
"2011","E00005057","E00005057","Total",133,124,61,63,1,0,0,0,8,7,0,1,0,0
"2011","E00005059","E00005059","Total",130,125,65,60,0,0,0,0,4,4,0,0,0,1
"2011","E00005068","E00005068","Total",125,122,59,63,0,1,0,1,2,2,0,0,0,0
"2011","E00005070","E00005070","Total",119,103,51,52,0,1,0,1,15,13,0,2,0,0
"2011","E00005080","E00005080","Total",135,123,52,71,0,7,7,0,5,4,1,0,0,0
"2011","E00005095","E00005095","Total",136,127,57,70,0,2,1,1,5,5,0,0,0,2
"2011","E00005100","E00005100","Total",125,120,50,70,0,1,1,0,4,4,0,0,0,0
"2011","E00005104","E00005104","Total",146,114,43,71,0,3,3,0,28,26,0,2,0,1
"2011","E00005105","E00005105","Total",125,106,49,57,0,10,2,8,9,8,0,1,0,0
"2011","E00005101","E00005101","Total",127,119,53,66,0,4,4,0,4,3,0,1,0,0
"2011","E00005103","E00005103","Total",118,108,47,61,1,5,5,0,4,4,0,0,0,0
"2011","E00005106","E00005106","Total",121,108,45,63,0,3,2,1,8,8,0,0,0,2
"2011","E00005107","E00005107","Total",123,112,58,54,0,2,2,0,8,6,0,2,0,1
"2011","E00005108","E00005108","Total",133,98,32,66,0,28,10,18,7,7,0,0,0,0
"2011","E00005110","E00005110","Total",126,79,32,47,1,36,32,4,10,9,0,1,0,0
"2011","E00005111","E00005111","Total",136,120,48,72,0,2,2,0,13,12,0,1,0,1
"2011","E00005112","E00005112","Total",113,98,38,60,0,12,10,2,3,3,0,0,0,0
"2011","E00005113","E00005113","Total",133,124,41,83,2,2,2,0,5,5,0,0,0,0
"2011","E00005096","E00005096","Total",148,128,44,84,0,1,1,0,16,15,0,1,0,3
"2011","E00005097","E00005097","Total",133,117,50,67,0,5,2,3,10,7,1,2,0,1
"2011","E00005109","E00005109","Total",125,111,47,64,0,2,1,1,12,12,0,0,0,0
"2011","E00005114","E00005114","Total",128,104,47,57,1,15,13,2,8,8,0,0,0,0
"2011","E00005058","E00005058","Total",119,99,42,57,0,3,3,0,17,14,2,1,0,0
"2011","E00005076","E00005076","Total",118,114,67,47,0,2,2,0,2,0,0,2,0,0
"2011","E00005079","E00005079","Total",136,125,66,59,0,5,0,5,5,5,0,0,0,1
"2011","E00005081","E00005081","Total",136,116,48,68,0,9,9,0,9,7,0,2,0,2
"2011","E00005083","E00005083","Total",130,121,50,71,0,0,0,0,8,8,0,0,0,1
"2011","E00005056","E00005056","Total",123,114,62,52,0,3,3,0,6,5,0,1,0,0
"2011","E00005071","E00005071","Total",113,72,42,30,0,41,41,0,0,0,0,0,0,0
"2011","E00005073","E00005073","Total",117,109,51,58,0,0,0,0,5,5,0,0,0,3
"2011","E00005074","E00005074","Total",117,104,55,49,0,1,0,1,11,5,3,0,3,1
"2011","E00005075","E00005075","Total",123,119,76,43,0,0,0,0,4,4,0,0,0,0
"2011","E00005078","E00005078","Total",142,132,65,67,0,0,0,0,6,6,0,0,0,4
"2011","E00005084","E00005084","Total",136,127,59,68,0,3,2,1,6,5,0,1,0,0
"2011","E00005085","E00005085","Total",117,73,39,34,0,33,31,2,10,9,0,1,0,1
"2011","E00005086","E00005086","Total",133,121,57,64,0,2,1,1,7,6,0,1,0,3
"2011","E00005088","E00005088","Total",129,117,40,77,0,3,1,2,5,4,0,1,0,4
"2011","E00005060","E00005060","Total",117,41,9,32,0,68,67,1,7,7,0,0,0,1
"2011","E00005062","E00005062","Total",122,37,9,28,0,70,68,2,15,15,0,0,0,0
"2011","E00005077","E00005077","Total",111,58,29,29,0,52,50,2,1,1,0,0,0,0
"2011","E00005082","E00005082","Total",135,55,28,27,0,67,65,2,10,8,0,2,0,3
"2011","E00005093","E00005093","Total",105,68,25,43,0,33,31,2,4,3,0,1,0,0
"2011","E00005087","E00005087","Total",125,116,63,53,0,0,0,0,4,2,2,0,0,5
"2011","E00005089","E00005089","Total",116,111,70,41,0,1,1,0,4,3,0,1,0,0
"2011","E00005090","E00005090","Total",121,114,56,58,0,2,1,1,5,5,0,0,0,0
"2011","E00005091","E00005091","Total",126,118,66,52,0,1,0,1,5,3,1,1,0,2
"2011","E00005092","E00005092","Total",123,110,57,53,0,7,6,1,6,4,0,2,0,0
"2011","E00004916","E00004916","Total",138,42,15,27,0,85,64,21,10,9,0,0,1,1
"2011","E00004917","E00004917","Total",138,65,20,45,1,67,60,7,5,4,1,0,0,0
"2011","E00004918","E00004918","Total",128,42,15,27,0,82,77,5,4,3,0,1,0,0
"2011","E00004950","E00004950","Total",134,37,17,20,0,82,68,14,12,10,0,1,1,3
"2011","E00005915","E00005915","Total",115,83,22,61,0,17,11,6,14,14,0,0,0,1
"2011","E00005916","E00005916","Total",89,53,15,38,3,23,7,16,10,10,0,0,0,0
"2011","E00005918","E00005918","Total",94,73,28,45,0,10,3,7,11,11,0,0,0,0
"2011","E00005924","E00005924","Total",167,131,41,90,1,16,0,16,17,16,0,1,0,2
"2011","E00005935","E00005935","Total",149,82,27,55,0,58,3,55,9,9,0,0,0,0
"2011","E00005936","E00005936","Total",116,91,27,64,1,9,4,5,14,13,1,0,0,1
"2011","E00005937","E00005937","Total",116,90,27,63,0,9,3,6,17,16,0,1,0,0
"2011","E00005938","E00005938","Total",111,76,27,49,1,17,2,15,15,15,0,0,0,2
"2011","E00005939","E00005939","Total",124,65,13,52,2,34,26,8,23,22,0,1,0,0
"2011","E00005948","E00005948","Total",136,103,28,75,0,8,2,6,24,23,0,0,1,1
"2011","E00005951","E00005951","Total",108,80,20,60,1,10,6,4,17,14,0,3,0,0
"2011","E00005954","E00005954","Total",104,63,13,50,0,11,4,7,30,29,0,1,0,0
"2011","E00005957","E00005957","Total",90,64,17,47,2,10,5,5,14,13,0,1,0,0
"2011","E00005960","E00005960","Total",83,56,15,41,1,7,4,3,17,17,0,0,0,2
"2011","E00005964","E00005964","Total",103,78,24,54,0,9,4,5,16,14,2,0,0,0
"2011","E00004944","E00004944","Total",147,29,11,18,1,104,93,11,12,11,0,1,0,1
"2011","E00004945","E00004945","Total",115,56,13,43,2,49,43,6,8,7,0,1,0,0
"2011","E00004946","E00004946","Total",112,35,10,25,2,67,36,31,8,8,0,0,0,0
"2011","E00004953","E00004953","Total",145,46,13,33,0,83,75,8,13,11,0,2,0,3
"2011","E00165794","E00165794","Total",141,30,5,25,0,98,83,15,13,12,0,0,1,0
"2011","E00006314","E00006314","Total",190,89,32,57,3,12,3,9,84,84,0,0,0,2
"2011","E00006343","E00006343","Total",114,75,32,43,0,3,2,1,36,32,0,2,2,0
"2011","E00006345","E00006345","Total",109,84,29,55,0,4,4,0,21,20,0,1,0,0
"2011","E00006348","E00006348","Total",113,91,42,49,0,1,0,1,21,21,0,0,0,0
"2011","E00006349","E00006349","Total",120,79,40,39,1,5,1,4,35,31,0,4,0,0
"2011","E00006315","E00006315","Total",109,76,25,51,1,7,2,5,25,24,0,1,0,0
"2011","E00006316","E00006316","Total",124,88,41,47,0,1,1,0,34,34,0,0,0,1
"2011","E00006344","E00006344","Total",134,75,24,51,0,29,25,4,28,28,0,0,0,2
"2011","E00006346","E00006346","Total",96,58,19,39,0,3,0,3,34,33,0,1,0,1
"2011","E00006350","E00006350","Total",130,100,40,60,1,6,1,5,21,21,0,0,0,2
"2011","E00006521","E00006521","Total",120,75,36,39,2,6,3,3,37,36,1,0,0,0
"2011","E00006522","E00006522","Total",110,81,38,43,0,3,1,2,25,24,0,1,0,1
"2011","E00006540","E00006540","Total",150,117,42,75,0,7,5,2,24,23,0,1,0,2
"2011","E00006542","E00006542","Total",112,81,23,58,0,3,0,3,26,24,0,2,0,2
"2011","E00006543","E00006543","Total",122,98,41,57,1,3,3,0,20,18,0,2,0,0
"2011","E00006541","E00006541","Total",128,73,26,47,14,22,0,22,18,16,0,1,1,1
"2011","E00006545","E00006545","Total",151,72,22,50,12,21,9,12,44,39,0,5,0,2
"2011","E00006546","E00006546","Total",146,123,52,71,1,4,2,2,16,15,0,0,1,2
"2011","E00006548","E00006548","Total",125,84,31,53,0,5,3,2,35,35,0,0,0,1
"2011","E00006549","E00006549","Total",113,81,25,56,1,4,0,4,26,25,0,1,0,1
"2011","E00006518","E00006518","Total",134,48,16,32,1,55,38,17,25,25,0,0,0,5
"2011","E00006520","E00006520","Total",134,70,26,44,1,29,24,5,30,29,0,1,0,4
"2011","E00006550","E00006550","Total",126,71,23,48,3,36,24,12,16,16,0,0,0,0
"2011","E00006551","E00006551","Total",128,56,16,40,1,46,39,7,24,24,0,0,0,1
"2011","E00006554","E00006554","Total",141,49,12,37,0,67,54,13,25,23,0,2,0,0
"2011","E00006517","E00006517","Total",179,92,39,53,2,1,1,0,83,81,2,0,0,1
"2011","E00006530","E00006530","Total",111,88,40,48,1,2,1,1,18,18,0,0,0,2
"2011","E00006533","E00006533","Total",106,83,44,39,0,0,0,0,23,22,0,1,0,0
"2011","E00006535","E00006535","Total",116,76,37,39,15,2,1,1,23,22,0,1,0,0
"2011","E00006539","E00006539","Total",121,93,44,49,0,5,3,2,23,20,0,3,0,0
"2011","E00006531","E00006531","Total",118,95,56,39,1,0,0,0,20,18,0,1,1,2
"2011","E00006534","E00006534","Total",183,124,50,74,5,1,0,1,50,46,2,2,0,3
"2011","E00006536","E00006536","Total",125,103,63,40,0,0,0,0,21,19,1,1,0,1
"2011","E00006537","E00006537","Total",137,94,51,43,0,5,4,1,36,34,1,1,0,2
"2011","E00006538","E00006538","Total",116,91,52,39,1,1,1,0,23,23,0,0,0,0
"2011","E00006519","E00006519","Total",114,75,30,45,1,2,1,1,36,34,0,2,0,0
"2011","E00006523","E00006523","Total",134,96,61,35,0,1,1,0,36,34,0,2,0,1
"2011","E00006524","E00006524","Total",122,98,47,51,0,1,1,0,22,20,1,1,0,1
"2011","E00006544","E00006544","Total",106,49,26,23,0,1,1,0,55,51,0,3,1,1
"2011","E00006553","E00006553","Total",114,52,28,24,0,43,42,1,17,14,0,1,2,2
"2011","E00006525","E00006525","Total",122,85,41,44,0,4,3,1,33,32,0,1,0,0
"2011","E00006527","E00006527","Total",140,101,47,54,1,6,5,1,32,32,0,0,0,0
"2011","E00006529","E00006529","Total",120,85,42,43,3,5,3,2,27,25,0,2,0,0
"2011","E00006552","E00006552","Total",134,100,45,55,0,4,2,2,29,27,0,1,1,1
"2011","E00006526","E00006526","Total",130,95,37,58,0,3,2,1,32,31,0,0,1,0
"2011","E00006528","E00006528","Total",126,97,40,57,0,4,3,1,24,24,0,0,0,1
"2011","E00006532","E00006532","Total",114,91,42,49,1,0,0,0,22,21,0,0,1,0
"2011","E00006547","E00006547","Total",136,95,46,49,0,2,2,0,36,35,0,1,0,3
"2011","E00006563","E00006563","Total",125,103,34,69,0,7,4,3,15,14,0,1,0,0
"2011","E00006573","E00006573","Total",122,66,22,44,1,33,22,11,21,20,0,1,0,1
"2011","E00006574","E00006574","Total",121,84,19,65,12,10,3,7,15,15,0,0,0,0
"2011","E00006578","E00006578","Total",127,64,24,40,13,20,4,16,28,25,1,2,0,2
"2011","E00006561","E00006561","Total",107,56,21,35,0,28,25,3,23,22,0,1,0,0
"2011","E00006562","E00006562","Total",158,16,8,8,0,102,94,8,39,37,0,1,1,1
"2011","E00006564","E00006564","Total",108,50,19,31,0,40,38,2,17,15,0,2,0,1
"2011","E00006566","E00006566","Total",122,31,12,19,2,77,75,2,12,11,0,0,1,0
"2011","E00006568","E00006568","Total",125,65,34,31,2,25,21,4,31,31,0,0,0,2
"2011","E00006567","E00006567","Total",123,42,10,32,1,50,36,14,29,28,0,1,0,1
"2011","E00006569","E00006569","Total",125,68,25,43,0,39,38,1,16,14,0,2,0,2
"2011","E00006570","E00006570","Total",137,88,39,49,0,21,19,2,28,27,0,1,0,0
"2011","E00006572","E00006572","Total",119,63,20,43,9,26,22,4,21,21,0,0,0,0
"2011","E00006577","E00006577","Total",182,110,36,74,0,22,16,6,44,42,0,2,0,6
"2011","E00006565","E00006565","Total",148,42,13,29,0,85,65,20,18,17,0,0,1,3
"2011","E00006575","E00006575","Total",106,42,15,27,1,48,19,29,11,10,0,1,0,4
"2011","E00006576","E00006576","Total",131,89,35,54,3,22,21,1,14,13,0,1,0,3
"2011","E00006579","E00006579","Total",128,67,26,41,0,41,39,2,18,17,0,0,1,2
"2011","E00006580","E00006580","Total",164,35,14,21,14,88,53,35,24,21,0,1,2,3
"2011","E00006571","E00006571","Total",120,53,15,38,0,51,45,6,13,13,0,0,0,3
"2011","E00006585","E00006585","Total",122,50,19,31,0,57,51,6,13,13,0,0,0,2
"2011","E00006588","E00006588","Total",153,52,13,39,1,85,67,18,13,12,0,1,0,2
"2011","E00006590","E00006590","Total",139,25,6,19,0,96,16,80,18,15,0,2,1,0
"2011","E00006560","E00006560","Total",130,74,34,40,11,9,5,4,35,34,0,0,1,1
"2011","E00006584","E00006584","Total",217,107,44,63,16,61,15,46,29,29,0,0,0,4
"2011","E00006593","E00006593","Total",128,106,74,32,0,8,4,4,13,10,0,2,1,1
"2011","E00006594","E00006594","Total",140,111,62,49,1,3,3,0,25,25,0,0,0,0
"2011","E00006595","E00006595","Total",143,58,18,40,2,64,31,33,14,14,0,0,0,5
"2011","E00006317","E00006317","Total",121,91,32,59,1,8,2,6,21,21,0,0,0,0
"2011","E00006318","E00006318","Total",114,86,34,52,0,4,1,3,23,21,0,2,0,1
"2011","E00006320","E00006320","Total",98,77,32,45,0,5,2,3,13,12,0,1,0,3
"2011","E00006347","E00006347","Total",122,94,38,56,1,5,2,3,22,22,0,0,0,0
"2011","E00006351","E00006351","Total",110,79,31,48,3,2,1,1,25,24,0,1,0,1
"2011","E00006581","E00006581","Total",122,93,46,47,0,4,2,2,24,23,0,1,0,1
"2011","E00006582","E00006582","Total",131,77,22,55,3,24,8,16,26,25,0,1,0,1
"2011","E00006586","E00006586","Total",115,85,36,49,2,8,2,6,18,16,0,2,0,2
"2011","E00006587","E00006587","Total",122,97,45,52,0,6,3,3,19,19,0,0,0,0
"2011","E00006558","E00006558","Total",133,101,53,48,1,7,3,4,22,21,0,1,0,2
"2011","E00006583","E00006583","Total",121,76,27,49,0,15,12,3,28,26,0,2,0,2
"2011","E00006589","E00006589","Total",131,85,39,46,0,6,2,4,38,37,0,1,0,2
"2011","E00006592","E00006592","Total",119,73,34,39,1,4,2,2,36,35,0,1,0,5
"2011","E00006596","E00006596","Total",123,71,21,50,1,9,4,5,40,39,0,1,0,2
"2011","E00006555","E00006555","Total",135,66,31,35,0,8,6,2,59,56,2,1,0,2
"2011","E00006556","E00006556","Total",135,86,40,46,1,4,1,3,38,35,2,1,0,6
"2011","E00006557","E00006557","Total",153,70,27,43,0,10,0,10,70,65,1,3,1,3
"2011","E00006559","E00006559","Total",125,83,39,44,2,21,1,20,19,18,0,1,0,0
"2011","E00006591","E00006591","Total",136,86,41,45,0,5,2,3,44,39,1,4,0,1
"2011","E00006690","E00006690","Total",129,74,31,43,0,9,4,5,44,39,0,4,1,2
"2011","E00006696","E00006696","Total",125,77,35,42,0,2,2,0,45,44,0,1,0,1
"2011","E00006699","E00006699","Total",147,84,38,46,0,1,1,0,60,57,1,1,1,2
"2011","E00006704","E00006704","Total",128,84,45,39,2,4,0,4,36,34,0,1,1,2
"2011","E00006673","E00006673","Total",152,92,36,56,0,2,1,1,58,56,0,1,1,0
"2011","E00006687","E00006687","Total",113,79,30,49,0,4,3,1,30,29,0,1,0,0
"2011","E00006689","E00006689","Total",128,80,35,45,1,4,3,1,42,39,0,2,1,1
"2011","E00006691","E00006691","Total",134,90,39,51,0,2,0,2,41,37,0,3,1,1
"2011","E00006697","E00006697","Total",111,40,16,24,1,3,1,2,65,63,0,1,1,2
"2011","E00006688","E00006688","Total",132,96,46,50,0,4,2,2,32,30,0,2,0,0
"2011","E00006692","E00006692","Total",111,78,42,36,1,3,2,1,26,23,0,2,1,3
"2011","E00006693","E00006693","Total",107,80,44,36,1,3,0,3,23,19,0,4,0,0
"2011","E00006698","E00006698","Total",133,105,47,58,0,0,0,0,26,25,0,1,0,2
"2011","E00006701","E00006701","Total",135,101,45,56,1,3,2,1,30,26,0,3,1,0
"2011","E00006708","E00006708","Total",125,70,32,38,1,25,22,3,27,25,0,2,0,2
"2011","E00006709","E00006709","Total",110,69,27,42,3,7,5,2,30,29,0,1,0,1
"2011","E00006712","E00006712","Total",131,72,19,53,3,26,22,4,26,25,0,1,0,4
"2011","E00006322","E00006322","Total",132,62,24,38,0,2,2,0,66,64,0,2,0,2
"2011","E00006324","E00006324","Total",122,66,24,42,0,5,2,3,50,48,0,2,0,1
"2011","E00006327","E00006327","Total",121,76,27,49,2,4,1,3,39,39,0,0,0,0
"2011","E00006328","E00006328","Total",132,91,36,55,1,7,4,3,30,29,0,1,0,3
"2011","E00006329","E00006329","Total",120,37,10,27,1,57,52,5,23,23,0,0,0,2
"2011","E00006319","E00006319","Total",143,91,47,44,2,4,1,3,46,42,0,4,0,0
"2011","E00006330","E00006330","Total",132,98,47,51,0,2,0,2,28,27,0,1,0,4
"2011","E00006333","E00006333","Total",164,111,59,52,2,5,1,4,40,38,0,2,0,6
"2011","E00006336","E00006336","Total",139,112,49,63,0,3,0,3,22,22,0,0,0,2
"2011","E00006313","E00006313","Total",152,39,10,29,2,91,86,5,13,11,0,2,0,7
"2011","E00006331","E00006331","Total",124,51,15,36,4,49,37,12,19,15,0,4,0,1
"2011","E00006332","E00006332","Total",117,29,11,18,3,72,68,4,9,9,0,0,0,4
"2011","E00006335","E00006335","Total",151,73,21,52,1,26,11,15,49,46,1,2,0,2
"2011","E00006339","E00006339","Total",139,85,31,54,2,4,1,3,47,45,0,1,1,1
"2011","E00006341","E00006341","Total",131,77,35,42,1,10,6,4,41,39,0,2,0,2
"2011","E00006321","E00006321","Total",122,66,23,43,0,4,1,3,50,50,0,0,0,2
"2011","E00006323","E00006323","Total",135,60,29,31,7,16,2,14,52,50,1,0,1,0
"2011","E00006325","E00006325","Total",147,112,58,54,1,6,5,1,27,27,0,0,0,1
"2011","E00006326","E00006326","Total",138,78,36,42,0,4,1,3,53,51,0,2,0,3
"2011","E00006675","E00006675","Total",143,105,48,57,2,12,10,2,24,23,0,1,0,0
"2011","E00006679","E00006679","Total",118,46,27,19,0,55,7,48,17,16,0,1,0,0
"2011","E00006683","E00006683","Total",131,96,47,49,0,9,7,2,25,24,1,0,0,1
"2011","E00006686","E00006686","Total",115,13,4,9,0,87,24,63,13,10,0,3,0,2
"2011","E00006694","E00006694","Total",129,63,29,34,1,35,33,2,27,25,0,2,0,3
"2011","E00006695","E00006695","Total",148,90,49,41,2,4,1,3,51,47,0,4,0,1
"2011","E00006702","E00006702","Total",128,83,36,47,3,4,2,2,37,31,0,6,0,1
"2011","E00006707","E00006707","Total",131,102,51,51,0,2,0,2,23,23,0,0,0,4
"2011","E00166857","E00166857","Total",233,108,28,80,8,45,18,27,72,72,0,0,0,0
"2011","E00166858","E00166858","Total",111,42,15,27,1,40,11,29,25,24,0,1,0,3
"2011","E00006677","E00006677","Total",125,79,34,45,1,5,3,2,37,36,0,1,0,3
"2011","E00006703","E00006703","Total",139,109,44,65,1,3,2,1,24,23,0,1,0,2
"2011","E00006705","E00006705","Total",118,96,37,59,2,2,2,0,18,17,1,0,0,0
"2011","E00006706","E00006706","Total",129,92,49,43,1,3,1,2,30,28,0,2,0,3
"2011","E00006710","E00006710","Total",123,93,41,52,0,4,2,2,25,25,0,0,0,1
"2011","E00006676","E00006676","Total",120,74,39,35,1,5,5,0,35,29,2,2,2,5
"2011","E00006678","E00006678","Total",120,78,35,43,1,5,3,2,33,32,0,1,0,3
"2011","E00006681","E00006681","Total",145,110,56,54,0,3,1,2,30,27,1,2,0,2
"2011","E00006684","E00006684","Total",133,99,42,57,1,2,1,1,28,27,0,1,0,3
"2011","E00006674","E00006674","Total",135,62,20,42,6,14,3,11,52,49,0,3,0,1
"2011","E00006680","E00006680","Total",119,72,44,28,0,1,1,0,43,38,2,3,0,3
"2011","E00006682","E00006682","Total",124,73,36,37,3,3,2,1,40,36,0,4,0,5
"2011","E00006685","E00006685","Total",111,52,24,28,1,4,1,3,54,53,0,1,0,0
"2011","E00006711","E00006711","Total",137,101,50,51,0,4,3,1,29,28,0,0,1,3
"2011","E00006282","E00006282","Total",115,36,16,20,0,66,61,5,12,11,0,0,1,1
"2011","E00006283","E00006283","Total",122,33,12,21,1,74,73,1,11,11,0,0,0,3
"2011","E00006286","E00006286","Total",120,46,11,35,1,65,57,8,7,6,0,1,0,1
"2011","E00006292","E00006292","Total",139,20,3,17,1,85,50,35,31,30,0,0,1,2
"2011","E00006294","E00006294","Total",163,38,9,29,0,95,24,71,28,27,0,1,0,2
"2011","E00006598","E00006598","Total",137,63,21,42,1,21,9,12,51,49,0,2,0,1
"2011","E00006605","E00006605","Total",130,80,44,36,0,15,3,12,34,34,0,0,0,1
"2011","E00006606","E00006606","Total",130,55,21,34,9,12,5,7,52,51,0,1,0,2
"2011","E00006608","E00006608","Total",136,44,7,37,19,23,12,11,50,49,0,0,1,0
"2011","E00006609","E00006609","Total",129,56,17,39,2,28,14,14,42,42,0,0,0,1
"2011","E00006599","E00006599","Total",130,65,21,44,2,38,35,3,21,20,0,0,1,4
"2011","E00006600","E00006600","Total",142,56,20,36,3,48,10,38,34,32,0,2,0,1
"2011","E00006602","E00006602","Total",132,77,27,50,2,37,33,4,15,15,0,0,0,1
"2011","E00006603","E00006603","Total",126,57,27,30,7,21,6,15,39,38,0,0,1,2
"2011","E00006604","E00006604","Total",144,31,8,23,2,93,53,40,17,16,0,1,0,1
"2011","E00006597","E00006597","Total",138,57,13,44,3,40,11,29,37,36,0,1,0,1
"2011","E00006616","E00006616","Total",121,4,1,3,0,103,99,4,10,10,0,0,0,4
"2011","E00006631","E00006631","Total",117,26,5,21,1,79,58,21,8,8,0,0,0,3
"2011","E00006638","E00006638","Total",139,60,14,46,1,60,53,7,17,17,0,0,0,1
"2011","E00006639","E00006639","Total",121,52,19,33,0,35,27,8,34,33,0,1,0,0
"2011","E00006634","E00006634","Total",189,39,16,23,23,102,25,77,20,17,1,2,0,5
"2011","E00006636","E00006636","Total",134,60,12,48,3,27,21,6,43,43,0,0,0,1
"2011","E00006637","E00006637","Total",132,53,14,39,0,46,26,20,28,26,0,0,2,5
"2011","E00006640","E00006640","Total",124,16,2,14,1,95,79,16,9,8,0,0,1,3
"2011","E00006601","E00006601","Total",118,79,27,52,0,28,24,4,7,6,1,0,0,4
"2011","E00006618","E00006618","Total",134,74,30,44,0,45,36,9,13,12,0,0,1,2
"2011","E00006623","E00006623","Total",123,53,16,37,0,53,50,3,15,12,0,3,0,2
"2011","E00006624","E00006624","Total",123,73,26,47,1,41,37,4,8,7,0,1,0,0
"2011","E00006627","E00006627","Total",104,82,34,48,1,9,8,1,9,8,0,0,1,3
"2011","E00006607","E00006607","Total",117,56,16,40,0,43,37,6,15,15,0,0,0,3
"2011","E00006610","E00006610","Total",125,67,26,41,4,37,32,5,14,14,0,0,0,3
"2011","E00006614","E00006614","Total",116,50,23,27,1,49,43,6,15,14,0,1,0,1
"2011","E00006619","E00006619","Total",120,82,40,42,1,10,5,5,26,26,0,0,0,1
"2011","E00006625","E00006625","Total",122,66,24,42,2,26,17,9,27,27,0,0,0,1
"2011","E00006611","E00006611","Total",127,104,50,54,1,5,2,3,15,15,0,0,0,2
"2011","E00006612","E00006612","Total",124,79,39,40,1,16,10,6,27,25,0,2,0,1
"2011","E00006615","E00006615","Total",110,11,3,8,0,71,66,5,27,24,0,2,1,1
"2011","E00006617","E00006617","Total",132,29,6,23,2,78,70,8,15,14,0,0,1,8
"2011","E00006620","E00006620","Total",127,33,14,19,0,69,63,6,23,20,0,3,0,2
"2011","E00006613","E00006613","Total",125,60,26,34,0,30,26,4,31,27,0,4,0,4
"2011","E00006621","E00006621","Total",129,67,26,41,2,40,35,5,20,19,0,1,0,0
"2011","E00006622","E00006622","Total",123,46,14,32,2,56,53,3,18,18,0,0,0,1
"2011","E00006626","E00006626","Total",126,93,46,47,1,11,4,7,21,21,0,0,0,0
"2011","E00006630","E00006630","Total",128,84,31,53,0,13,12,1,29,29,0,0,0,2
"2011","E00006628","E00006628","Total",125,51,4,47,3,17,10,7,52,52,0,0,0,2
"2011","E00006629","E00006629","Total",121,31,8,23,0,65,59,6,24,24,0,0,0,1
"2011","E00006632","E00006632","Total",123,45,15,30,0,51,48,3,23,21,0,1,1,4
"2011","E00006633","E00006633","Total",125,15,7,8,0,92,90,2,17,16,0,0,1,1
"2011","E00006635","E00006635","Total",124,35,12,23,0,60,50,10,27,27,0,0,0,2
"2011","E00006279","E00006279","Total",113,97,51,46,0,3,2,1,12,12,0,0,0,1
"2011","E00006285","E00006285","Total",123,102,51,51,1,6,3,3,14,11,0,3,0,0
"2011","E00006290","E00006290","Total",135,87,17,70,1,9,4,5,38,37,0,1,0,0
"2011","E00006296","E00006296","Total",130,65,29,36,4,13,5,8,47,45,0,1,1,1
"2011","E00006301","E00006301","Total",133,70,32,38,2,38,34,4,21,19,0,2,0,2
"2011","E00006273","E00006273","Total",143,52,15,37,2,73,67,6,14,14,0,0,0,2
"2011","E00006275","E00006275","Total",143,76,26,50,0,46,40,6,21,21,0,0,0,0
"2011","E00006280","E00006280","Total",130,88,36,52,0,25,16,9,17,16,0,1,0,0
"2011","E00006289","E00006289","Total",142,67,24,43,2,42,33,9,25,20,0,5,0,6
"2011","E00006271","E00006271","Total",143,76,25,51,2,35,25,10,30,28,0,2,0,0
"2011","E00006272","E00006272","Total",143,69,27,42,0,47,20,27,25,24,0,1,0,2
"2011","E00006274","E00006274","Total",116,60,16,44,0,41,17,24,15,14,0,1,0,0
"2011","E00006276","E00006276","Total",121,62,28,34,0,21,7,14,38,34,0,3,1,0
"2011","E00006281","E00006281","Total",124,33,7,26,0,76,74,2,13,13,0,0,0,2
"2011","E00006277","E00006277","Total",132,86,34,52,0,28,25,3,18,17,0,1,0,0
"2011","E00006278","E00006278","Total",116,38,12,26,0,63,59,4,15,14,1,0,0,0
"2011","E00006284","E00006284","Total",114,84,52,32,1,13,10,3,16,14,0,2,0,0
"2011","E00006291","E00006291","Total",120,95,60,35,1,6,3,3,16,15,0,1,0,2
"2011","E00006312","E00006312","Total",130,77,14,63,3,22,12,10,28,26,0,2,0,0
"2011","E00166847","E00166847","Total",195,59,7,52,32,46,6,40,55,54,0,1,0,3
"2011","E00166848","E00166848","Total",282,84,15,69,4,12,8,4,181,179,0,1,1,1
"2011","E00166849","E00166849","Total",175,46,6,40,61,28,1,27,37,34,0,1,2,3
"2011","E00166865","E00166865","Total",166,10,1,9,1,130,10,120,21,21,0,0,0,4
"2011","E00006270","E00006270","Total",130,78,17,61,2,4,1,3,46,43,0,2,1,0
"2011","E00006287","E00006287","Total",136,78,30,48,1,32,27,5,18,18,0,0,0,7
"2011","E00006288","E00006288","Total",118,34,12,22,0,30,26,4,51,48,0,2,1,3
"2011","E00006295","E00006295","Total",102,21,9,12,4,23,19,4,51,49,0,1,1,3
"2011","E00006368","E00006368","Total",122,63,29,34,1,3,0,3,55,53,0,1,1,0
"2011","E00006369","E00006369","Total",119,52,21,31,2,3,0,3,61,58,0,2,1,1
"2011","E00006370","E00006370","Total",142,81,48,33,1,2,2,0,55,52,0,2,1,3
"2011","E00006372","E00006372","Total",132,78,40,38,2,7,1,6,42,41,0,1,0,3
"2011","E00006373","E00006373","Total",136,60,15,45,1,1,1,0,73,72,0,1,0,1
"2011","E00006358","E00006358","Total",119,74,37,37,0,1,1,0,40,39,0,1,0,4
"2011","E00006371","E00006371","Total",104,25,12,13,1,11,1,10,63,62,0,1,0,4
"2011","E00006374","E00006374","Total",149,73,45,28,3,6,2,4,66,63,0,3,0,1
"2011","E00006375","E00006375","Total",142,63,36,27,0,7,2,5,69,63,1,5,0,3
"2011","E00006379","E00006379","Total",154,90,54,36,0,2,1,1,55,54,0,1,0,7
"2011","E00006353","E00006353","Total",112,79,51,28,0,3,2,1,29,28,1,0,0,1
"2011","E00006376","E00006376","Total",127,73,40,33,2,2,0,2,49,49,0,0,0,1
"2011","E00006383","E00006383","Total",139,30,17,13,0,18,12,6,89,86,0,2,1,2
"2011","E00006385","E00006385","Total",160,53,24,29,6,7,1,6,94,88,1,3,2,0
"2011","E00006386","E00006386","Total",117,35,15,20,7,6,3,3,65,62,0,3,0,4
"2011","E00006387","E00006387","Total",146,85,55,30,0,5,4,1,53,52,0,1,0,3
"2011","E00006354","E00006354","Total",127,65,36,29,2,6,1,5,53,52,0,1,0,1
"2011","E00006355","E00006355","Total",129,72,33,39,0,0,0,0,57,56,0,1,0,0
"2011","E00006382","E00006382","Total",114,44,16,28,29,4,0,4,36,34,0,2,0,1
"2011","E00006389","E00006389","Total",155,98,61,37,2,0,0,0,52,50,0,2,0,3
"2011","E00006390","E00006390","Total",129,39,22,17,27,9,3,6,54,51,0,3,0,0
"2011","E00006392","E00006392","Total",128,55,37,18,0,1,1,0,66,66,0,0,0,6
"2011","E00006058","E00006058","Total",143,80,39,41,0,6,3,3,55,53,1,1,0,2
"2011","E00006062","E00006062","Total",135,87,47,40,2,5,4,1,40,39,0,1,0,1
"2011","E00006064","E00006064","Total",81,34,16,18,1,16,3,13,28,28,0,0,0,2
"2011","E00006072","E00006072","Total",172,22,10,12,0,124,122,2,20,19,0,1,0,6
"2011","E00006073","E00006073","Total",161,30,12,18,1,112,68,44,15,13,0,2,0,3
"2011","E00006293","E00006293","Total",118,80,28,52,2,6,4,2,29,29,0,0,0,1
"2011","E00006298","E00006298","Total",144,83,32,51,3,10,5,5,46,45,0,0,1,2
"2011","E00006299","E00006299","Total",134,104,54,50,0,2,0,2,27,27,0,0,0,1
"2011","E00006302","E00006302","Total",123,68,31,37,1,20,20,0,32,31,0,1,0,2
"2011","E00006303","E00006303","Total",141,92,54,38,1,5,4,1,42,38,0,4,0,1
"2011","E00006300","E00006300","Total",138,103,55,48,1,11,10,1,23,20,0,1,2,0
"2011","E00006309","E00006309","Total",104,36,21,15,1,25,17,8,38,37,0,1,0,4
"2011","E00006310","E00006310","Total",116,59,24,35,2,28,25,3,20,17,0,3,0,7
"2011","E00006311","E00006311","Total",121,65,35,30,0,33,30,3,23,23,0,0,0,0
"2011","E00166861","E00166861","Total",110,9,3,6,2,2,0,2,95,91,0,3,1,2
"2011","E00166862","E00166862","Total",169,23,5,18,64,15,3,12,64,61,1,2,0,3
"2011","E00006334","E00006334","Total",125,112,69,43,0,1,1,0,11,10,0,1,0,1
"2011","E00006337","E00006337","Total",120,82,24,58,1,9,8,1,25,25,0,0,0,3
"2011","E00006338","E00006338","Total",134,113,58,55,0,0,0,0,20,19,0,0,1,1
"2011","E00006340","E00006340","Total",120,102,57,45,0,1,0,1,15,13,0,2,0,2
"2011","E00006342","E00006342","Total",130,86,42,44,0,7,1,6,34,33,1,0,0,3
"2011","E00006015","E00006015","Total",141,95,44,51,0,1,0,1,43,43,0,0,0,2
"2011","E00006041","E00006041","Total",130,111,59,52,0,2,0,2,17,16,0,1,0,0
"2011","E00006044","E00006044","Total",126,113,46,67,0,1,0,1,11,11,0,0,0,1
"2011","E00006045","E00006045","Total",124,75,32,43,0,2,2,0,43,39,1,1,2,4
"2011","E00006047","E00006047","Total",126,117,44,73,0,1,0,1,8,8,0,0,0,0
"2011","E00006013","E00006013","Total",136,88,43,45,0,4,2,2,43,43,0,0,0,1
"2011","E00006014","E00006014","Total",158,72,32,40,16,52,49,3,17,17,0,0,0,1
"2011","E00006019","E00006019","Total",139,65,31,34,1,6,1,5,67,66,0,1,0,0
"2011","E00006020","E00006020","Total",127,62,29,33,11,1,0,1,52,52,0,0,0,1
"2011","E00006055","E00006055","Total",145,97,50,47,2,16,15,1,29,29,0,0,0,1
"2011","E00006352","E00006352","Total",116,95,59,36,1,0,0,0,20,20,0,0,0,0
"2011","E00006378","E00006378","Total",101,83,47,36,0,1,0,1,16,15,0,1,0,1
"2011","E00006380","E00006380","Total",105,91,54,37,0,4,0,4,10,10,0,0,0,0
"2011","E00006381","E00006381","Total",114,93,47,46,0,2,1,1,19,18,0,0,1,0
"2011","E00006388","E00006388","Total",128,112,73,39,0,0,0,0,14,14,0,0,0,2
"2011","E00006377","E00006377","Total",132,115,61,54,0,2,2,0,15,13,0,2,0,0
"2011","E00006384","E00006384","Total",123,97,41,56,0,1,1,0,24,23,0,1,0,1
"2011","E00006391","E00006391","Total",119,104,44,60,1,2,1,1,12,11,0,1,0,0
"2011","E00006393","E00006393","Total",125,77,48,29,0,4,2,2,42,42,0,0,0,2
"2011","E00006394","E00006394","Total",126,82,46,36,0,2,1,1,39,38,0,1,0,3
"2011","E00006057","E00006057","Total",114,81,40,41,0,3,2,1,30,30,0,0,0,0
"2011","E00006059","E00006059","Total",126,101,39,62,0,4,1,3,17,17,0,0,0,4
"2011","E00006060","E00006060","Total",98,72,27,45,0,5,3,2,21,21,0,0,0,0
"2011","E00006061","E00006061","Total",117,96,48,48,3,1,0,1,16,13,0,2,1,1
"2011","E00006304","E00006304","Total",132,86,35,51,5,5,2,3,34,32,0,1,1,2
"2011","E00006305","E00006305","Total",136,86,37,49,0,6,2,4,41,40,0,1,0,3
"2011","E00006307","E00006307","Total",114,86,42,44,0,12,9,3,14,13,0,1,0,2
"2011","E00006308","E00006308","Total",128,67,30,37,4,6,1,5,51,50,0,0,1,0
"2011","E00006444","E00006444","Total",133,93,41,52,2,10,4,6,27,27,0,0,0,1
"2011","E00006465","E00006465","Total",123,84,33,51,2,10,1,9,27,26,0,1,0,0
"2011","E00006466","E00006466","Total",119,79,35,44,1,6,3,3,32,28,0,3,1,1
"2011","E00006467","E00006467","Total",120,89,31,58,0,3,1,2,25,24,0,1,0,3
"2011","E00006443","E00006443","Total",115,78,33,45,0,4,3,1,28,27,0,1,0,5
"2011","E00006447","E00006447","Total",131,103,53,50,0,6,2,4,22,21,0,1,0,0
"2011","E00006468","E00006468","Total",116,97,48,49,2,1,0,1,16,13,0,3,0,0
"2011","E00006469","E00006469","Total",142,97,53,44,2,2,0,2,37,34,0,3,0,4
"2011","E00006446","E00006446","Total",128,86,37,49,2,8,2,6,31,30,0,1,0,1
"2011","E00006450","E00006450","Total",117,65,33,32,0,10,8,2,41,39,0,2,0,1
"2011","E00006470","E00006470","Total",115,88,30,58,0,7,3,4,18,15,0,3,0,2
"2011","E00006473","E00006473","Total",118,79,33,46,0,14,2,12,23,22,0,1,0,2
"2011","E00005975","E00005975","Total",129,54,27,27,1,14,1,13,60,58,1,1,0,0
"2011","E00005978","E00005978","Total",160,19,12,7,0,114,5,109,11,10,0,0,1,16
"2011","E00005980","E00005980","Total",139,59,33,26,1,52,5,47,25,23,0,1,1,2
"2011","E00005981","E00005981","Total",144,12,7,5,3,105,10,95,22,21,0,0,1,2
"2011","E00005982","E00005982","Total",190,94,63,31,10,14,9,5,69,66,0,3,0,3
"2011","E00006182","E00006182","Total",115,30,10,20,14,22,2,20,47,47,0,0,0,2
"2011","E00006183","E00006183","Total",163,39,10,29,11,5,0,5,108,104,1,2,1,0
"2011","E00006200","E00006200","Total",125,33,12,21,10,52,22,30,26,24,0,1,1,4
"2011","E00006205","E00006205","Total",178,44,10,34,8,31,6,25,93,93,0,0,0,2
"2011","E00006210","E00006210","Total",125,53,20,33,1,25,15,10,44,43,0,0,1,2
"2011","E00166856","E00166856","Total",471,56,21,35,106,69,21,48,235,229,0,1,5,5
"2011","E00166867","E00166867","Total",59,11,5,6,4,33,10,23,9,8,0,1,0,2
"2011","E00006195","E00006195","Total",152,39,8,31,15,41,4,37,56,55,0,0,1,1
"2011","E00006197","E00006197","Total",156,84,47,37,1,16,2,14,53,53,0,0,0,2
"2011","E00006201","E00006201","Total",117,13,4,9,18,69,24,45,16,15,0,0,1,1
"2011","E00006203","E00006203","Total",128,29,14,15,6,57,5,52,31,31,0,0,0,5
"2011","E00006190","E00006190","Total",126,60,19,41,1,20,9,11,45,41,0,3,1,0
"2011","E00006191","E00006191","Total",120,53,29,24,0,28,3,25,39,38,0,1,0,0
"2011","E00006192","E00006192","Total",128,52,24,28,2,51,3,48,23,22,0,0,1,0
"2011","E00006193","E00006193","Total",118,59,16,43,2,14,10,4,43,42,0,1,0,0
"2011","E00006181","E00006181","Total",160,75,41,34,2,11,7,4,68,64,0,3,1,4
"2011","E00006194","E00006194","Total",135,21,10,11,1,31,27,4,80,80,0,0,0,2
"2011","E00006198","E00006198","Total",146,77,46,31,1,10,3,7,57,55,0,2,0,1
"2011","E00006199","E00006199","Total",127,72,50,22,0,1,0,1,48,45,1,2,0,6
"2011","E00006202","E00006202","Total",106,79,44,35,1,3,2,1,23,21,1,0,1,0
"2011","E00006016","E00006016","Total",100,6,1,5,0,79,73,6,5,5,0,0,0,10
"2011","E00006042","E00006042","Total",112,93,49,44,0,6,3,3,11,11,0,0,0,2
"2011","E00006043","E00006043","Total",93,6,5,1,1,68,62,6,13,13,0,0,0,5
"2011","E00006046","E00006046","Total",179,52,19,33,12,71,49,22,41,38,0,1,2,3
"2011","E00006048","E00006048","Total",133,17,7,10,0,93,86,7,22,22,0,0,0,1
"2011","E00006051","E00006051","Total",123,17,8,9,0,93,80,13,9,9,0,0,0,4
"2011","E00006401","E00006401","Total",139,37,21,16,2,73,62,11,19,17,0,0,2,8
"2011","E00006426","E00006426","Total",116,64,19,45,1,35,34,1,15,14,0,1,0,1
"2011","E00006429","E00006429","Total",131,53,11,42,2,59,56,3,15,15,0,0,0,2
"2011","E00006431","E00006431","Total",118,57,19,38,2,46,43,3,12,10,0,2,0,1
"2011","E00006437","E00006437","Total",123,28,8,20,0,78,74,4,10,10,0,0,0,7
"2011","E00006428","E00006428","Total",101,44,21,23,1,46,43,3,10,10,0,0,0,0
"2011","E00006430","E00006430","Total",114,33,14,19,0,66,39,27,13,13,0,0,0,2
"2011","E00006432","E00006432","Total",133,59,20,39,0,60,53,7,13,13,0,0,0,1
"2011","E00006434","E00006434","Total",125,94,45,49,0,11,8,3,19,19,0,0,0,1
"2011","E00006435","E00006435","Total",110,20,11,9,0,78,71,7,9,7,0,2,0,3
"2011","E00006436","E00006436","Total",129,46,17,29,1,58,52,6,22,20,0,0,2,2
"2011","E00006400","E00006400","Total",100,71,23,48,0,20,20,0,9,8,0,1,0,0
"2011","E00006402","E00006402","Total",113,59,26,33,0,35,25,10,18,18,0,0,0,1
"2011","E00006411","E00006411","Total",115,76,34,42,3,9,6,3,26,25,0,1,0,1
"2011","E00006440","E00006440","Total",122,49,24,25,0,47,41,6,25,23,0,1,1,1
"2011","E00006442","E00006442","Total",112,65,17,48,2,30,30,0,15,15,0,0,0,0
"2011","E00006406","E00006406","Total",110,63,30,33,0,32,27,5,14,13,0,1,0,1
"2011","E00006409","E00006409","Total",133,67,28,39,1,42,39,3,22,17,0,5,0,1
"2011","E00006412","E00006412","Total",115,74,18,56,3,14,6,8,23,22,0,1,0,1
"2011","E00006416","E00006416","Total",128,74,24,50,0,28,21,7,26,26,0,0,0,0
"2011","E00006439","E00006439","Total",134,73,28,45,0,38,34,4,22,22,0,0,0,1
"2011","E00006403","E00006403","Total",138,102,56,46,0,11,7,4,25,24,0,1,0,0
"2011","E00006405","E00006405","Total",116,59,19,40,0,37,35,2,17,17,0,0,0,3
"2011","E00006407","E00006407","Total",114,10,5,5,0,95,90,5,9,8,0,1,0,0
"2011","E00006408","E00006408","Total",115,15,3,12,0,83,79,4,13,13,0,0,0,4
"2011","E00006445","E00006445","Total",129,97,43,54,0,4,2,2,27,25,0,2,0,1
"2011","E00006449","E00006449","Total",141,101,51,50,4,8,6,2,24,22,0,2,0,4
"2011","E00006453","E00006453","Total",123,90,44,46,1,4,3,1,26,23,0,3,0,2
"2011","E00006471","E00006471","Total",145,94,34,60,0,8,4,4,42,41,0,1,0,1
"2011","E00006448","E00006448","Total",136,109,55,54,0,1,1,0,23,22,0,1,0,3
"2011","E00006451","E00006451","Total",116,93,43,50,0,3,1,2,20,16,0,3,1,0
"2011","E00006452","E00006452","Total",124,97,43,54,0,3,3,0,20,19,0,1,0,4
"2011","E00006472","E00006472","Total",145,98,37,61,1,10,5,5,34,32,0,1,1,2
"2011","E00006455","E00006455","Total",142,110,49,61,0,9,7,2,23,21,0,2,0,0
"2011","E00006456","E00006456","Total",128,85,32,53,2,19,16,3,21,19,0,2,0,1
"2011","E00006458","E00006458","Total",134,87,46,41,1,22,21,1,21,20,0,1,0,3
"2011","E00006454","E00006454","Total",122,73,36,37,0,17,14,3,31,30,0,1,0,1
"2011","E00006457","E00006457","Total",147,117,63,54,1,6,6,0,23,20,0,2,1,0
"2011","E00006459","E00006459","Total",106,56,29,27,0,5,4,1,45,43,0,2,0,0
"2011","E00006462","E00006462","Total",120,71,35,36,0,23,14,9,24,23,0,0,1,2
"2011","E00006460","E00006460","Total",141,94,43,51,0,18,16,2,24,23,1,0,0,5
"2011","E00006463","E00006463","Total",134,94,51,43,0,11,6,5,25,20,0,5,0,4
"2011","E00006464","E00006464","Total",119,68,34,34,0,15,11,4,33,31,0,2,0,3
"2011","E00166859","E00166859","Total",65,31,15,16,0,17,13,4,14,12,0,2,0,3
"2011","E00166860","E00166860","Total",70,48,32,16,0,4,1,3,17,17,0,0,0,1
"2011","E00006022","E00006022","Total",110,51,27,24,0,24,2,22,35,34,0,1,0,0
"2011","E00006023","E00006023","Total",122,99,45,54,2,6,4,2,14,14,0,0,0,1
"2011","E00006028","E00006028","Total",129,58,22,36,1,35,34,1,32,32,0,0,0,3
"2011","E00006032","E00006032","Total",122,106,48,58,0,5,4,1,11,11,0,0,0,0
"2011","E00006033","E00006033","Total",102,84,43,41,0,5,2,3,13,11,0,2,0,0
"2011","E00006012","E00006012","Total",123,12,6,6,0,97,15,82,13,11,0,0,2,1
"2011","E00006030","E00006030","Total",120,82,30,52,1,3,2,1,34,31,1,2,0,0
"2011","E00006034","E00006034","Total",124,90,36,54,0,8,3,5,26,24,0,2,0,0
"2011","E00006035","E00006035","Total",106,52,26,26,1,27,24,3,25,25,0,0,0,1
"2011","E00006038","E00006038","Total",125,4,2,2,0,56,3,53,60,59,0,0,1,5
"2011","E00006018","E00006018","Total",103,14,5,9,0,78,73,5,8,7,0,1,0,3
"2011","E00006024","E00006024","Total",130,83,33,50,0,5,3,2,40,39,0,1,0,2
"2011","E00006027","E00006027","Total",114,8,4,4,1,89,82,7,15,15,0,0,0,1
"2011","E00006029","E00006029","Total",120,14,5,9,1,91,83,8,10,10,0,0,0,4
"2011","E00006031","E00006031","Total",115,16,6,10,0,87,82,5,9,9,0,0,0,3
"2011","E00006011","E00006011","Total",119,65,31,34,0,14,2,12,39,39,0,0,0,1
"2011","E00006036","E00006036","Total",145,35,12,23,0,19,3,16,90,88,2,0,0,1
"2011","E00006037","E00006037","Total",143,83,31,52,8,16,1,15,33,32,0,1,0,3
"2011","E00006039","E00006039","Total",116,88,22,66,0,7,3,4,20,20,0,0,0,1
"2011","E00006040","E00006040","Total",145,93,37,56,0,9,3,6,40,40,0,0,0,3
"2011","E00006017","E00006017","Total",134,125,71,54,1,1,0,1,6,6,0,0,0,1
"2011","E00006049","E00006049","Total",132,86,34,52,2,25,21,4,19,18,0,1,0,0
"2011","E00006050","E00006050","Total",112,98,44,54,0,1,1,0,12,11,0,1,0,1
"2011","E00006053","E00006053","Total",120,104,55,49,1,2,1,1,10,10,0,0,0,3
"2011","E00006021","E00006021","Total",109,68,30,38,0,11,0,11,29,29,0,0,0,1
"2011","E00006025","E00006025","Total",117,63,40,23,0,1,0,1,51,51,0,0,0,2
"2011","E00006026","E00006026","Total",121,92,62,30,1,4,1,3,23,22,0,1,0,1
"2011","E00006052","E00006052","Total",108,73,43,30,1,2,2,0,30,28,0,2,0,2
"2011","E00006054","E00006054","Total",136,88,50,38,0,3,0,3,45,44,0,1,0,0
"2011","E00006056","E00006056","Total",100,79,41,38,0,2,1,1,18,17,0,1,0,1
"2011","E00006121","E00006121","Total",97,20,4,16,0,13,1,12,64,63,0,1,0,0
"2011","E00006128","E00006128","Total",92,38,14,24,1,7,3,4,45,43,0,1,1,1
"2011","E00006129","E00006129","Total",209,85,39,46,4,8,4,4,111,110,1,0,0,1
"2011","E00006130","E00006130","Total",247,74,24,50,18,42,6,36,107,106,0,1,0,6
"2011","E00006131","E00006131","Total",111,26,6,20,1,18,2,16,65,65,0,0,0,1
"2011","E00006134","E00006134","Total",129,47,16,31,1,13,12,1,67,65,0,1,1,1
"2011","E00166845","E00166845","Total",132,33,11,22,1,12,0,12,83,81,0,2,0,3
"2011","E00166850","E00166850","Total",133,11,5,6,41,36,4,32,44,43,1,0,0,1
"2011","E00006097","E00006097","Total",117,88,41,47,0,7,4,3,22,22,0,0,0,0
"2011","E00006102","E00006102","Total",133,95,55,40,0,6,6,0,28,28,0,0,0,4
"2011","E00006106","E00006106","Total",101,64,31,33,0,5,0,5,30,30,0,0,0,2
"2011","E00006110","E00006110","Total",111,82,53,29,1,3,1,2,24,24,0,0,0,1
"2011","E00006111","E00006111","Total",108,79,36,43,2,5,1,4,22,20,0,2,0,0
"2011","E00006093","E00006093","Total",150,70,38,32,1,9,2,7,64,61,1,1,1,6
"2011","E00006094","E00006094","Total",153,66,39,27,0,11,1,10,75,73,0,2,0,1
"2011","E00006101","E00006101","Total",113,50,22,28,0,7,0,7,52,49,3,0,0,4
"2011","E00006107","E00006107","Total",127,81,57,24,0,0,0,0,44,44,0,0,0,2
"2011","E00006135","E00006135","Total",125,39,20,19,0,34,0,34,52,50,0,2,0,0
"2011","E00006109","E00006109","Total",122,89,51,38,0,2,1,1,28,27,0,0,1,3
"2011","E00006112","E00006112","Total",119,80,38,42,0,13,1,12,26,24,0,2,0,0
"2011","E00006114","E00006114","Total",120,65,35,30,5,5,1,4,45,44,0,0,1,0
"2011","E00006118","E00006118","Total",114,74,39,35,2,6,2,4,31,29,0,0,2,1
"2011","E00006119","E00006119","Total",127,67,31,36,1,16,0,16,40,39,0,0,1,3
"2011","E00006099","E00006099","Total",105,47,25,22,3,2,1,1,53,52,0,0,1,0
"2011","E00006115","E00006115","Total",188,61,36,25,2,22,5,17,101,98,0,2,1,2
"2011","E00006116","E00006116","Total",110,60,35,25,0,13,3,10,35,31,0,4,0,2
"2011","E00006120","E00006120","Total",89,56,30,26,0,4,0,4,29,28,0,0,1,0
"2011","E00006123","E00006123","Total",137,53,32,21,1,23,2,21,56,55,0,1,0,4
"2011","E00006125","E00006125","Total",163,77,44,33,2,7,2,5,76,72,1,3,0,1
"2011","E00006100","E00006100","Total",163,50,18,32,2,40,15,25,69,68,0,1,0,2
"2011","E00006124","E00006124","Total",153,57,32,25,1,4,2,2,91,89,1,1,0,0
"2011","E00006126","E00006126","Total",213,37,12,25,0,4,0,4,170,165,2,2,1,2
"2011","E00006127","E00006127","Total",144,31,12,19,10,27,5,22,71,70,0,1,0,5
"2011","E00006132","E00006132","Total",117,27,10,17,9,50,47,3,28,26,0,2,0,3
"2011","E00006133","E00006133","Total",162,50,18,32,0,13,3,10,97,95,0,2,0,2
"2011","E00006091","E00006091","Total",143,69,41,28,1,11,0,11,60,60,0,0,0,2
"2011","E00006095","E00006095","Total",116,86,48,38,0,2,0,2,28,27,0,0,1,0
"2011","E00006096","E00006096","Total",103,39,27,12,0,2,2,0,61,60,0,1,0,1
"2011","E00006104","E00006104","Total",129,57,27,30,0,8,1,7,62,62,0,0,0,2
"2011","E00006105","E00006105","Total",152,51,28,23,1,30,1,29,66,63,2,1,0,4
"2011","E00006092","E00006092","Total",185,63,26,37,0,65,3,62,56,54,1,1,0,1
"2011","E00006098","E00006098","Total",126,42,23,19,0,20,1,19,62,61,0,1,0,2
"2011","E00006103","E00006103","Total",112,43,31,12,0,24,0,24,43,40,2,1,0,2
"2011","E00006108","E00006108","Total",118,54,31,23,0,31,1,30,29,27,0,2,0,4
"2011","E00006113","E00006113","Total",140,83,30,53,0,1,1,0,54,53,1,0,0,2
"2011","E00006122","E00006122","Total",126,64,50,14,0,2,0,2,56,51,2,3,0,4
"2011","E00006136","E00006136","Total",145,49,16,33,0,2,0,2,93,91,0,1,1,1
"2011","E00006163","E00006163","Total",104,56,21,35,0,2,1,1,46,44,0,2,0,0
"2011","E00006165","E00006165","Total",139,72,35,37,0,3,0,3,62,60,1,0,1,2
"2011","E00006166","E00006166","Total",158,59,24,35,0,2,0,2,95,92,0,3,0,2
"2011","E00006171","E00006171","Total",145,49,22,27,1,17,8,9,76,76,0,0,0,2
"2011","E00006137","E00006137","Total",139,36,12,24,0,10,1,9,92,92,0,0,0,1
"2011","E00006167","E00006167","Total",120,45,24,21,0,17,8,9,58,57,0,1,0,0
"2011","E00006173","E00006173","Total",113,33,19,14,0,30,3,27,46,44,0,2,0,4
"2011","E00006174","E00006174","Total",127,25,11,14,0,54,1,53,48,48,0,0,0,0
"2011","E00006177","E00006177","Total",119,75,43,32,0,4,0,4,39,38,0,1,0,1
"2011","E00006179","E00006179","Total",123,65,40,25,0,5,0,5,52,49,0,3,0,1
"2011","E00006357","E00006357","Total",134,92,52,40,0,1,1,0,37,34,0,3,0,4
"2011","E00006361","E00006361","Total",109,48,32,16,0,2,1,1,56,55,1,0,0,3
"2011","E00006365","E00006365","Total",112,43,14,29,0,3,1,2,61,57,0,4,0,5
"2011","E00006396","E00006396","Total",122,92,54,38,0,2,1,1,28,27,0,0,1,0
"2011","E00006397","E00006397","Total",120,96,66,30,1,2,1,1,20,20,0,0,0,1
"2011","E00006362","E00006362","Total",113,59,39,20,0,3,0,3,49,48,0,1,0,2
"2011","E00006363","E00006363","Total",121,56,28,28,0,14,0,14,50,49,0,1,0,1
"2011","E00006395","E00006395","Total",115,67,32,35,1,4,2,2,41,41,0,0,0,2
"2011","E00006398","E00006398","Total",126,62,39,23,0,4,0,4,54,52,1,0,1,6
"2011","E00006399","E00006399","Total",110,44,22,22,1,20,0,20,44,43,0,1,0,1
"2011","E00006356","E00006356","Total",117,80,54,26,0,0,0,0,36,34,0,2,0,1
"2011","E00006359","E00006359","Total",112,56,36,20,0,9,0,9,45,43,0,2,0,2
"2011","E00006360","E00006360","Total",154,67,49,18,1,27,6,21,53,51,0,2,0,6
"2011","E00006364","E00006364","Total",167,43,16,27,0,13,6,7,111,109,0,2,0,0
"2011","E00006366","E00006366","Total",163,33,15,18,0,39,2,37,90,89,0,1,0,1
"2011","E00006367","E00006367","Total",144,48,26,22,0,23,0,23,73,72,0,1,0,0
"2011","E00005972","E00005972","Total",127,87,57,30,0,1,0,1,39,30,0,1,8,0
"2011","E00005973","E00005973","Total",118,74,37,37,0,7,1,6,35,26,1,0,8,2
"2011","E00005974","E00005974","Total",114,72,36,36,0,5,0,5,37,34,0,0,3,0
"2011","E00005976","E00005976","Total",125,61,35,26,1,1,1,0,58,57,1,0,0,4
"2011","E00005977","E00005977","Total",114,63,27,36,0,6,1,5,45,37,0,1,7,0
"2011","E00005966","E00005966","Total",148,55,22,33,6,45,42,3,40,39,0,1,0,2
"2011","E00005979","E00005979","Total",115,64,34,30,4,9,3,6,38,37,0,1,0,0
"2011","E00005986","E00005986","Total",124,51,22,29,0,11,7,4,57,57,0,0,0,5
"2011","E00005989","E00005989","Total",153,47,25,22,4,32,3,29,65,63,1,0,1,5
"2011","E00005992","E00005992","Total",128,35,19,16,0,30,9,21,60,59,0,0,1,3
"2011","E00005983","E00005983","Total",155,61,22,39,1,30,4,26,63,60,0,3,0,0
"2011","E00005984","E00005984","Total",137,102,49,53,0,6,2,4,27,26,0,0,1,2
"2011","E00005985","E00005985","Total",152,63,24,39,0,19,1,18,69,67,0,1,1,1
"2011","E00005990","E00005990","Total",140,67,28,39,0,21,1,20,52,47,0,5,0,0
"2011","E00005987","E00005987","Total",136,27,8,19,5,44,7,37,59,57,0,2,0,1
"2011","E00005988","E00005988","Total",120,69,29,40,1,15,4,11,33,32,0,1,0,2
"2011","E00005994","E00005994","Total",137,37,9,28,1,47,3,44,52,50,0,1,1,0
"2011","E00005996","E00005996","Total",181,55,19,36,3,64,23,41,58,56,0,2,0,1
"2011","E00006000","E00006000","Total",120,57,21,36,2,19,2,17,40,38,0,2,0,2
"2011","E00006404","E00006404","Total",110,86,45,41,0,6,1,5,17,16,0,0,1,1
"2011","E00006427","E00006427","Total",114,94,46,48,1,1,0,1,17,17,0,0,0,1
"2011","E00006433","E00006433","Total",112,101,48,53,0,4,2,2,6,4,0,2,0,1
"2011","E00006438","E00006438","Total",100,72,44,28,0,7,6,1,21,21,0,0,0,0
"2011","E00006441","E00006441","Total",102,79,34,45,1,5,2,3,17,16,0,1,0,0
"2011","E00006410","E00006410","Total",137,87,33,54,2,16,4,12,32,31,0,1,0,0
"2011","E00006413","E00006413","Total",136,83,31,52,0,7,4,3,46,43,0,2,1,0
"2011","E00006415","E00006415","Total",131,91,35,56,0,3,0,3,37,36,0,1,0,0
"2011","E00006418","E00006418","Total",127,74,28,46,3,26,22,4,20,18,0,1,1,4
"2011","E00006414","E00006414","Total",100,71,33,38,0,2,0,2,26,25,0,1,0,1
"2011","E00006417","E00006417","Total",115,91,31,60,0,0,0,0,24,24,0,0,0,0
"2011","E00006422","E00006422","Total",142,116,34,82,0,8,4,4,17,15,0,1,1,1
"2011","E00006425","E00006425","Total",119,51,14,37,3,31,20,11,34,33,0,1,0,0
"2011","E00006419","E00006419","Total",162,58,24,34,3,17,2,15,83,81,2,0,0,1
"2011","E00006420","E00006420","Total",157,97,54,43,0,4,4,0,50,49,0,1,0,6
"2011","E00006421","E00006421","Total",147,70,36,34,0,19,1,18,55,48,4,2,1,3
"2011","E00006423","E00006423","Total",137,64,25,39,2,13,3,10,58,58,0,0,0,0
"2011","E00006424","E00006424","Total",135,77,39,38,0,33,2,31,24,23,1,0,0,1
"2011","E00006075","E00006075","Total",126,72,44,28,0,18,9,9,34,34,0,0,0,2
"2011","E00006077","E00006077","Total",129,74,28,46,1,30,26,4,24,23,0,0,1,0
"2011","E00006082","E00006082","Total",128,86,32,54,0,25,23,2,14,14,0,0,0,3
"2011","E00006088","E00006088","Total",120,82,47,35,0,7,4,3,26,24,0,1,1,5
"2011","E00006067","E00006067","Total",124,71,35,36,1,18,16,2,29,28,0,1,0,5
"2011","E00006078","E00006078","Total",124,89,56,33,0,4,3,1,29,29,0,0,0,2
"2011","E00006079","E00006079","Total",119,96,57,39,0,5,3,2,17,17,0,0,0,1
"2011","E00006080","E00006080","Total",110,80,48,32,0,3,3,0,26,23,0,1,2,1
"2011","E00006081","E00006081","Total",146,85,52,33,2,24,9,15,29,29,0,0,0,6
"2011","E00006083","E00006083","Total",133,73,33,40,0,16,12,4,42,38,1,2,1,2
"2011","E00006086","E00006086","Total",123,74,40,34,0,15,9,6,32,28,0,4,0,2
"2011","E00006087","E00006087","Total",150,51,24,27,0,61,52,9,36,35,0,1,0,2
"2011","E00006084","E00006084","Total",128,99,52,47,0,5,4,1,21,18,0,3,0,3
"2011","E00006085","E00006085","Total",116,69,40,29,0,18,10,8,27,25,0,2,0,2
"2011","E00006089","E00006089","Total",112,60,35,25,10,16,13,3,24,23,0,1,0,2
"2011","E00006090","E00006090","Total",120,64,31,33,1,13,12,1,40,35,0,4,1,2
"2011","E00006762","E00006762","Total",120,36,16,20,4,56,12,44,20,20,0,0,0,4
"2011","E00006766","E00006766","Total",117,36,17,19,0,48,5,43,31,29,1,0,1,2
"2011","E00006768","E00006768","Total",120,90,48,42,4,6,1,5,20,14,0,5,1,0
"2011","E00006781","E00006781","Total",103,17,8,9,2,7,3,4,72,61,0,5,6,5
"2011","E00006204","E00006204","Total",127,62,27,35,2,26,24,2,35,35,0,0,0,2
"2011","E00006206","E00006206","Total",118,61,34,27,2,16,16,0,39,39,0,0,0,0
"2011","E00006208","E00006208","Total",117,49,21,28,2,43,43,0,22,22,0,0,0,1
"2011","E00006211","E00006211","Total",150,55,36,19,0,22,11,11,67,65,0,2,0,6
"2011","E00006207","E00006207","Total",122,51,24,27,0,37,33,4,31,31,0,0,0,3
"2011","E00006209","E00006209","Total",120,52,28,24,2,14,12,2,52,52,0,0,0,0
"2011","E00006215","E00006215","Total",114,78,52,26,0,5,2,3,29,28,0,0,1,2
"2011","E00006218","E00006218","Total",147,66,36,30,0,13,2,11,65,61,1,1,2,3
"2011","E00006212","E00006212","Total",120,69,46,23,0,15,5,10,34,30,0,3,1,2
"2011","E00006214","E00006214","Total",132,46,23,23,0,56,3,53,24,21,0,2,1,6
"2011","E00006217","E00006217","Total",133,47,27,20,0,53,5,48,32,30,0,1,1,1
"2011","E00006221","E00006221","Total",139,62,23,39,2,27,3,24,47,44,0,3,0,1
"2011","E00006213","E00006213","Total",112,31,13,18,1,45,44,1,32,31,0,0,1,3
"2011","E00006216","E00006216","Total",127,16,6,10,0,93,90,3,15,15,0,0,0,3
"2011","E00006219","E00006219","Total",118,67,37,30,2,8,3,5,41,40,0,1,0,0
"2011","E00006220","E00006220","Total",106,63,28,35,1,10,3,7,31,30,0,0,1,1
"2011","E00006222","E00006222","Total",186,35,6,29,36,65,8,57,48,40,3,0,5,2
"2011","E00006184","E00006184","Total",192,95,54,41,2,36,22,14,57,56,0,0,1,2
"2011","E00006186","E00006186","Total",126,28,10,18,2,65,61,4,29,27,0,0,2,2
"2011","E00006225","E00006225","Total",144,27,11,16,2,78,74,4,32,30,0,2,0,5
"2011","E00166852","E00166852","Total",126,36,13,23,0,36,3,33,50,47,0,3,0,4
"2011","E00166853","E00166853","Total",128,42,19,23,0,44,30,14,39,39,0,0,0,3
"2011","E00166854","E00166854","Total",164,61,18,43,1,8,4,4,91,89,0,1,1,3
"2011","E00166855","E00166855","Total",219,44,11,33,43,56,2,54,75,72,0,2,1,1
"2011","E00006185","E00006185","Total",150,49,33,16,2,34,8,26,63,61,0,2,0,2
"2011","E00006187","E00006187","Total",128,74,27,47,1,4,0,4,47,45,0,1,1,2
"2011","E00006188","E00006188","Total",121,67,20,47,1,11,4,7,41,40,0,1,0,1
"2011","E00006224","E00006224","Total",138,82,44,38,0,3,1,2,53,53,0,0,0,0
"2011","E00166864","E00166864","Total",234,22,8,14,144,38,15,23,25,21,0,3,1,5
"2011","E00166866","E00166866","Total",52,22,9,13,1,10,2,8,19,19,0,0,0,0
"2011","E00005993","E00005993","Total",113,90,49,41,0,4,3,1,19,17,0,2,0,0
"2011","E00005995","E00005995","Total",141,61,23,38,0,18,1,17,61,59,0,1,1,1
"2011","E00006005","E00006005","Total",119,70,30,40,0,11,2,9,37,37,0,0,0,1
"2011","E00006006","E00006006","Total",119,75,23,52,0,11,6,5,32,27,1,4,0,1
"2011","E00006008","E00006008","Total",94,41,18,23,0,15,3,12,38,35,0,3,0,0
"2011","E00005991","E00005991","Total",135,70,24,46,1,28,7,21,30,25,0,4,1,6
"2011","E00005997","E00005997","Total",131,64,27,37,0,21,3,18,44,44,0,0,0,2
"2011","E00005998","E00005998","Total",124,59,18,41,2,20,7,13,43,40,0,3,0,0
"2011","E00005999","E00005999","Total",124,65,20,45,0,21,2,19,36,36,0,0,0,2
"2011","E00006003","E00006003","Total",128,72,30,42,0,24,3,21,30,30,0,0,0,2
"2011","E00005968","E00005968","Total",228,44,20,24,2,24,12,12,158,155,0,1,2,0
"2011","E00005969","E00005969","Total",125,25,10,15,0,85,78,7,13,13,0,0,0,2
"2011","E00006001","E00006001","Total",147,77,36,41,0,18,6,12,52,51,0,1,0,0
"2011","E00006002","E00006002","Total",135,9,4,5,2,96,95,1,24,23,0,0,1,4
"2011","E00006004","E00006004","Total",236,74,27,47,14,61,10,51,82,81,0,1,0,5
"2011","E00005967","E00005967","Total",143,34,7,27,1,51,5,46,56,52,0,3,1,1
"2011","E00005970","E00005970","Total",147,63,22,41,3,16,7,9,64,61,0,3,0,1
"2011","E00005971","E00005971","Total",146,24,5,19,2,72,7,65,45,45,0,0,0,3
"2011","E00006007","E00006007","Total",136,45,13,32,1,52,10,42,36,35,0,0,1,2
"2011","E00006009","E00006009","Total",136,45,9,36,0,41,11,30,48,48,0,0,0,2
"2011","E00006010","E00006010","Total",153,34,4,30,0,60,4,56,58,57,0,0,1,1
"2011","E00006743","E00006743","Total",155,100,42,58,1,13,5,8,41,40,0,0,1,0
"2011","E00006748","E00006748","Total",184,33,20,13,2,25,11,14,122,120,0,1,1,2
"2011","E00006751","E00006751","Total",180,27,8,19,8,93,37,56,47,44,0,3,0,5
"2011","E00006752","E00006752","Total",156,67,22,45,4,16,8,8,65,63,0,2,0,4
"2011","E00006757","E00006757","Total",136,32,6,26,10,48,22,26,45,44,0,1,0,1
"2011","E00006775","E00006775","Total",109,81,31,50,0,5,2,3,23,20,1,1,1,0
"2011","E00006778","E00006778","Total",129,82,46,36,0,4,2,2,40,40,0,0,0,3
"2011","E00006780","E00006780","Total",141,75,40,35,1,25,5,20,33,31,0,1,1,7
"2011","E00166844","E00166844","Total",110,36,16,20,1,37,1,36,33,31,1,1,0,3
"2011","E00166846","E00166846","Total",73,44,16,28,0,4,0,4,23,22,0,0,1,2
"2011","E00006764","E00006764","Total",124,91,54,37,1,7,5,2,20,18,0,0,2,5
"2011","E00006783","E00006783","Total",127,80,41,39,2,3,0,3,38,35,0,3,0,4
"2011","E00006785","E00006785","Total",115,72,44,28,0,11,3,8,29,26,0,1,2,3
"2011","E00006788","E00006788","Total",139,96,62,34,2,3,2,1,36,34,0,1,1,2
"2011","E00006765","E00006765","Total",118,74,31,43,2,14,3,11,28,22,1,2,3,0
"2011","E00006769","E00006769","Total",137,63,33,30,1,40,1,39,30,27,0,2,1,3
"2011","E00006784","E00006784","Total",139,78,49,29,0,8,4,4,50,45,0,5,0,3
"2011","E00006787","E00006787","Total",117,76,35,41,2,7,0,7,30,26,0,2,2,2
"2011","E00006772","E00006772","Total",123,61,33,28,15,22,13,9,25,24,0,1,0,0
"2011","E00006773","E00006773","Total",113,76,42,34,1,11,4,7,24,24,0,0,0,1
"2011","E00006776","E00006776","Total",115,68,32,36,1,7,3,4,38,34,0,1,3,1
"2011","E00006777","E00006777","Total",120,72,41,31,0,17,13,4,29,26,0,1,2,2
"2011","E00006760","E00006760","Total",130,49,28,21,1,60,18,42,13,12,0,0,1,7
"2011","E00006770","E00006770","Total",121,56,27,29,0,48,36,12,11,10,0,1,0,6
"2011","E00006771","E00006771","Total",133,11,3,8,17,94,14,80,8,8,0,0,0,3
"2011","E00006774","E00006774","Total",132,80,39,41,1,13,6,7,34,28,0,4,2,4
"2011","E00006761","E00006761","Total",120,73,45,28,0,15,5,10,31,28,1,0,2,1
"2011","E00006763","E00006763","Total",109,71,27,44,3,3,0,3,30,29,0,1,0,2
"2011","E00006767","E00006767","Total",123,67,37,30,3,4,1,3,44,41,0,1,2,5
"2011","E00006782","E00006782","Total",112,78,43,35,1,10,1,9,23,22,0,0,1,0
"2011","E00006786","E00006786","Total",126,84,50,34,0,5,2,3,33,30,0,0,3,4
"2011","E00006149","E00006149","Total",158,103,54,49,1,6,0,6,40,39,0,1,0,8
"2011","E00006155","E00006155","Total",150,87,40,47,0,5,2,3,54,53,0,1,0,4
"2011","E00006157","E00006157","Total",139,110,62,48,0,5,2,3,20,20,0,0,0,4
"2011","E00166851","E00166851","Total",133,62,44,18,1,11,5,6,59,58,0,1,0,0
"2011","E00166863","E00166863","Total",116,57,29,28,15,13,4,9,30,30,0,0,0,1
"2011","E00006164","E00006164","Total",124,59,28,31,0,13,1,12,52,49,0,1,2,0
"2011","E00006168","E00006168","Total",114,21,6,15,0,41,1,40,49,49,0,0,0,3
"2011","E00006170","E00006170","Total",142,44,13,31,1,6,3,3,91,90,0,1,0,0
"2011","E00006172","E00006172","Total",128,40,19,21,0,14,3,11,73,68,0,5,0,1
"2011","E00006175","E00006175","Total",132,77,42,35,0,2,0,2,53,52,0,0,1,0
"2011","E00006738","E00006738","Total",116,74,35,39,0,4,2,2,38,37,1,0,0,0
"2011","E00006739","E00006739","Total",136,67,42,25,0,22,5,17,46,44,0,1,1,1
"2011","E00006740","E00006740","Total",125,52,27,25,1,27,9,18,44,41,0,2,1,1
"2011","E00006741","E00006741","Total",116,55,27,28,1,21,1,20,37,36,0,0,1,2
"2011","E00006742","E00006742","Total",128,49,23,26,4,14,6,8,60,58,0,1,1,1
"2011","E00006744","E00006744","Total",126,78,38,40,1,9,0,9,35,35,0,0,0,3
"2011","E00006745","E00006745","Total",162,96,52,44,1,5,3,2,60,59,0,1,0,0
"2011","E00006746","E00006746","Total",124,31,19,12,0,46,21,25,46,45,0,1,0,1
"2011","E00006747","E00006747","Total",159,47,13,34,4,7,2,5,98,96,2,0,0,3
"2011","E00006716","E00006716","Total",121,62,36,26,4,20,4,16,34,33,0,1,0,1
"2011","E00006721","E00006721","Total",134,73,35,38,0,9,4,5,50,49,0,1,0,2
"2011","E00006749","E00006749","Total",128,36,14,22,0,12,1,11,79,78,0,1,0,1
"2011","E00006750","E00006750","Total",128,86,40,46,0,1,0,1,39,38,1,0,0,2
"2011","E00006753","E00006753","Total",166,84,43,41,3,11,3,8,64,57,1,3,3,4
"2011","E00006228","E00006228","Total",236,75,18,57,10,55,25,30,93,92,0,1,0,3
"2011","E00006230","E00006230","Total",174,40,10,30,0,52,17,35,82,81,1,0,0,0
"2011","E00006236","E00006236","Total",132,9,5,4,0,104,96,8,14,14,0,0,0,5
"2011","E00006237","E00006237","Total",129,5,4,1,0,111,108,3,9,9,0,0,0,4
"2011","E00006239","E00006239","Total",45,10,7,3,0,30,27,3,5,4,0,1,0,0
"2011","E00006240","E00006240","Total",127,12,2,10,15,47,6,41,51,51,0,0,0,2
"2011","E00006241","E00006241","Total",182,31,4,27,14,68,37,31,67,66,0,1,0,2
"2011","E00006231","E00006231","Total",182,60,22,38,1,61,28,33,54,49,0,5,0,6
"2011","E00006232","E00006232","Total",148,27,9,18,11,84,8,76,22,22,0,0,0,4
"2011","E00006233","E00006233","Total",108,45,15,30,12,25,3,22,24,23,0,1,0,2
"2011","E00006234","E00006234","Total",155,46,14,32,1,35,5,30,70,70,0,0,0,3
"2011","E00006235","E00006235","Total",152,58,28,30,2,12,5,7,76,73,0,2,1,4
"2011","E00006238","E00006238","Total",122,42,21,21,2,45,40,5,31,31,0,0,0,2
"2011","E00006269","E00006269","Total",116,56,19,37,1,23,9,14,32,31,0,0,1,4
"2011","E00006254","E00006254","Total",117,72,23,49,0,9,1,8,33,32,0,1,0,3
"2011","E00006255","E00006255","Total",125,89,17,72,1,14,6,8,20,20,0,0,0,1
"2011","E00006260","E00006260","Total",117,97,51,46,0,6,2,4,12,11,0,1,0,2
"2011","E00006262","E00006262","Total",121,85,29,56,1,7,1,6,28,25,0,3,0,0
"2011","E00006263","E00006263","Total",128,96,35,61,0,8,4,4,24,23,0,1,0,0
"2011","E00006869","E00006869","Total",136,95,34,61,0,3,0,3,38,36,0,1,1,0
"2011","E00006881","E00006881","Total",148,98,43,55,1,7,2,5,41,38,1,1,1,1
"2011","E00006882","E00006882","Total",116,82,37,45,0,7,2,5,27,25,0,2,0,0
"2011","E00006903","E00006903","Total",127,69,21,48,1,10,1,9,46,44,0,2,0,1
"2011","E00006906","E00006906","Total",135,85,30,55,0,14,2,12,35,35,0,0,0,1
"2011","E00006878","E00006878","Total",122,84,31,53,0,16,2,14,22,20,1,1,0,0
"2011","E00006891","E00006891","Total",125,49,12,37,1,38,2,36,35,32,0,1,2,2
"2011","E00006892","E00006892","Total",102,20,8,12,1,63,33,30,18,17,0,0,1,0
"2011","E00006894","E00006894","Total",183,54,20,34,35,31,7,24,57,55,0,2,0,6
"2011","E00006900","E00006900","Total",90,16,5,11,1,62,62,0,10,10,0,0,0,1
"2011","E00006902","E00006902","Total",121,6,3,3,0,105,53,52,9,8,0,0,1,1
"2011","E00006896","E00006896","Total",132,73,19,54,3,10,2,8,46,44,0,2,0,0
"2011","E00006897","E00006897","Total",152,76,32,44,1,11,4,7,59,55,2,2,0,5
"2011","E00006899","E00006899","Total",131,40,15,25,0,64,7,57,23,23,0,0,0,4
"2011","E00006901","E00006901","Total",170,62,23,39,0,15,8,7,90,84,1,1,4,3
"2011","E00006904","E00006904","Total",141,80,28,52,0,3,3,0,53,52,0,1,0,5
"2011","E00006063","E00006063","Total",139,46,14,32,1,64,58,6,28,25,1,1,1,0
"2011","E00006066","E00006066","Total",110,18,8,10,1,78,66,12,11,10,0,1,0,2
"2011","E00006068","E00006068","Total",125,43,16,27,0,66,61,5,11,10,0,0,1,5
"2011","E00006070","E00006070","Total",193,27,7,20,22,121,80,41,21,17,0,3,1,2
"2011","E00006071","E00006071","Total",107,60,20,40,0,34,29,5,13,10,0,3,0,0
"2011","E00006065","E00006065","Total",87,31,16,15,1,28,13,15,22,18,0,4,0,5
"2011","E00006069","E00006069","Total",139,15,8,7,1,106,92,14,9,8,0,0,1,8
"2011","E00006074","E00006074","Total",116,14,9,5,0,91,87,4,6,5,0,1,0,5
"2011","E00006076","E00006076","Total",129,31,11,20,0,80,76,4,14,14,0,0,0,4
"2011","E00006651","E00006651","Total",134,38,17,21,2,74,71,3,16,16,0,0,0,4
"2011","E00006653","E00006653","Total",126,37,21,16,0,73,71,2,12,12,0,0,0,4
"2011","E00006655","E00006655","Total",128,66,25,41,1,41,39,2,19,18,0,1,0,1
"2011","E00006656","E00006656","Total",134,24,13,11,2,89,81,8,19,18,0,1,0,0
"2011","E00006643","E00006643","Total",112,92,46,46,0,3,0,3,16,15,0,1,0,1
"2011","E00006645","E00006645","Total",106,13,6,7,0,84,3,81,9,8,1,0,0,0
"2011","E00006666","E00006666","Total",120,86,49,37,4,4,2,2,24,24,0,0,0,2
"2011","E00006667","E00006667","Total",114,12,8,4,1,96,14,82,4,3,0,1,0,1
"2011","E00006647","E00006647","Total",130,35,15,20,0,74,72,2,17,14,0,0,3,4
"2011","E00006664","E00006664","Total",138,98,61,37,0,10,5,5,29,29,0,0,0,1
"2011","E00006665","E00006665","Total",114,79,45,34,3,6,3,3,25,24,0,1,0,1
"2011","E00006668","E00006668","Total",136,85,54,31,0,8,3,5,41,39,0,2,0,2
"2011","E00006641","E00006641","Total",192,19,11,8,23,134,14,120,12,10,0,0,2,4
"2011","E00006648","E00006648","Total",124,26,12,14,3,79,73,6,15,12,0,3,0,1
"2011","E00006650","E00006650","Total",119,29,6,23,32,41,26,15,16,14,0,2,0,1
"2011","E00006654","E00006654","Total",133,106,48,58,1,13,6,7,11,11,0,0,0,2
"2011","E00006669","E00006669","Total",122,25,5,20,54,30,2,28,11,10,1,0,0,2
"2011","E00006670","E00006670","Total",129,60,17,43,1,2,2,0,66,64,0,1,1,0
"2011","E00006671","E00006671","Total",112,5,2,3,0,101,7,94,4,4,0,0,0,2
"2011","E00006672","E00006672","Total",143,12,3,9,0,98,16,82,33,32,1,0,0,0
"2011","E00006229","E00006229","Total",155,100,35,65,5,14,2,12,32,30,0,1,1,4
"2011","E00006242","E00006242","Total",109,72,32,40,0,4,1,3,32,29,0,2,1,1
"2011","E00006243","E00006243","Total",130,95,27,68,0,4,0,4,31,30,0,0,1,0
"2011","E00006244","E00006244","Total",136,69,17,52,0,9,6,3,56,53,0,1,2,2
"2011","E00006245","E00006245","Total",129,99,47,52,1,3,2,1,23,23,0,0,0,3
"2011","E00006227","E00006227","Total",121,88,44,44,0,8,4,4,23,23,0,0,0,2
"2011","E00006246","E00006246","Total",157,38,9,29,0,60,12,48,55,52,0,2,1,4
"2011","E00006249","E00006249","Total",191,41,9,32,0,9,3,6,141,134,3,2,2,0
"2011","E00006250","E00006250","Total",160,91,41,50,2,21,12,9,42,40,0,2,0,4
"2011","E00006252","E00006252","Total",139,61,24,37,4,15,5,10,59,55,0,0,4,0
"2011","E00006251","E00006251","Total",134,87,37,50,0,15,0,15,32,30,0,2,0,0
"2011","E00006256","E00006256","Total",141,65,18,47,0,15,10,5,59,55,0,3,1,2
"2011","E00006258","E00006258","Total",138,108,43,65,1,7,4,3,21,21,0,0,0,1
"2011","E00006259","E00006259","Total",141,95,34,61,0,4,2,2,40,39,0,1,0,2
"2011","E00006261","E00006261","Total",116,47,21,26,4,25,23,2,35,33,0,1,1,5
"2011","E00006226","E00006226","Total",154,118,33,85,1,5,0,5,30,30,0,0,0,0
"2011","E00006247","E00006247","Total",159,70,24,46,35,32,3,29,21,21,0,0,0,1
"2011","E00006248","E00006248","Total",157,33,16,17,13,68,36,32,41,40,0,0,1,2
"2011","E00006253","E00006253","Total",126,103,36,67,2,6,2,4,15,15,0,0,0,0
"2011","E00006257","E00006257","Total",154,113,41,72,1,4,1,3,35,32,0,3,0,1
"2011","E00006139","E00006139","Total",125,49,20,29,1,56,51,5,16,15,0,1,0,3
"2011","E00006141","E00006141","Total",132,63,22,41,1,54,50,4,13,13,0,0,0,1
"2011","E00006156","E00006156","Total",105,51,28,23,0,41,39,2,12,11,0,0,1,1
"2011","E00006158","E00006158","Total",109,60,29,31,0,21,19,2,28,28,0,0,0,0
"2011","E00006160","E00006160","Total",126,46,17,29,0,47,44,3,29,25,0,3,1,4
"2011","E00006143","E00006143","Total",122,69,30,39,0,8,5,3,42,42,0,0,0,3
"2011","E00006144","E00006144","Total",119,68,27,41,0,13,1,12,38,36,0,1,1,0
"2011","E00006147","E00006147","Total",118,58,31,27,0,17,2,15,39,38,1,0,0,4
"2011","E00006153","E00006153","Total",143,58,18,40,2,6,1,5,73,73,0,0,0,4
"2011","E00006180","E00006180","Total",127,81,45,36,0,3,0,3,40,36,0,3,1,3
"2011","E00006140","E00006140","Total",126,47,16,31,5,46,41,5,25,22,0,3,0,3
"2011","E00006145","E00006145","Total",126,48,15,33,0,56,53,3,18,16,0,1,1,4
"2011","E00006146","E00006146","Total",114,93,56,37,1,3,2,1,16,16,0,0,0,1
"2011","E00006148","E00006148","Total",118,49,17,32,11,18,17,1,40,40,0,0,0,0
"2011","E00006151","E00006151","Total",128,76,34,42,9,12,10,2,31,29,0,2,0,0
"2011","E00006142","E00006142","Total",116,44,18,26,1,57,24,33,14,14,0,0,0,0
"2011","E00006154","E00006154","Total",124,69,33,36,0,7,7,0,45,45,0,0,0,3
"2011","E00006159","E00006159","Total",112,63,28,35,0,1,0,1,47,44,0,3,0,1
"2011","E00006161","E00006161","Total",120,46,23,23,2,40,40,0,32,31,0,1,0,0
"2011","E00006162","E00006162","Total",127,60,24,36,0,35,25,10,31,30,1,0,0,1
"2011","E00006138","E00006138","Total",130,81,26,55,0,5,0,5,44,44,0,0,0,0
"2011","E00006150","E00006150","Total",135,102,61,41,0,0,0,0,32,30,1,1,0,1
"2011","E00006169","E00006169","Total",112,42,19,23,0,22,21,1,45,45,0,0,0,3
"2011","E00006176","E00006176","Total",149,69,36,33,1,2,0,2,74,74,0,0,0,3
"2011","E00006178","E00006178","Total",126,23,9,14,0,21,0,21,81,81,0,0,0,1
"2011","E00006870","E00006870","Total",111,62,24,38,0,14,8,6,31,29,1,1,0,4
"2011","E00006876","E00006876","Total",125,73,31,42,0,18,16,2,33,31,0,1,1,1
"2011","E00006885","E00006885","Total",142,93,44,49,0,7,2,5,40,40,0,0,0,2
"2011","E00006890","E00006890","Total",109,65,30,35,0,3,1,2,37,36,0,1,0,4
"2011","E00006907","E00006907","Total",123,87,43,44,1,8,3,5,25,22,1,2,0,2
"2011","E00006909","E00006909","Total",125,86,34,52,0,2,1,1,37,35,1,0,1,0
"2011","E00006478","E00006478","Total",127,83,43,40,0,0,0,0,42,39,1,2,0,2
"2011","E00006479","E00006479","Total",138,89,32,57,0,2,1,1,45,42,2,1,0,2
"2011","E00006482","E00006482","Total",137,98,48,50,1,9,6,3,29,29,0,0,0,0
"2011","E00006484","E00006484","Total",120,66,37,29,0,8,6,2,45,44,0,1,0,1
"2011","E00006513","E00006513","Total",102,71,35,36,0,4,0,4,27,25,0,2,0,0
"2011","E00006867","E00006867","Total",110,83,37,46,1,3,2,1,20,19,0,1,0,3
"2011","E00006874","E00006874","Total",124,96,45,51,1,2,2,0,24,22,0,2,0,1
"2011","E00006880","E00006880","Total",132,115,68,47,0,4,2,2,12,11,0,1,0,1
"2011","E00006886","E00006886","Total",119,96,53,43,0,1,1,0,21,21,0,0,0,1
"2011","E00006905","E00006905","Total",79,65,27,38,0,3,3,0,11,11,0,0,0,0
"2011","E00006875","E00006875","Total",137,104,42,62,0,4,1,3,26,25,0,1,0,3
"2011","E00006877","E00006877","Total",134,78,26,52,0,10,5,5,42,39,0,3,0,4
"2011","E00006879","E00006879","Total",133,63,30,33,1,1,1,0,68,64,0,3,1,0
"2011","E00006883","E00006883","Total",146,94,33,61,0,7,0,7,41,39,0,2,0,4
"2011","E00006908","E00006908","Total",127,81,29,52,2,8,3,5,36,34,0,2,0,0
"2011","E00006871","E00006871","Total",145,101,46,55,0,3,0,3,40,40,0,0,0,1
"2011","E00006872","E00006872","Total",151,71,36,35,0,7,3,4,69,68,0,0,1,4
"2011","E00006884","E00006884","Total",134,79,37,42,3,3,1,2,46,44,0,2,0,3
"2011","E00006887","E00006887","Total",120,96,45,51,0,2,1,1,22,22,0,0,0,0
"2011","E00006888","E00006888","Total",117,97,42,55,0,2,1,1,18,18,0,0,0,0
"2011","E00006868","E00006868","Total",127,91,47,44,1,9,7,2,20,20,0,0,0,6
"2011","E00006873","E00006873","Total",89,36,14,22,1,41,36,5,9,9,0,0,0,2
"2011","E00006889","E00006889","Total",128,49,16,33,0,7,3,4,72,66,2,2,2,0
"2011","E00006893","E00006893","Total",142,63,29,34,0,1,1,0,78,77,0,0,1,0
"2011","E00006895","E00006895","Total",112,54,18,36,2,12,1,11,40,38,0,1,1,4
"2011","E00006898","E00006898","Total",115,42,11,31,0,15,4,11,53,52,0,1,0,5
"2011","E00006723","E00006723","Total",122,39,21,18,0,49,28,21,27,27,0,0,0,7
"2011","E00006724","E00006724","Total",141,19,12,7,0,70,13,57,48,47,0,0,1,4
"2011","E00006725","E00006725","Total",113,51,20,31,0,12,2,10,45,42,0,2,1,5
"2011","E00006727","E00006727","Total",125,38,16,22,0,9,2,7,78,77,0,1,0,0
"2011","E00006730","E00006730","Total",109,56,25,31,1,11,6,5,39,36,0,3,0,2
"2011","E00006732","E00006732","Total",108,27,13,14,0,63,61,2,18,18,0,0,0,0
"2011","E00006713","E00006713","Total",139,62,21,41,0,41,4,37,35,33,0,2,0,1
"2011","E00006717","E00006717","Total",120,47,18,29,1,24,20,4,45,44,1,0,0,3
"2011","E00006718","E00006718","Total",124,63,18,45,0,19,4,15,36,35,0,1,0,6
"2011","E00006719","E00006719","Total",121,66,25,41,1,24,5,19,30,29,0,1,0,0
"2011","E00006720","E00006720","Total",129,60,17,43,2,24,2,22,41,40,0,1,0,2
"2011","E00006756","E00006756","Total",127,22,10,12,0,61,43,18,43,42,0,1,0,1
"2011","E00006715","E00006715","Total",122,30,14,16,0,63,63,0,25,24,0,1,0,4
"2011","E00006722","E00006722","Total",129,8,5,3,0,109,105,4,9,9,0,0,0,3
"2011","E00006728","E00006728","Total",190,16,6,10,8,147,110,37,12,11,0,1,0,7
"2011","E00006754","E00006754","Total",130,21,10,11,0,79,72,7,21,20,1,0,0,9
"2011","E00006755","E00006755","Total",137,13,6,7,1,115,111,4,6,6,0,0,0,2
"2011","E00006759","E00006759","Total",133,18,6,12,8,83,72,11,18,16,0,2,0,6
"2011","E00006726","E00006726","Total",130,68,21,47,4,15,8,7,41,40,0,1,0,2
"2011","E00006729","E00006729","Total",121,7,0,7,1,94,88,6,14,14,0,0,0,5
"2011","E00006758","E00006758","Total",110,31,9,22,2,65,63,2,10,8,0,1,1,2
"2011","E00166868","E00166868","Total",65,1,0,1,30,31,4,27,2,2,0,0,0,1
"2011","E00006714","E00006714","Total",114,20,12,8,0,77,72,5,11,10,0,0,1,6
"2011","E00006731","E00006731","Total",118,7,6,1,2,86,84,2,18,16,0,1,1,5
"2011","E00006734","E00006734","Total",104,11,1,10,2,75,63,12,14,12,0,1,1,2
"2011","E00006735","E00006735","Total",131,11,1,10,1,106,103,3,10,9,0,0,1,3
"2011","E00006737","E00006737","Total",119,7,3,4,20,81,48,33,7,7,0,0,0,4
"2011","E00006829","E00006829","Total",111,81,42,39,0,4,4,0,26,23,0,3,0,0
"2011","E00006831","E00006831","Total",118,64,32,32,2,1,1,0,51,50,0,1,0,0
"2011","E00006833","E00006833","Total",117,89,33,56,1,2,1,1,23,23,0,0,0,2
"2011","E00006834","E00006834","Total",135,94,50,44,0,3,2,1,38,38,0,0,0,0
"2011","E00006840","E00006840","Total",112,85,45,40,0,0,0,0,25,25,0,0,0,2
"2011","E00006866","E00006866","Total",113,90,45,45,0,1,0,1,21,21,0,0,0,1
"2011","E00006820","E00006820","Total",128,86,58,28,1,2,1,1,35,34,0,1,0,4
"2011","E00006822","E00006822","Total",128,68,43,25,3,32,28,4,23,21,1,1,0,2
"2011","E00006841","E00006841","Total",121,84,45,39,0,8,3,5,27,27,0,0,0,2
"2011","E00006846","E00006846","Total",131,99,57,42,1,3,1,2,26,26,0,0,0,2
"2011","E00006851","E00006851","Total",99,46,25,21,1,19,9,10,32,32,0,0,0,1
"2011","E00006853","E00006853","Total",111,85,39,46,0,4,2,2,20,19,0,1,0,2
"2011","E00006835","E00006835","Total",120,91,46,45,1,2,2,0,25,25,0,0,0,1
"2011","E00006836","E00006836","Total",112,87,36,51,0,4,4,0,20,19,0,1,0,1
"2011","E00006838","E00006838","Total",107,67,19,48,2,12,1,11,26,26,0,0,0,0
"2011","E00006839","E00006839","Total",135,86,30,56,0,0,0,0,48,46,1,1,0,1
"2011","E00006842","E00006842","Total",130,111,51,60,0,3,2,1,15,14,0,1,0,1
"2011","E00006843","E00006843","Total",105,74,33,41,1,3,1,2,26,25,0,1,0,1
"2011","E00006823","E00006823","Total",173,78,30,48,1,31,6,25,61,57,0,1,3,2
"2011","E00006828","E00006828","Total",126,96,46,50,0,8,7,1,21,21,0,0,0,1
"2011","E00006861","E00006861","Total",161,19,8,11,6,6,4,2,127,124,0,1,2,3
"2011","E00006862","E00006862","Total",137,62,32,30,1,12,1,11,60,59,0,1,0,2
"2011","E00006863","E00006863","Total",141,78,26,52,3,8,4,4,49,47,0,2,0,3
"2011","E00006264","E00006264","Total",115,55,23,32,1,39,38,1,20,20,0,0,0,0
"2011","E00006265","E00006265","Total",120,65,21,44,3,14,5,9,38,38,0,0,0,0
"2011","E00006266","E00006266","Total",105,53,22,31,3,33,33,0,15,15,0,0,0,1
"2011","E00006267","E00006267","Total",105,93,48,45,0,2,2,0,7,7,0,0,0,3
"2011","E00006268","E00006268","Total",136,97,45,52,1,10,6,4,28,25,1,2,0,0
"2011","E00006474","E00006474","Total",112,94,51,43,0,2,2,0,15,13,0,2,0,1
"2011","E00006480","E00006480","Total",131,112,71,41,1,2,2,0,16,15,0,1,0,0
"2011","E00006481","E00006481","Total",119,95,53,42,0,1,0,1,19,17,0,2,0,4
"2011","E00006487","E00006487","Total",160,104,61,43,0,8,3,5,47,47,0,0,0,1
"2011","E00006515","E00006515","Total",129,111,58,53,1,0,0,0,17,15,0,2,0,0
"2011","E00006476","E00006476","Total",135,111,51,60,0,1,0,1,22,22,0,0,0,1
"2011","E00006508","E00006508","Total",119,87,29,58,0,6,3,3,24,22,0,2,0,2
"2011","E00006510","E00006510","Total",118,85,35,50,0,3,1,2,30,30,0,0,0,0
"2011","E00006511","E00006511","Total",138,115,47,68,0,3,1,2,19,18,0,1,0,1
"2011","E00006514","E00006514","Total",124,114,67,47,0,3,3,0,6,5,0,1,0,1
"2011","E00006477","E00006477","Total",151,113,50,63,0,6,3,3,29,29,0,0,0,3
"2011","E00006485","E00006485","Total",111,72,47,25,4,3,1,2,32,30,0,2,0,0
"2011","E00006491","E00006491","Total",103,71,44,27,4,2,2,0,23,22,0,1,0,3
"2011","E00006509","E00006509","Total",113,62,32,30,0,5,0,5,45,45,0,0,0,1
"2011","E00006512","E00006512","Total",117,98,42,56,0,0,0,0,19,18,0,0,1,0
"2011","E00006516","E00006516","Total",118,102,43,59,0,1,0,1,15,15,0,0,0,0
"2011","E00006806","E00006806","Total",141,51,14,37,4,19,3,16,64,61,0,3,0,3
"2011","E00006809","E00006809","Total",106,52,16,36,1,21,6,15,30,27,1,1,1,2
"2011","E00006810","E00006810","Total",150,95,55,40,0,9,3,6,41,39,0,2,0,5
"2011","E00006814","E00006814","Total",146,98,51,47,0,17,4,13,28,24,1,1,2,3
"2011","E00006789","E00006789","Total",155,70,28,42,0,19,12,7,63,58,1,4,0,3
"2011","E00006805","E00006805","Total",108,20,11,9,1,16,3,13,65,60,1,2,2,6
"2011","E00006811","E00006811","Total",103,44,25,19,2,28,5,23,25,24,0,1,0,4
"2011","E00006816","E00006816","Total",161,62,36,26,4,24,5,19,65,59,1,2,3,6
"2011","E00006791","E00006791","Total",134,101,51,50,1,4,3,1,26,25,0,1,0,2
"2011","E00006793","E00006793","Total",100,74,37,37,0,2,0,2,21,21,0,0,0,3
"2011","E00006812","E00006812","Total",135,84,33,51,0,5,1,4,44,42,0,0,2,2
"2011","E00006815","E00006815","Total",87,11,5,6,0,71,10,61,4,3,0,0,1,1
"2011","E00006796","E00006796","Total",138,82,40,42,2,3,1,2,50,46,0,2,2,1
"2011","E00006799","E00006799","Total",140,63,21,42,1,36,14,22,38,33,1,1,3,2
"2011","E00006800","E00006800","Total",115,74,40,34,2,5,2,3,33,30,2,1,0,1
"2011","E00006813","E00006813","Total",139,91,43,48,1,11,7,4,34,31,0,3,0,2
"2011","E00006792","E00006792","Total",138,59,28,31,1,15,7,8,62,60,0,0,2,1
"2011","E00006797","E00006797","Total",138,92,55,37,0,14,5,9,32,30,0,1,1,0
"2011","E00006803","E00006803","Total",199,61,32,29,16,54,12,42,66,64,0,1,1,2
"2011","E00006819","E00006819","Total",119,72,40,32,2,9,2,7,35,31,0,4,0,1
"2011","E00006794","E00006794","Total",121,78,34,44,1,12,3,9,29,29,0,0,0,1
"2011","E00006798","E00006798","Total",110,49,16,33,2,22,6,16,33,29,0,3,1,4
"2011","E00006801","E00006801","Total",135,62,24,38,1,14,6,8,56,52,0,1,3,2
"2011","E00006802","E00006802","Total",127,54,19,35,1,18,3,15,50,48,0,1,1,4
"2011","E00006804","E00006804","Total",146,88,31,57,3,13,4,9,38,36,0,2,0,4
"2011","E00006807","E00006807","Total",125,71,34,37,12,10,2,8,26,24,0,0,2,6
"2011","E00006808","E00006808","Total",141,79,33,46,1,15,4,11,43,41,0,2,0,3
"2011","E00006644","E00006644","Total",117,47,25,22,0,35,21,14,34,31,1,2,0,1
"2011","E00006646","E00006646","Total",131,14,8,6,0,83,62,21,26,22,0,2,2,8
"2011","E00006649","E00006649","Total",181,68,34,34,0,43,19,24,62,57,0,4,1,8
"2011","E00006652","E00006652","Total",134,73,41,32,3,17,6,11,39,36,0,1,2,2
"2011","E00006657","E00006657","Total",128,116,47,69,0,0,0,0,11,10,0,1,0,1
"2011","E00006658","E00006658","Total",129,111,49,62,0,4,0,4,13,13,0,0,0,1
"2011","E00006659","E00006659","Total",132,50,24,26,0,56,43,13,24,21,2,0,1,2
"2011","E00006660","E00006660","Total",135,92,48,44,7,11,6,5,21,18,0,2,1,4
"2011","E00006642","E00006642","Total",132,106,57,49,0,1,0,1,25,23,0,2,0,0
"2011","E00006661","E00006661","Total",128,58,22,36,5,12,7,5,51,50,0,1,0,2
"2011","E00006662","E00006662","Total",136,15,8,7,0,104,4,100,13,11,0,0,2,4
"2011","E00006663","E00006663","Total",123,80,36,44,0,21,20,1,21,21,0,0,0,1
"2011","E00006790","E00006790","Total",147,53,30,23,1,22,10,12,67,61,3,1,2,4
"2011","E00006795","E00006795","Total",142,82,42,40,1,15,12,3,43,43,0,0,0,1
"2011","E00006817","E00006817","Total",107,53,18,35,0,11,3,8,38,37,0,0,1,5
"2011","E00006818","E00006818","Total",129,71,32,39,0,20,13,7,37,35,0,0,2,1
"2011","E00006483","E00006483","Total",116,95,47,48,0,3,0,3,16,13,0,3,0,2
"2011","E00006486","E00006486","Total",106,92,39,53,0,3,1,2,11,10,1,0,0,0
"2011","E00006489","E00006489","Total",145,107,38,69,0,4,2,2,34,33,0,1,0,0
"2011","E00006497","E00006497","Total",115,73,28,45,0,0,0,0,41,39,1,1,0,1
"2011","E00006499","E00006499","Total",126,75,27,48,0,3,0,3,47,45,0,2,0,1
"2011","E00006488","E00006488","Total",111,44,16,28,0,7,1,6,58,54,0,4,0,2
"2011","E00006492","E00006492","Total",169,39,18,21,3,86,79,7,40,36,1,3,0,1
"2011","E00006493","E00006493","Total",85,40,16,24,0,5,4,1,39,38,0,1,0,1
"2011","E00006496","E00006496","Total",117,78,27,51,0,4,2,2,34,33,0,1,0,1
"2011","E00006500","E00006500","Total",110,56,19,37,0,4,2,2,49,47,1,1,0,1
"2011","E00166869","E00166869","Total",115,53,22,31,3,9,9,0,43,41,0,0,2,7
"2011","E00006494","E00006494","Total",108,65,27,38,0,12,7,5,31,31,0,0,0,0
"2011","E00006498","E00006498","Total",159,100,49,51,0,5,1,4,50,49,0,1,0,4
"2011","E00006501","E00006501","Total",124,89,36,53,0,3,1,2,30,30,0,0,0,2
"2011","E00006502","E00006502","Total",107,93,33,60,0,1,0,1,12,11,0,1,0,1
"2011","E00006503","E00006503","Total",116,66,30,36,0,11,3,8,37,37,0,0,0,2
"2011","E00006475","E00006475","Total",130,73,18,55,0,5,3,2,52,49,0,3,0,0
"2011","E00006504","E00006504","Total",145,69,26,43,0,30,7,23,45,43,1,1,0,1
"2011","E00006505","E00006505","Total",136,53,13,40,1,53,28,25,27,26,0,1,0,2
"2011","E00006506","E00006506","Total",138,78,19,59,1,15,9,6,43,39,0,3,1,1
"2011","E00006507","E00006507","Total",156,94,35,59,1,20,9,11,41,38,0,3,0,0
"2011","E00006825","E00006825","Total",157,88,31,57,1,15,9,6,53,48,1,4,0,0
"2011","E00006832","E00006832","Total",130,66,27,39,0,24,20,4,39,38,0,1,0,1
"2011","E00006837","E00006837","Total",117,65,29,36,1,14,12,2,37,36,0,1,0,0
"2011","E00006844","E00006844","Total",127,66,19,47,3,14,11,3,41,40,0,0,1,3
"2011","E00006849","E00006849","Total",135,87,38,49,0,11,6,5,34,32,0,2,0,3
"2011","E00006858","E00006858","Total",139,93,41,52,0,11,1,10,34,33,0,0,1,1
"2011","E00006824","E00006824","Total",109,51,20,31,1,20,18,2,35,34,0,1,0,2
"2011","E00006826","E00006826","Total",137,46,8,38,0,51,3,48,40,38,0,2,0,0
"2011","E00006827","E00006827","Total",130,55,17,38,0,30,26,4,43,41,0,2,0,2
"2011","E00006830","E00006830","Total",120,45,17,28,0,33,18,15,37,36,0,0,1,5
"2011","E00006864","E00006864","Total",120,53,29,24,0,4,3,1,60,58,1,1,0,3
"2011","E00006865","E00006865","Total",127,65,30,35,1,15,14,1,45,45,0,0,0,1
"2011","E00006821","E00006821","Total",135,64,27,37,1,35,28,7,34,34,0,0,0,1
"2011","E00006848","E00006848","Total",148,84,44,40,1,18,1,17,43,40,0,3,0,2
"2011","E00006855","E00006855","Total",115,75,29,46,0,11,0,11,28,27,0,1,0,1
"2011","E00006856","E00006856","Total",127,79,41,38,0,6,3,3,42,42,0,0,0,0
"2011","E00006857","E00006857","Total",105,66,29,37,0,4,1,3,32,31,0,1,0,3
"2011","E00006860","E00006860","Total",132,73,34,39,0,4,2,2,55,52,0,3,0,0
"2011","E00006845","E00006845","Total",171,47,16,31,1,3,2,1,120,115,1,4,0,0
"2011","E00006847","E00006847","Total",114,73,21,52,0,7,5,2,34,32,2,0,0,0
"2011","E00006850","E00006850","Total",103,68,28,40,1,2,1,1,32,29,0,3,0,0
"2011","E00006852","E00006852","Total",123,78,39,39,0,7,4,3,38,37,0,1,0,0
"2011","E00006854","E00006854","Total",130,28,10,18,0,69,57,12,26,24,0,1,1,7
"2011","E00165797","E00165797","Total",117,51,23,28,0,8,3,5,53,53,0,0,0,5
"2011","E00007193","E00007193","Total",125,100,41,59,0,6,4,2,18,18,0,0,0,1
"2011","E00007194","E00007194","Total",126,86,35,51,1,10,6,4,25,20,0,5,0,4
"2011","E00007195","E00007195","Total",139,81,33,48,0,16,13,3,40,38,0,2,0,2
"2011","E00007196","E00007196","Total",116,95,52,43,2,9,7,2,8,7,0,1,0,2
"2011","E00007198","E00007198","Total",132,106,43,63,0,4,2,2,20,17,1,2,0,2
"2011","E00007197","E00007197","Total",132,90,31,59,0,27,13,14,15,13,0,1,1,0
"2011","E00007199","E00007199","Total",188,92,36,56,29,30,5,25,34,34,0,0,0,3
"2011","E00007202","E00007202","Total",126,75,31,44,0,12,8,4,36,35,0,1,0,3
"2011","E00007205","E00007205","Total",122,85,38,47,1,8,5,3,27,26,0,1,0,1
"2011","E00007206","E00007206","Total",146,85,37,48,2,10,4,6,45,42,1,2,0,4
"2011","E00007697","E00007697","Total",119,73,38,35,1,31,10,21,13,13,0,0,0,1
"2011","E00007699","E00007699","Total",121,89,35,54,0,13,12,1,19,17,0,2,0,0
"2011","E00007701","E00007701","Total",127,76,33,43,0,14,11,3,36,33,0,3,0,1
"2011","E00007702","E00007702","Total",153,56,19,37,4,40,6,34,52,52,0,0,0,1
"2011","E00007704","E00007704","Total",120,100,42,58,0,8,4,4,9,9,0,0,0,3
"2011","E00007687","E00007687","Total",140,86,46,40,1,12,6,6,39,35,1,3,0,2
"2011","E00007688","E00007688","Total",120,110,54,56,1,2,0,2,7,6,1,0,0,0
"2011","E00007692","E00007692","Total",125,109,54,55,0,5,5,0,11,10,0,1,0,0
"2011","E00007694","E00007694","Total",125,96,45,51,2,21,17,4,6,6,0,0,0,0
"2011","E00007696","E00007696","Total",149,87,30,57,0,24,19,5,36,34,0,2,0,2
"2011","E00007167","E00007167","Total",94,15,3,12,0,47,22,25,29,27,0,1,1,3
"2011","E00007172","E00007172","Total",163,92,54,38,2,28,18,10,36,36,0,0,0,5
"2011","E00007175","E00007175","Total",111,12,3,9,0,86,81,5,11,10,0,1,0,2
"2011","E00007180","E00007180","Total",128,27,13,14,0,88,77,11,10,10,0,0,0,3
"2011","E00007189","E00007189","Total",121,66,27,39,2,9,9,0,42,40,0,2,0,2
"2011","E00007668","E00007668","Total",168,31,8,23,14,73,31,42,47,45,0,2,0,3
"2011","E00007695","E00007695","Total",121,44,17,27,0,65,39,26,11,11,0,0,0,1
"2011","E00007698","E00007698","Total",124,61,23,38,0,50,32,18,10,9,0,1,0,3
"2011","E00007703","E00007703","Total",128,37,7,30,0,67,60,7,22,22,0,0,0,2
"2011","E00007705","E00007705","Total",124,33,9,24,1,76,60,16,12,12,0,0,0,2
"2011","E00007670","E00007670","Total",116,81,41,40,0,21,15,6,14,13,0,1,0,0
"2011","E00007673","E00007673","Total",131,64,27,37,0,13,5,8,54,51,0,3,0,0
"2011","E00007674","E00007674","Total",125,97,46,51,0,7,6,1,19,19,0,0,0,2
"2011","E00007676","E00007676","Total",151,83,44,39,0,29,23,6,39,38,0,1,0,0
"2011","E00007707","E00007707","Total",136,107,51,56,5,11,11,0,9,9,0,0,0,4
"2011","E00007669","E00007669","Total",117,36,15,21,1,54,42,12,23,23,0,0,0,3
"2011","E00007675","E00007675","Total",117,84,41,43,1,10,7,3,22,22,0,0,0,0
"2011","E00007677","E00007677","Total",135,97,51,46,2,9,5,4,25,24,0,1,0,2
"2011","E00007700","E00007700","Total",166,57,16,41,10,69,49,20,28,28,0,0,0,2
"2011","E00007706","E00007706","Total",141,85,28,57,13,19,17,2,24,23,0,1,0,0
"2011","E00007686","E00007686","Total",131,107,59,48,0,9,3,6,15,15,0,0,0,0
"2011","E00007689","E00007689","Total",167,44,25,19,0,115,113,2,6,5,0,1,0,2
"2011","E00007690","E00007690","Total",110,40,16,24,4,54,15,39,10,9,0,1,0,2
"2011","E00007691","E00007691","Total",121,48,18,30,0,56,36,20,17,17,0,0,0,0
"2011","E00007693","E00007693","Total",132,74,35,39,2,32,20,12,20,18,1,0,1,4
"2011","E00007177","E00007177","Total",200,126,33,93,1,11,8,3,59,57,0,2,0,3
"2011","E00007179","E00007179","Total",145,88,43,45,0,15,9,6,41,39,0,2,0,1
"2011","E00007182","E00007182","Total",131,70,19,51,1,20,6,14,40,39,0,1,0,0
"2011","E00007192","E00007192","Total",216,98,28,70,7,18,11,7,89,86,0,3,0,4
"2011","E00171149","E00171149","Total",135,85,15,70,1,26,5,21,20,20,0,0,0,3
"2011","E00171150","E00171150","Total",153,38,5,33,10,41,5,36,62,60,0,2,0,2
"2011","E00007168","E00007168","Total",129,70,30,40,2,25,17,8,31,28,0,2,1,1
"2011","E00007171","E00007171","Total",159,17,8,9,16,83,44,39,40,40,0,0,0,3
"2011","E00007200","E00007200","Total",135,64,29,35,0,29,24,5,42,38,0,3,1,0
"2011","E00007201","E00007201","Total",124,58,25,33,5,30,22,8,27,26,0,1,0,4
"2011","E00007203","E00007203","Total",123,50,21,29,7,42,27,15,22,22,0,0,0,2
"2011","E00007204","E00007204","Total",113,28,11,17,1,70,40,30,13,9,0,1,3,1
"2011","E00007174","E00007174","Total",115,81,31,50,0,11,5,6,22,21,0,0,1,1
"2011","E00007176","E00007176","Total",127,87,34,53,1,13,3,10,24,22,0,1,1,2
"2011","E00007184","E00007184","Total",130,71,20,51,0,30,16,14,29,27,0,1,1,0
"2011","E00007186","E00007186","Total",133,58,21,37,0,47,37,10,28,28,0,0,0,0
"2011","E00007207","E00007207","Total",150,63,24,39,0,31,24,7,56,55,0,0,1,0
"2011","E00007173","E00007173","Total",171,94,33,61,12,20,8,12,45,45,0,0,0,0
"2011","E00007183","E00007183","Total",126,92,29,63,3,9,5,4,21,21,0,0,0,1
"2011","E00007185","E00007185","Total",133,53,18,35,1,50,39,11,26,25,0,1,0,3
"2011","E00007191","E00007191","Total",145,90,42,48,1,38,28,10,15,15,0,0,0,1
"2011","E00007188","E00007188","Total",143,89,32,57,0,13,7,6,41,38,0,2,1,0
"2011","E00171169","E00171169","Total",129,77,8,69,0,21,8,13,30,30,0,0,0,1
"2011","E00171170","E00171170","Total",134,19,6,13,1,98,3,95,11,11,0,0,0,5
"2011","E00171172","E00171172","Total",135,9,2,7,1,113,11,102,8,8,0,0,0,4
"2011","E00171183","E00171183","Total",120,92,12,80,0,8,5,3,17,17,0,0,0,3
"2011","E00007170","E00007170","Total",227,104,11,93,2,19,9,10,99,96,0,1,2,3
"2011","E00007181","E00007181","Total",182,37,4,33,0,93,8,85,45,42,0,3,0,7
"2011","E00007187","E00007187","Total",170,87,6,81,0,19,8,11,61,59,1,1,0,3
"2011","E00171177","E00171177","Total",123,51,3,48,0,5,4,1,64,63,0,1,0,3
"2011","E00007000","E00007000","Total",119,96,43,53,3,13,8,5,6,5,0,1,0,1
"2011","E00007008","E00007008","Total",129,79,28,51,1,28,26,2,20,19,0,0,1,1
"2011","E00007015","E00007015","Total",120,104,30,74,0,5,2,3,10,10,0,0,0,1
"2011","E00007020","E00007020","Total",131,106,36,70,1,10,9,1,12,12,0,0,0,2
"2011","E00007023","E00007023","Total",106,86,25,61,0,6,2,4,13,12,0,1,0,1
"2011","E00007024","E00007024","Total",126,84,33,51,0,2,0,2,38,36,0,2,0,2
"2011","E00007004","E00007004","Total",129,95,35,60,1,8,5,3,19,19,0,0,0,6
"2011","E00007005","E00007005","Total",126,100,40,60,1,4,1,3,18,18,0,0,0,3
"2011","E00007019","E00007019","Total",129,104,33,71,0,8,1,7,16,13,1,2,0,1
"2011","E00007022","E00007022","Total",125,96,36,60,0,6,2,4,23,21,0,2,0,0
"2011","E00007025","E00007025","Total",106,76,33,43,0,13,2,11,15,13,0,1,1,2
"2011","E00007027","E00007027","Total",144,63,33,30,0,49,30,19,30,29,0,1,0,2
"2011","E00007029","E00007029","Total",156,109,51,58,1,10,10,0,28,22,3,3,0,8
"2011","E00007030","E00007030","Total",113,98,60,38,1,3,3,0,7,7,0,0,0,4
"2011","E00007031","E00007031","Total",141,52,26,26,3,68,60,8,18,17,1,0,0,0
"2011","E00007032","E00007032","Total",118,93,62,31,0,4,3,1,20,17,0,3,0,1
"2011","E00007033","E00007033","Total",149,84,32,52,0,46,31,15,16,12,1,3,0,3
"2011","E00006991","E00006991","Total",122,95,48,47,0,19,17,2,6,6,0,0,0,2
"2011","E00006992","E00006992","Total",126,106,66,40,0,9,8,1,10,9,1,0,0,1
"2011","E00006994","E00006994","Total",122,114,53,61,1,1,0,1,5,5,0,0,0,1
"2011","E00006995","E00006995","Total",117,99,47,52,0,4,4,0,13,13,0,0,0,1
"2011","E00006998","E00006998","Total",125,110,61,49,0,9,2,7,6,6,0,0,0,0
"2011","E00007003","E00007003","Total",93,22,10,12,0,55,52,3,16,15,0,1,0,0
"2011","E00007006","E00007006","Total",184,45,17,28,2,119,119,0,14,14,0,0,0,4
"2011","E00007013","E00007013","Total",118,72,31,41,0,34,29,5,12,11,0,0,1,0
"2011","E00007014","E00007014","Total",158,62,24,38,25,55,50,5,14,12,0,2,0,2
"2011","E00007017","E00007017","Total",134,16,9,7,0,100,98,2,16,15,0,1,0,2
"2011","E00006993","E00006993","Total",132,92,42,50,2,21,19,2,16,15,1,0,0,1
"2011","E00006996","E00006996","Total",100,75,37,38,0,14,12,2,10,10,0,0,0,1
"2011","E00006999","E00006999","Total",128,112,36,76,0,7,5,2,9,9,0,0,0,0
"2011","E00007001","E00007001","Total",126,77,25,52,0,24,22,2,24,22,0,2,0,1
"2011","E00007007","E00007007","Total",127,96,38,58,0,4,4,0,24,23,1,0,0,3
"2011","E00007012","E00007012","Total",128,74,31,43,0,25,15,10,29,29,0,0,0,0
"2011","E00007016","E00007016","Total",134,85,29,56,2,19,12,7,27,27,0,0,0,1
"2011","E00007021","E00007021","Total",135,86,34,52,0,5,2,3,41,39,0,2,0,3
"2011","E00007028","E00007028","Total",151,87,33,54,0,14,8,6,48,46,0,0,2,2
"2011","E00171155","E00171155","Total",129,61,12,49,0,39,4,35,27,27,0,0,0,2
"2011","E00171156","E00171156","Total",129,28,2,26,5,34,9,25,60,57,1,1,1,2
"2011","E00006997","E00006997","Total",126,86,37,49,2,23,18,5,13,11,0,0,2,2
"2011","E00007002","E00007002","Total",115,50,17,33,0,40,34,6,23,21,0,2,0,2
"2011","E00007009","E00007009","Total",157,48,5,43,4,48,11,37,54,52,1,1,0,3
"2011","E00007010","E00007010","Total",114,34,15,19,0,72,72,0,8,7,0,1,0,0
"2011","E00007011","E00007011","Total",119,15,6,9,1,70,62,8,30,30,0,0,0,3
"2011","E00007018","E00007018","Total",124,39,5,34,4,54,5,49,24,22,0,2,0,3
"2011","E00007510","E00007510","Total",122,59,27,32,1,53,48,5,8,8,0,0,0,1
"2011","E00007511","E00007511","Total",119,83,32,51,0,23,21,2,12,12,0,0,0,1
"2011","E00007514","E00007514","Total",146,87,42,45,0,20,17,3,35,35,0,0,0,4
"2011","E00007518","E00007518","Total",123,61,18,43,0,46,38,8,12,12,0,0,0,4
"2011","E00007520","E00007520","Total",138,64,30,34,1,32,29,3,36,32,0,4,0,5
"2011","E00007623","E00007623","Total",132,76,23,53,2,4,2,2,50,49,0,1,0,0
"2011","E00007624","E00007624","Total",136,109,39,70,0,5,3,2,19,18,0,1,0,3
"2011","E00007625","E00007625","Total",138,69,27,42,0,6,4,2,62,60,0,2,0,1
"2011","E00007666","E00007666","Total",145,118,43,75,1,4,4,0,20,19,0,1,0,2
"2011","E00007667","E00007667","Total",158,98,45,53,1,7,7,0,50,50,0,0,0,2
"2011","E00007129","E00007129","Total",106,14,6,8,0,69,60,9,22,22,0,0,0,1
"2011","E00007134","E00007134","Total",137,83,33,50,0,12,8,4,39,39,0,0,0,3
"2011","E00007135","E00007135","Total",154,18,4,14,6,42,27,15,83,79,2,0,2,5
"2011","E00007139","E00007139","Total",112,53,27,26,0,27,14,13,27,25,0,1,1,5
"2011","E00007159","E00007159","Total",153,53,18,35,1,57,30,27,40,38,0,0,2,2
"2011","E00007166","E00007166","Total",128,72,28,44,0,10,7,3,44,43,0,1,0,2
"2011","E00007151","E00007151","Total",114,38,15,23,2,55,45,10,19,19,0,0,0,0
"2011","E00007152","E00007152","Total",118,11,5,6,1,86,82,4,18,16,0,2,0,2
"2011","E00007153","E00007153","Total",125,102,39,63,1,7,5,2,14,14,0,0,0,1
"2011","E00007154","E00007154","Total",126,40,13,27,4,51,47,4,28,26,0,1,1,3
"2011","E00007157","E00007157","Total",154,98,39,59,8,24,14,10,23,22,0,1,0,1
"2011","E00007512","E00007512","Total",161,40,9,31,0,80,76,4,40,38,0,0,2,1
"2011","E00007513","E00007513","Total",144,25,9,16,1,96,87,9,19,19,0,0,0,3
"2011","E00007515","E00007515","Total",141,27,8,19,0,92,82,10,19,19,0,0,0,3
"2011","E00007516","E00007516","Total",117,45,15,30,0,59,49,10,13,13,0,0,0,0
"2011","E00007517","E00007517","Total",133,55,12,43,0,49,36,13,28,28,0,0,0,1
"2011","E00007671","E00007671","Total",130,29,8,21,0,24,18,6,74,71,2,0,1,3
"2011","E00007672","E00007672","Total",133,32,10,22,2,20,16,4,74,74,0,0,0,5
"2011","E00007678","E00007678","Total",138,22,6,16,1,84,72,12,29,28,0,1,0,2
"2011","E00007679","E00007679","Total",128,93,30,63,0,11,7,4,23,23,0,0,0,1
"2011","E00007680","E00007680","Total",145,31,9,22,0,54,45,9,55,54,0,1,0,5
"2011","E00007681","E00007681","Total",124,55,18,37,1,34,28,6,34,33,0,0,1,0
"2011","E00007682","E00007682","Total",147,102,47,55,0,18,12,6,23,22,0,1,0,4
"2011","E00007683","E00007683","Total",154,79,24,55,0,49,16,33,22,22,0,0,0,4
"2011","E00007684","E00007684","Total",135,57,17,40,0,64,56,8,14,11,0,2,1,0
"2011","E00007685","E00007685","Total",134,83,28,55,1,34,27,7,16,16,0,0,0,0
"2011","E00007128","E00007128","Total",132,60,21,39,1,45,35,10,24,22,0,1,1,2
"2011","E00007155","E00007155","Total",122,48,16,32,0,55,46,9,16,15,0,0,1,3
"2011","E00007156","E00007156","Total",192,74,15,59,7,75,59,16,31,27,0,1,3,5
"2011","E00007161","E00007161","Total",138,57,14,43,1,58,50,8,19,19,0,0,0,3
"2011","E00007126","E00007126","Total",135,101,39,62,1,5,2,3,23,22,0,0,1,5
"2011","E00007160","E00007160","Total",133,98,45,53,0,10,8,2,22,20,0,2,0,3
"2011","E00007164","E00007164","Total",130,87,34,53,0,21,16,5,18,18,0,0,0,4
"2011","E00007165","E00007165","Total",153,111,40,71,0,17,14,3,25,24,0,1,0,0
"2011","E00007125","E00007125","Total",129,100,38,62,1,12,12,0,15,15,0,0,0,1
"2011","E00007158","E00007158","Total",129,101,50,51,0,5,3,2,21,20,0,1,0,2
"2011","E00007162","E00007162","Total",104,74,25,49,0,12,12,0,18,16,0,2,0,0
"2011","E00007163","E00007163","Total",127,94,37,57,0,6,4,2,26,24,0,2,0,1
"2011","E00007130","E00007130","Total",138,111,58,53,0,11,10,1,16,15,0,1,0,0
"2011","E00007131","E00007131","Total",131,106,48,58,0,11,4,7,14,12,0,2,0,0
"2011","E00007132","E00007132","Total",128,79,35,44,0,9,8,1,38,36,0,2,0,2
"2011","E00007138","E00007138","Total",130,96,36,60,1,7,5,2,23,23,0,0,0,3
"2011","E00007140","E00007140","Total",126,80,42,38,1,11,7,4,33,32,0,1,0,1
"2011","E00007124","E00007124","Total",142,75,32,43,0,37,20,17,29,27,0,2,0,1
"2011","E00007133","E00007133","Total",166,68,24,44,4,48,7,41,46,45,0,1,0,0
"2011","E00007137","E00007137","Total",134,85,30,55,0,18,16,2,31,29,0,2,0,0
"2011","E00007143","E00007143","Total",124,79,32,47,0,23,21,2,20,20,0,0,0,2
"2011","E00007293","E00007293","Total",154,120,63,57,0,9,2,7,23,21,0,2,0,2
"2011","E00007298","E00007298","Total",116,72,29,43,0,27,25,2,16,16,0,0,0,1
"2011","E00007328","E00007328","Total",124,86,33,53,0,30,29,1,8,5,0,3,0,0
"2011","E00007331","E00007331","Total",121,69,29,40,1,36,30,6,13,12,0,0,1,2
"2011","E00007333","E00007333","Total",118,90,50,40,0,9,9,0,18,18,0,0,0,1
"2011","E00007637","E00007637","Total",74,51,20,31,0,14,11,3,8,8,0,0,0,1
"2011","E00007649","E00007649","Total",127,115,57,58,0,4,2,2,7,7,0,0,0,1
"2011","E00007653","E00007653","Total",150,118,60,58,0,2,2,0,29,25,2,2,0,1
"2011","E00007659","E00007659","Total",129,87,44,43,0,7,6,1,31,28,0,3,0,4
"2011","E00007661","E00007661","Total",107,66,36,30,0,28,26,2,12,11,0,1,0,1
"2011","E00007665","E00007665","Total",155,62,27,35,1,8,8,0,80,79,1,0,0,4
"2011","E00007628","E00007628","Total",212,137,41,96,0,6,6,0,66,62,1,3,0,3
"2011","E00007631","E00007631","Total",132,95,59,36,0,4,1,3,31,27,0,2,2,2
"2011","E00007635","E00007635","Total",176,120,45,75,1,2,2,0,51,44,0,7,0,2
"2011","E00007643","E00007643","Total",122,78,30,48,0,6,5,1,37,36,0,1,0,1
"2011","E00007648","E00007648","Total",152,90,38,52,1,5,5,0,55,49,2,3,1,1
"2011","E00007634","E00007634","Total",123,78,29,49,5,3,1,2,34,33,0,1,0,3
"2011","E00007636","E00007636","Total",117,71,23,48,22,3,1,2,21,21,0,0,0,0
"2011","E00007641","E00007641","Total",140,121,43,78,0,3,0,3,15,13,0,1,1,1
"2011","E00007642","E00007642","Total",142,97,37,60,1,19,18,1,23,23,0,0,0,2
"2011","E00007652","E00007652","Total",128,119,50,69,0,2,2,0,7,7,0,0,0,0
"2011","E00007639","E00007639","Total",157,84,45,39,0,30,23,7,39,38,0,0,1,4
"2011","E00007644","E00007644","Total",136,102,36,66,1,6,3,3,27,26,0,1,0,0
"2011","E00007646","E00007646","Total",137,81,35,46,0,26,25,1,29,29,0,0,0,1
"2011","E00007654","E00007654","Total",118,36,8,28,2,66,22,44,13,10,0,3,0,1
"2011","E00007656","E00007656","Total",130,107,58,49,0,10,8,2,11,10,1,0,0,2
"2011","E00007622","E00007622","Total",110,86,46,40,1,18,4,14,4,3,1,0,0,1
"2011","E00007627","E00007627","Total",120,106,48,58,0,3,1,2,11,10,1,0,0,0
"2011","E00007633","E00007633","Total",130,126,59,67,1,0,0,0,2,1,0,0,1,1
"2011","E00007638","E00007638","Total",123,114,53,61,0,2,1,1,5,4,1,0,0,2
"2011","E00007647","E00007647","Total",120,113,59,54,2,1,0,1,1,1,0,0,0,3
"2011","E00007626","E00007626","Total",119,101,51,50,1,5,3,2,12,12,0,0,0,0
"2011","E00007629","E00007629","Total",129,113,51,62,0,3,0,3,10,10,0,0,0,3
"2011","E00007630","E00007630","Total",125,102,53,49,1,3,1,2,17,17,0,0,0,2
"2011","E00007632","E00007632","Total",141,73,34,39,1,24,20,4,41,40,0,0,1,2
"2011","E00007640","E00007640","Total",143,129,68,61,0,1,1,0,11,10,0,0,1,2
"2011","E00007645","E00007645","Total",129,120,56,64,0,3,1,2,4,4,0,0,0,2
"2011","E00007650","E00007650","Total",116,106,52,54,0,0,0,0,9,9,0,0,0,1
"2011","E00007651","E00007651","Total",128,104,50,54,0,9,1,8,15,9,1,3,2,0
"2011","E00007655","E00007655","Total",121,109,48,61,0,2,1,1,10,10,0,0,0,0
"2011","E00007663","E00007663","Total",102,94,48,46,0,1,0,1,6,5,0,0,1,1
"2011","E00007657","E00007657","Total",123,100,51,49,2,6,6,0,10,10,0,0,0,5
"2011","E00007658","E00007658","Total",115,113,54,59,0,0,0,0,2,2,0,0,0,0
"2011","E00007660","E00007660","Total",110,106,59,47,0,2,0,2,1,1,0,0,0,1
"2011","E00007662","E00007662","Total",121,106,66,40,0,1,0,1,12,11,0,1,0,2
"2011","E00007664","E00007664","Total",141,105,69,36,1,3,1,2,32,31,0,1,0,0
"2011","E00007210","E00007210","Total",154,84,34,50,4,3,3,0,62,62,0,0,0,1
"2011","E00007211","E00007211","Total",155,103,44,59,0,4,3,1,43,38,1,3,1,5
"2011","E00007212","E00007212","Total",167,124,75,49,0,3,2,1,38,34,1,3,0,2
"2011","E00007213","E00007213","Total",87,73,46,27,0,0,0,0,13,13,0,0,0,1
"2011","E00007215","E00007215","Total",105,69,41,28,0,2,2,0,33,33,0,0,0,1
"2011","E00007217","E00007217","Total",130,105,60,45,0,3,1,2,22,21,0,1,0,0
"2011","E00007324","E00007324","Total",162,85,34,51,0,5,3,2,71,38,24,1,8,1
"2011","E00007325","E00007325","Total",111,90,54,36,0,1,0,1,19,19,0,0,0,1
"2011","E00007326","E00007326","Total",127,122,63,59,0,1,1,0,4,4,0,0,0,0
"2011","E00007327","E00007327","Total",124,44,27,17,0,68,6,62,10,10,0,0,0,2
"2011","E00007294","E00007294","Total",171,117,59,58,1,12,8,4,40,36,1,3,0,1
"2011","E00007295","E00007295","Total",117,87,44,43,0,1,1,0,29,26,0,3,0,0
"2011","E00007297","E00007297","Total",141,96,32,64,0,1,1,0,42,39,0,3,0,2
"2011","E00007301","E00007301","Total",123,108,90,18,0,1,0,1,12,11,0,0,1,2
"2011","E00007329","E00007329","Total",125,92,46,46,0,1,0,1,31,31,0,0,0,1
"2011","E00007330","E00007330","Total",133,81,32,49,0,4,1,3,47,47,0,0,0,1
"2011","E00007332","E00007332","Total",120,74,26,48,0,1,0,1,45,41,0,4,0,0
"2011","E00007296","E00007296","Total",126,59,24,35,6,28,26,2,32,31,0,0,1,1
"2011","E00007299","E00007299","Total",137,104,54,50,0,6,6,0,23,22,0,1,0,4
"2011","E00007304","E00007304","Total",150,125,45,80,0,4,3,1,21,21,0,0,0,0
"2011","E00007306","E00007306","Total",122,90,55,35,0,5,4,1,25,25,0,0,0,2
"2011","E00007308","E00007308","Total",99,33,17,16,0,3,3,0,59,54,1,3,1,4
"2011","E00007334","E00007334","Total",137,114,58,56,0,2,1,1,20,20,0,0,0,1
"2011","E00007300","E00007300","Total",133,98,49,49,0,6,5,1,28,27,0,0,1,1
"2011","E00007302","E00007302","Total",128,91,41,50,0,0,0,0,35,33,0,2,0,2
"2011","E00007305","E00007305","Total",118,90,46,44,1,2,2,0,24,21,0,2,1,1
"2011","E00007309","E00007309","Total",157,138,77,61,0,2,0,2,14,12,0,2,0,3
"2011","E00007311","E00007311","Total",143,95,59,36,1,6,3,3,41,41,0,0,0,0
"2011","E00007314","E00007314","Total",161,116,55,61,0,1,1,0,43,43,0,0,0,1
"2011","E00007058","E00007058","Total",144,73,43,30,0,17,2,15,49,47,1,1,0,5
"2011","E00007062","E00007062","Total",97,33,14,19,0,2,1,1,59,56,2,1,0,3
"2011","E00007064","E00007064","Total",125,15,12,3,0,84,77,7,25,22,0,2,1,1
"2011","E00007065","E00007065","Total",127,117,71,46,0,2,1,1,8,8,0,0,0,0
"2011","E00007066","E00007066","Total",184,163,101,62,0,1,1,0,16,16,0,0,0,4
"2011","E00007050","E00007050","Total",133,126,65,61,0,0,0,0,5,5,0,0,0,2
"2011","E00007054","E00007054","Total",130,123,59,64,0,3,2,1,3,3,0,0,0,1
"2011","E00007056","E00007056","Total",181,161,105,56,0,2,1,1,16,16,0,0,0,2
"2011","E00171166","E00171166","Total",68,58,25,33,0,2,2,0,8,8,0,0,0,0
"2011","E00171167","E00171167","Total",89,70,40,30,0,10,9,1,6,2,1,0,3,3
"2011","E00007038","E00007038","Total",162,65,34,31,0,44,37,7,53,52,0,1,0,0
"2011","E00007060","E00007060","Total",126,116,60,56,0,1,1,0,7,7,0,0,0,2
"2011","E00007061","E00007061","Total",142,119,67,52,0,2,0,2,20,20,0,0,0,1
"2011","E00007067","E00007067","Total",150,69,39,30,6,44,39,5,26,22,0,0,4,5
"2011","E00007068","E00007068","Total",123,67,40,27,0,31,1,30,24,23,0,0,1,1
"2011","E00007052","E00007052","Total",138,126,76,50,0,1,1,0,7,7,0,0,0,4
"2011","E00007053","E00007053","Total",139,122,66,56,1,0,0,0,15,15,0,0,0,1
"2011","E00007055","E00007055","Total",142,130,64,66,0,0,0,0,9,9,0,0,0,3
"2011","E00007057","E00007057","Total",140,133,73,60,0,1,0,1,5,5,0,0,0,1
"2011","E00007136","E00007136","Total",139,66,34,32,0,43,39,4,29,29,0,0,0,1
"2011","E00007141","E00007141","Total",107,43,14,29,1,44,36,8,18,14,0,2,2,1
"2011","E00007144","E00007144","Total",128,96,40,56,0,7,4,3,24,24,0,0,0,1
"2011","E00007146","E00007146","Total",109,74,36,38,0,15,10,5,18,18,0,0,0,2
"2011","E00007147","E00007147","Total",114,93,37,56,0,8,5,3,13,12,0,1,0,0
"2011","E00007460","E00007460","Total",121,90,42,48,1,7,6,1,23,23,0,0,0,0
"2011","E00007464","E00007464","Total",128,88,40,48,1,21,16,5,17,17,0,0,0,1
"2011","E00007469","E00007469","Total",124,86,36,50,0,9,2,7,26,26,0,0,0,3
"2011","E00007470","E00007470","Total",140,78,34,44,2,17,7,10,41,38,0,3,0,2
"2011","E00007459","E00007459","Total",122,104,51,53,0,7,5,2,9,9,0,0,0,2
"2011","E00007461","E00007461","Total",157,64,13,51,2,20,6,14,71,68,1,2,0,0
"2011","E00007462","E00007462","Total",139,72,29,43,0,32,18,14,30,29,0,0,1,5
"2011","E00007466","E00007466","Total",149,67,19,48,2,58,53,5,20,20,0,0,0,2
"2011","E00007468","E00007468","Total",159,97,56,41,0,22,16,6,38,36,2,0,0,2
"2011","E00007471","E00007471","Total",207,63,28,35,20,45,14,31,74,70,0,1,3,5
"2011","E00007475","E00007475","Total",120,33,6,27,0,29,4,25,56,53,0,3,0,2
"2011","E00007486","E00007486","Total",149,33,17,16,0,40,29,11,71,71,0,0,0,5
"2011","E00007489","E00007489","Total",131,50,11,39,0,53,40,13,21,21,0,0,0,7
"2011","E00007476","E00007476","Total",140,49,16,33,0,36,12,24,51,50,1,0,0,4
"2011","E00007483","E00007483","Total",151,71,34,37,2,18,14,4,58,56,0,2,0,2
"2011","E00007487","E00007487","Total",146,90,32,58,0,14,7,7,39,37,0,0,2,3
"2011","E00171158","E00171158","Total",127,70,36,34,1,6,4,2,49,47,0,2,0,1
"2011","E00171480","E00171480","Total",154,22,8,14,51,51,13,38,28,28,0,0,0,2
"2011","E00007499","E00007499","Total",122,69,28,41,1,32,29,3,18,17,0,1,0,2
"2011","E00007519","E00007519","Total",133,45,9,36,0,66,60,6,20,20,0,0,0,2
"2011","E00007521","E00007521","Total",119,52,13,39,2,49,32,17,12,12,0,0,0,4
"2011","E00007522","E00007522","Total",116,43,15,28,3,54,49,5,16,15,1,0,0,0
"2011","E00007523","E00007523","Total",133,94,34,60,0,3,1,2,35,33,0,2,0,1
"2011","E00007035","E00007035","Total",133,127,70,57,0,0,0,0,5,5,0,0,0,1
"2011","E00007039","E00007039","Total",117,93,54,39,0,15,4,11,8,8,0,0,0,1
"2011","E00007063","E00007063","Total",121,114,51,63,0,0,0,0,6,5,0,1,0,1
"2011","E00007069","E00007069","Total",112,106,59,47,0,0,0,0,4,4,0,0,0,2
"2011","E00007072","E00007072","Total",115,110,55,55,1,1,1,0,3,3,0,0,0,0
"2011","E00007303","E00007303","Total",131,119,75,44,0,0,0,0,11,10,0,1,0,1
"2011","E00007307","E00007307","Total",128,123,78,45,0,0,0,0,5,5,0,0,0,0
"2011","E00007310","E00007310","Total",125,102,64,38,0,9,9,0,9,8,0,1,0,5
"2011","E00007315","E00007315","Total",118,104,51,53,0,3,2,1,9,5,0,2,2,2
"2011","E00007316","E00007316","Total",139,102,51,51,0,17,15,2,20,19,1,0,0,0
"2011","E00007312","E00007312","Total",162,99,44,55,6,47,6,41,9,7,0,0,2,1
"2011","E00007313","E00007313","Total",124,110,61,49,0,5,4,1,6,6,0,0,0,3
"2011","E00007320","E00007320","Total",121,85,40,45,1,24,24,0,11,11,0,0,0,0
"2011","E00007322","E00007322","Total",140,94,51,43,2,24,21,3,17,17,0,0,0,3
"2011","E00007317","E00007317","Total",119,107,53,54,0,1,1,0,10,9,0,1,0,1
"2011","E00007318","E00007318","Total",120,113,59,54,0,2,1,1,5,5,0,0,0,0
"2011","E00007319","E00007319","Total",129,119,80,39,1,0,0,0,9,6,0,3,0,0
"2011","E00007321","E00007321","Total",128,117,65,52,0,4,2,2,4,4,0,0,0,3
"2011","E00007323","E00007323","Total",139,117,58,59,1,3,3,0,18,18,0,0,0,0
"2011","E00007127","E00007127","Total",210,109,50,59,11,30,11,19,57,56,0,1,0,3
"2011","E00007142","E00007142","Total",137,24,5,19,0,93,55,38,17,17,0,0,0,3
"2011","E00007148","E00007148","Total",134,86,50,36,0,34,29,5,14,14,0,0,0,0
"2011","E00007149","E00007149","Total",118,10,4,6,1,90,89,1,13,12,0,1,0,4
"2011","E00007150","E00007150","Total",117,13,4,9,0,87,84,3,16,15,0,1,0,1
"2011","E00171159","E00171159","Total",46,34,15,19,0,8,7,1,4,3,0,1,0,0
"2011","E00171163","E00171163","Total",113,35,6,29,0,11,5,6,66,66,0,0,0,1
"2011","E00171164","E00171164","Total",115,30,4,26,0,24,4,20,60,60,0,0,0,1
"2011","E00007463","E00007463","Total",134,85,36,49,0,22,11,11,27,22,0,5,0,0
"2011","E00007473","E00007473","Total",154,78,23,55,1,24,18,6,50,49,0,0,1,1
"2011","E00007477","E00007477","Total",124,48,20,28,2,38,31,7,34,33,0,1,0,2
"2011","E00007481","E00007481","Total",153,39,12,27,1,64,29,35,44,41,3,0,0,5
"2011","E00007472","E00007472","Total",141,73,29,44,0,15,8,7,52,46,0,4,2,1
"2011","E00007474","E00007474","Total",139,87,41,46,0,13,9,4,35,33,0,2,0,4
"2011","E00007478","E00007478","Total",129,85,34,51,1,14,8,6,27,26,0,1,0,2
"2011","E00007480","E00007480","Total",134,32,3,29,6,28,14,14,67,66,0,1,0,1
"2011","E00007482","E00007482","Total",145,34,7,27,5,50,21,29,55,53,0,2,0,1
"2011","E00007465","E00007465","Total",175,21,5,16,1,126,112,14,27,26,0,1,0,0
"2011","E00007479","E00007479","Total",173,17,6,11,2,132,131,1,19,18,0,1,0,3
"2011","E00007485","E00007485","Total",131,6,4,2,2,107,106,1,14,13,0,1,0,2
"2011","E00007491","E00007491","Total",131,10,6,4,0,114,112,2,7,7,0,0,0,0
"2011","E00006978","E00006978","Total",217,114,63,51,0,49,18,31,52,52,0,0,0,2
"2011","E00006979","E00006979","Total",140,105,76,29,0,1,1,0,33,32,0,1,0,1
"2011","E00006982","E00006982","Total",116,97,61,36,0,4,4,0,15,13,0,2,0,0
"2011","E00006983","E00006983","Total",122,102,58,44,1,2,0,2,17,17,0,0,0,0
"2011","E00006987","E00006987","Total",140,82,43,39,0,2,1,1,55,52,0,3,0,1
"2011","E00006990","E00006990","Total",127,89,52,37,0,1,1,0,34,34,0,0,0,3
"2011","E00006980","E00006980","Total",135,74,13,61,0,29,23,6,30,28,0,0,2,2
"2011","E00006981","E00006981","Total",137,106,46,60,1,6,4,2,24,24,0,0,0,0
"2011","E00006984","E00006984","Total",119,79,24,55,1,14,13,1,23,23,0,0,0,2
"2011","E00006985","E00006985","Total",124,73,39,34,0,22,19,3,28,28,0,0,0,1
"2011","E00006986","E00006986","Total",160,58,25,33,1,26,5,21,73,69,0,1,3,2
"2011","E00007218","E00007218","Total",141,75,29,46,0,24,18,6,40,39,0,1,0,2
"2011","E00007220","E00007220","Total",126,61,34,27,2,37,35,2,25,21,0,4,0,1
"2011","E00007223","E00007223","Total",119,65,33,32,0,1,1,0,52,50,0,1,1,1
"2011","E00007226","E00007226","Total",132,106,63,43,0,1,1,0,25,23,0,2,0,0
"2011","E00007232","E00007232","Total",136,101,67,34,0,2,0,2,30,30,0,0,0,3
"2011","E00171152","E00171152","Total",138,51,20,31,0,9,6,3,73,71,0,1,1,5
"2011","E00171153","E00171153","Total",132,33,14,19,0,4,4,0,94,92,0,1,1,1
"2011","E00007527","E00007527","Total",117,55,21,34,0,37,3,34,23,22,0,1,0,2
"2011","E00007528","E00007528","Total",120,49,21,28,0,14,10,4,57,51,0,5,1,0
"2011","E00007532","E00007532","Total",132,106,32,74,1,3,3,0,21,20,0,1,0,1
"2011","E00007534","E00007534","Total",144,122,42,80,0,4,4,0,18,17,0,1,0,0
"2011","E00007537","E00007537","Total",129,69,22,47,0,3,3,0,57,55,0,2,0,0
"2011","E00007538","E00007538","Total",140,107,37,70,0,6,2,4,25,24,0,1,0,2
"2011","E00007502","E00007502","Total",106,35,10,25,1,46,44,2,22,22,0,0,0,2
"2011","E00007503","E00007503","Total",126,33,7,26,0,69,65,4,24,23,0,1,0,0
"2011","E00007507","E00007507","Total",234,34,12,22,5,111,97,14,80,80,0,0,0,4
"2011","E00007508","E00007508","Total",135,97,29,68,0,4,2,2,34,34,0,0,0,0
"2011","E00007509","E00007509","Total",154,30,10,20,1,100,97,3,23,22,0,0,1,0
"2011","E00006950","E00006950","Total",127,114,55,59,0,4,1,3,9,9,0,0,0,0
"2011","E00006951","E00006951","Total",105,93,41,52,2,5,4,1,4,4,0,0,0,1
"2011","E00006988","E00006988","Total",135,116,50,66,0,6,6,0,12,12,0,0,0,1
"2011","E00006989","E00006989","Total",134,118,53,65,0,5,4,1,10,10,0,0,0,1
"2011","E00007356","E00007356","Total",133,83,34,49,0,29,25,4,21,21,0,0,0,0
"2011","E00007358","E00007358","Total",146,124,58,66,0,4,4,0,18,17,0,1,0,0
"2011","E00007362","E00007362","Total",135,95,41,54,1,18,17,1,19,17,0,2,0,2
"2011","E00007365","E00007365","Total",130,75,38,37,0,34,31,3,20,20,0,0,0,1
"2011","E00007354","E00007354","Total",134,100,38,62,0,4,3,1,28,27,0,1,0,2
"2011","E00007355","E00007355","Total",139,108,54,54,1,5,2,3,25,23,0,2,0,0
"2011","E00007359","E00007359","Total",118,89,46,43,0,2,2,0,26,25,0,1,0,1
"2011","E00007363","E00007363","Total",125,101,58,43,0,5,4,1,18,16,0,2,0,1
"2011","E00007498","E00007498","Total",132,84,29,55,1,7,3,4,39,39,0,0,0,1
"2011","E00007530","E00007530","Total",112,92,37,55,1,3,1,2,16,15,0,1,0,0
"2011","E00007533","E00007533","Total",130,109,45,64,0,4,3,1,16,14,0,2,0,1
"2011","E00007535","E00007535","Total",123,97,43,54,0,3,2,1,23,22,0,1,0,0
"2011","E00007536","E00007536","Total",151,107,29,78,0,8,5,3,36,36,0,0,0,0
"2011","E00007500","E00007500","Total",145,124,49,75,1,6,5,1,13,13,0,0,0,1
"2011","E00007501","E00007501","Total",166,87,25,62,0,43,41,2,35,33,0,2,0,1
"2011","E00007504","E00007504","Total",122,59,18,41,0,45,41,4,14,14,0,0,0,4
"2011","E00007505","E00007505","Total",119,69,21,48,2,21,21,0,26,25,0,0,1,1
"2011","E00007506","E00007506","Total",133,90,38,52,1,5,2,3,33,32,0,1,0,4
"2011","E00007524","E00007524","Total",127,87,41,46,1,3,1,2,36,36,0,0,0,0
"2011","E00007525","E00007525","Total",150,62,12,50,1,5,2,3,82,82,0,0,0,0
"2011","E00007526","E00007526","Total",116,88,31,57,0,10,3,7,18,17,0,1,0,0
"2011","E00007529","E00007529","Total",155,98,45,53,1,8,7,1,46,40,0,4,2,2
"2011","E00007531","E00007531","Total",136,116,44,72,0,1,0,1,17,17,0,0,0,2
"2011","E00007216","E00007216","Total",130,91,46,45,0,1,0,1,36,35,0,1,0,2
"2011","E00007221","E00007221","Total",144,113,59,54,0,5,4,1,25,23,0,2,0,1
"2011","E00007222","E00007222","Total",137,118,69,49,0,5,4,1,13,13,0,0,0,1
"2011","E00007227","E00007227","Total",134,107,66,41,0,7,7,0,19,19,0,0,0,1
"2011","E00007233","E00007233","Total",116,110,61,49,0,1,0,1,5,5,0,0,0,0
"2011","E00007225","E00007225","Total",144,135,69,66,0,0,0,0,9,9,0,0,0,0
"2011","E00007231","E00007231","Total",121,111,57,54,0,0,0,0,5,4,1,0,0,5
"2011","E00007237","E00007237","Total",110,98,44,54,0,2,2,0,9,9,0,0,0,1
"2011","E00007247","E00007247","Total",113,87,38,49,0,11,10,1,14,12,0,2,0,1
"2011","E00007208","E00007208","Total",141,116,66,50,0,2,1,1,21,20,0,1,0,2
"2011","E00007219","E00007219","Total",116,90,48,42,0,17,1,16,7,6,0,1,0,2
"2011","E00007224","E00007224","Total",133,126,68,58,0,0,0,0,7,7,0,0,0,0
"2011","E00007228","E00007228","Total",154,136,85,51,1,6,5,1,10,10,0,0,0,1
"2011","E00007238","E00007238","Total",117,84,51,33,0,3,1,2,28,26,0,2,0,2
"2011","E00007229","E00007229","Total",125,112,82,30,0,0,0,0,11,10,1,0,0,2
"2011","E00007230","E00007230","Total",133,103,50,53,0,1,0,1,23,22,0,1,0,6
"2011","E00007234","E00007234","Total",131,129,77,52,0,1,0,1,1,1,0,0,0,0
"2011","E00007236","E00007236","Total",138,121,65,56,0,1,0,1,14,12,0,2,0,2
"2011","E00007240","E00007240","Total",133,82,42,40,2,3,2,1,43,38,0,2,3,3
"2011","E00007357","E00007357","Total",133,109,53,56,2,3,2,1,18,18,0,0,0,1
"2011","E00007360","E00007360","Total",100,38,14,24,0,7,6,1,51,45,0,4,2,4
"2011","E00007361","E00007361","Total",117,67,31,36,1,33,30,3,15,14,0,1,0,1
"2011","E00007364","E00007364","Total",125,84,40,44,0,10,7,3,30,30,0,0,0,1
"2011","E00007369","E00007369","Total",118,76,31,45,0,16,12,4,22,20,0,0,2,4
"2011","E00007339","E00007339","Total",126,62,32,30,0,37,30,7,24,22,0,1,1,3
"2011","E00007366","E00007366","Total",118,51,17,34,0,48,41,7,15,15,0,0,0,4
"2011","E00007368","E00007368","Total",123,57,23,34,0,37,33,4,26,26,0,0,0,3
"2011","E00007370","E00007370","Total",125,68,31,37,0,40,32,8,15,15,0,0,0,2
"2011","E00007371","E00007371","Total",115,80,30,50,0,17,13,4,16,16,0,0,0,2
"2011","E00007335","E00007335","Total",136,108,49,59,1,4,4,0,21,21,0,0,0,2
"2011","E00007342","E00007342","Total",127,76,39,37,5,11,6,5,34,33,0,1,0,1
"2011","E00007346","E00007346","Total",145,112,50,62,0,7,6,1,24,24,0,0,0,2
"2011","E00007375","E00007375","Total",148,97,39,58,0,25,20,5,24,19,0,5,0,2
"2011","E00007488","E00007488","Total",130,77,33,44,0,18,13,5,32,29,1,1,1,3
"2011","E00007492","E00007492","Total",128,98,62,36,0,4,3,1,24,24,0,0,0,2
"2011","E00007497","E00007497","Total",154,72,23,49,0,60,33,27,18,18,0,0,0,4
"2011","E00171161","E00171161","Total",91,47,19,28,3,12,3,9,27,25,0,1,1,2
"2011","E00171181","E00171181","Total",96,44,16,28,0,30,9,21,19,19,0,0,0,3
"2011","E00007484","E00007484","Total",123,71,29,42,1,15,14,1,36,31,0,5,0,0
"2011","E00007493","E00007493","Total",137,101,47,54,0,2,2,0,31,27,0,4,0,3
"2011","E00007494","E00007494","Total",152,62,25,37,1,53,53,0,35,35,0,0,0,1
"2011","E00007495","E00007495","Total",126,94,32,62,1,9,7,2,21,21,0,0,0,1
"2011","E00007496","E00007496","Total",116,74,36,38,0,19,7,12,21,20,0,1,0,2
"2011","E00007564","E00007564","Total",129,77,43,34,0,29,14,15,22,21,0,1,0,1
"2011","E00007565","E00007565","Total",135,39,20,19,3,59,54,5,33,32,0,0,1,1
"2011","E00007566","E00007566","Total",122,104,50,54,0,2,1,1,15,15,0,0,0,1
"2011","E00007569","E00007569","Total",158,75,28,47,0,22,21,1,60,58,1,1,0,1
"2011","E00007572","E00007572","Total",129,116,64,52,0,3,1,2,8,8,0,0,0,2
"2011","E00007540","E00007540","Total",141,75,14,61,24,1,1,0,41,41,0,0,0,0
"2011","E00007541","E00007541","Total",139,80,33,47,0,2,2,0,55,51,0,4,0,2
"2011","E00007542","E00007542","Total",115,80,27,53,1,12,0,12,22,21,0,1,0,0
"2011","E00007543","E00007543","Total",184,125,50,75,1,1,1,0,55,53,0,1,1,2
"2011","E00007544","E00007544","Total",172,43,9,34,18,70,5,65,41,40,1,0,0,0
"2011","E00007545","E00007545","Total",129,84,23,61,1,2,1,1,42,41,0,1,0,0
"2011","E00007546","E00007546","Total",121,104,85,19,1,2,0,2,11,11,0,0,0,3
"2011","E00007550","E00007550","Total",137,121,61,60,0,3,3,0,11,11,0,0,0,2
"2011","E00007551","E00007551","Total",127,101,57,44,0,3,3,0,22,22,0,0,0,1
"2011","E00007553","E00007553","Total",110,62,30,32,1,2,1,1,42,40,0,2,0,3
"2011","E00007562","E00007562","Total",114,107,59,48,0,3,0,3,4,4,0,0,0,0
"2011","E00007548","E00007548","Total",131,95,46,49,1,4,3,1,30,30,0,0,0,1
"2011","E00007549","E00007549","Total",122,98,50,48,0,7,3,4,13,12,0,1,0,4
"2011","E00007552","E00007552","Total",72,8,4,4,0,61,3,58,3,3,0,0,0,0
"2011","E00007555","E00007555","Total",119,98,57,41,0,2,1,1,16,13,0,2,1,3
"2011","E00007559","E00007559","Total",102,53,28,25,1,14,2,12,34,33,0,1,0,0
"2011","E00007547","E00007547","Total",114,100,58,42,0,4,4,0,10,10,0,0,0,0
"2011","E00007554","E00007554","Total",131,119,62,57,1,1,1,0,9,9,0,0,0,1
"2011","E00007557","E00007557","Total",122,77,37,40,0,0,0,0,44,42,0,2,0,1
"2011","E00007560","E00007560","Total",147,125,84,41,0,2,1,1,19,19,0,0,0,1
"2011","E00007561","E00007561","Total",125,113,59,54,0,2,2,0,9,9,0,0,0,1
"2011","E00007037","E00007037","Total",123,52,28,24,0,16,16,0,51,51,0,0,0,4
"2011","E00007040","E00007040","Total",123,112,61,51,0,1,1,0,8,8,0,0,0,2
"2011","E00007041","E00007041","Total",125,72,37,35,2,30,25,5,19,18,0,1,0,2
"2011","E00007059","E00007059","Total",122,69,40,29,1,5,5,0,44,39,2,2,1,3
"2011","E00007070","E00007070","Total",164,100,52,48,0,3,2,1,59,58,0,1,0,2
"2011","E00007071","E00007071","Total",137,98,66,32,0,0,0,0,37,36,0,1,0,2
"2011","E00007042","E00007042","Total",114,67,27,40,0,16,14,2,31,29,0,2,0,0
"2011","E00007043","E00007043","Total",131,78,40,38,0,31,31,0,22,20,0,2,0,0
"2011","E00007044","E00007044","Total",114,97,52,45,0,2,1,1,14,12,1,1,0,1
"2011","E00007045","E00007045","Total",104,24,7,17,0,62,61,1,18,17,0,1,0,0
"2011","E00007073","E00007073","Total",106,41,22,19,2,23,20,3,39,37,0,1,1,1
"2011","E00007034","E00007034","Total",121,85,73,12,1,5,5,0,23,21,0,2,0,7
"2011","E00007036","E00007036","Total",118,39,15,24,1,16,4,12,61,60,0,1,0,1
"2011","E00007046","E00007046","Total",104,27,12,15,0,59,58,1,17,15,0,2,0,1
"2011","E00007047","E00007047","Total",123,89,48,41,0,4,3,1,26,23,0,3,0,4
"2011","E00007048","E00007048","Total",115,27,7,20,0,64,63,1,22,22,0,0,0,2
"2011","E00007049","E00007049","Total",133,73,27,46,1,26,26,0,32,31,0,1,0,1
"2011","E00007568","E00007568","Total",139,81,51,30,0,3,1,2,54,49,0,5,0,1
"2011","E00007571","E00007571","Total",133,57,34,23,0,2,0,2,72,66,0,5,1,2
"2011","E00007573","E00007573","Total",147,71,46,25,0,2,0,2,71,71,0,0,0,3
"2011","E00007575","E00007575","Total",165,71,35,36,1,8,1,7,82,78,1,3,0,3
"2011","E00007576","E00007576","Total",127,56,26,30,0,4,3,1,65,64,1,0,0,2
"2011","E00007577","E00007577","Total",111,33,9,24,0,1,1,0,77,77,0,0,0,0
"2011","E00171178","E00171178","Total",103,34,11,23,1,23,3,20,44,39,2,1,2,1
"2011","E00171180","E00171180","Total",108,39,11,28,1,1,0,1,64,62,0,2,0,3
"2011","E00171481","E00171481","Total",108,17,8,9,1,5,2,3,82,78,0,3,1,3
"2011","E00007539","E00007539","Total",147,100,61,39,2,6,3,3,38,36,0,2,0,1
"2011","E00007556","E00007556","Total",132,87,51,36,0,1,1,0,44,44,0,0,0,0
"2011","E00007558","E00007558","Total",156,85,43,42,10,2,1,1,59,59,0,0,0,0
"2011","E00007563","E00007563","Total",137,90,41,49,0,13,12,1,32,32,0,0,0,2
"2011","E00007570","E00007570","Total",151,106,51,55,0,13,10,3,30,30,0,0,0,2
"2011","E00006953","E00006953","Total",121,110,48,62,0,2,2,0,9,7,0,2,0,0
"2011","E00006954","E00006954","Total",130,116,48,68,0,4,3,1,8,8,0,0,0,2
"2011","E00006955","E00006955","Total",120,105,44,61,0,1,1,0,14,13,0,0,1,0
"2011","E00006956","E00006956","Total",120,111,46,65,0,1,0,1,7,7,0,0,0,1
"2011","E00006958","E00006958","Total",131,126,47,79,0,0,0,0,5,4,0,1,0,0
"2011","E00006962","E00006962","Total",120,113,51,62,0,2,2,0,5,4,0,1,0,0
"2011","E00006963","E00006963","Total",129,111,51,60,0,2,1,1,16,16,0,0,0,0
"2011","E00006966","E00006966","Total",119,108,69,39,1,4,2,2,6,5,0,1,0,0
"2011","E00006952","E00006952","Total",107,92,62,30,1,2,1,1,10,9,0,1,0,2
"2011","E00006957","E00006957","Total",107,96,62,34,0,3,3,0,7,5,0,2,0,1
"2011","E00006959","E00006959","Total",111,103,60,43,0,1,1,0,6,6,0,0,0,1
"2011","E00006960","E00006960","Total",122,121,82,39,0,0,0,0,1,1,0,0,0,0
"2011","E00006961","E00006961","Total",140,109,63,46,0,1,1,0,30,29,0,0,1,0
"2011","E00006964","E00006964","Total",141,108,45,63,0,1,1,0,29,27,0,2,0,3
"2011","E00006965","E00006965","Total",117,102,55,47,0,0,0,0,12,12,0,0,0,3
"2011","E00006968","E00006968","Total",187,113,59,54,1,7,5,2,64,61,0,3,0,2
"2011","E00006969","E00006969","Total",123,117,58,59,0,0,0,0,5,5,0,0,0,1
"2011","E00006970","E00006970","Total",123,105,46,59,0,3,3,0,12,11,0,1,0,3
"2011","E00006949","E00006949","Total",136,113,58,55,1,7,7,0,15,15,0,0,0,0
"2011","E00006967","E00006967","Total",122,72,42,30,1,13,5,8,35,33,0,2,0,1
"2011","E00006971","E00006971","Total",112,96,55,41,0,3,2,1,10,9,0,0,1,3
"2011","E00006972","E00006972","Total",135,114,63,51,1,0,0,0,17,16,0,1,0,3
"2011","E00006973","E00006973","Total",128,115,58,57,0,1,0,1,11,11,0,0,0,1
"2011","E00007209","E00007209","Total",121,115,62,53,0,1,0,1,5,5,0,0,0,0
"2011","E00007235","E00007235","Total",129,119,58,61,1,0,0,0,8,8,0,0,0,1
"2011","E00007239","E00007239","Total",121,85,39,46,0,0,0,0,34,33,0,0,1,2
"2011","E00007245","E00007245","Total",100,77,29,48,0,14,14,0,9,9,0,0,0,0
"2011","E00007246","E00007246","Total",110,99,39,60,0,1,0,1,8,8,0,0,0,2
"2011","E00007241","E00007241","Total",126,119,55,64,1,1,1,0,5,5,0,0,0,0
"2011","E00007242","E00007242","Total",114,109,57,52,0,0,0,0,3,3,0,0,0,2
"2011","E00007243","E00007243","Total",116,108,55,53,0,0,0,0,8,8,0,0,0,0
"2011","E00007244","E00007244","Total",125,107,57,50,0,1,1,0,16,16,0,0,0,1
"2011","E00007760","E00007760","Total",120,85,37,48,0,7,1,6,26,26,0,0,0,2
"2011","E00007763","E00007763","Total",127,84,33,51,1,2,0,2,40,38,0,2,0,0
"2011","E00007765","E00007765","Total",140,121,60,61,1,1,1,0,14,12,0,2,0,3
"2011","E00007766","E00007766","Total",127,95,40,55,0,10,9,1,21,19,0,2,0,1
"2011","E00007775","E00007775","Total",132,108,40,68,0,4,4,0,20,19,0,0,1,0
"2011","E00007788","E00007788","Total",113,100,53,47,0,5,5,0,6,6,0,0,0,2
"2011","E00007789","E00007789","Total",120,113,63,50,0,1,1,0,6,6,0,0,0,0
"2011","E00007790","E00007790","Total",146,114,58,56,0,13,1,12,17,17,0,0,0,2
"2011","E00007791","E00007791","Total",121,110,66,44,0,0,0,0,10,10,0,0,0,1
"2011","E00007792","E00007792","Total",132,101,48,53,0,1,1,0,28,28,0,0,0,2
"2011","E00007756","E00007756","Total",127,114,70,44,0,5,5,0,6,6,0,0,0,2
"2011","E00007767","E00007767","Total",150,133,67,66,0,3,0,3,12,12,0,0,0,2
"2011","E00007769","E00007769","Total",136,123,73,50,0,1,1,0,11,9,2,0,0,1
"2011","E00007771","E00007771","Total",125,113,52,61,1,4,3,1,5,5,0,0,0,2
"2011","E00007754","E00007754","Total",165,111,47,64,0,4,2,2,47,45,0,1,1,3
"2011","E00007755","E00007755","Total",133,79,38,41,0,17,17,0,35,32,1,2,0,2
"2011","E00007757","E00007757","Total",130,80,30,50,0,4,4,0,41,39,0,2,0,5
"2011","E00007758","E00007758","Total",128,66,38,28,1,17,15,2,44,43,0,1,0,0
"2011","E00007759","E00007759","Total",123,68,39,29,0,18,18,0,36,34,2,0,0,1
"2011","E00007762","E00007762","Total",99,24,5,19,0,2,2,0,73,69,1,3,0,0
"2011","E00007340","E00007340","Total",110,77,37,40,3,8,3,5,18,16,0,1,1,4
"2011","E00007343","E00007343","Total",126,49,17,32,0,36,17,19,40,39,0,0,1,1
"2011","E00007349","E00007349","Total",115,75,24,51,0,5,2,3,33,31,0,2,0,2
"2011","E00007350","E00007350","Total",140,86,30,56,1,4,2,2,48,46,0,2,0,1
"2011","E00007373","E00007373","Total",148,50,27,23,0,32,4,28,61,56,0,0,5,5
"2011","E00007337","E00007337","Total",140,60,22,38,1,18,9,9,57,51,0,4,2,4
"2011","E00007338","E00007338","Total",154,73,29,44,1,31,22,9,47,42,0,4,1,2
"2011","E00007341","E00007341","Total",135,91,55,36,1,15,7,8,25,25,0,0,0,3
"2011","E00007345","E00007345","Total",132,67,36,31,1,53,50,3,10,10,0,0,0,1
"2011","E00007351","E00007351","Total",129,48,18,30,1,46,42,4,32,30,1,1,0,2
"2011","E00007383","E00007383","Total",157,91,38,53,0,28,19,9,37,37,0,0,0,1
"2011","E00007384","E00007384","Total",163,48,20,28,30,50,18,32,32,27,0,2,3,3
"2011","E00007390","E00007390","Total",107,58,20,38,2,10,5,5,36,35,0,1,0,1
"2011","E00007398","E00007398","Total",151,64,33,31,4,37,25,12,45,44,1,0,0,1
"2011","E00007400","E00007400","Total",145,82,43,39,0,20,5,15,38,35,0,3,0,5
"2011","E00007387","E00007387","Total",110,70,32,38,0,20,17,3,18,17,0,0,1,2
"2011","E00007392","E00007392","Total",149,102,48,54,2,18,8,10,24,23,0,0,1,3
"2011","E00007395","E00007395","Total",126,70,33,37,2,17,7,10,35,35,0,0,0,2
"2011","E00007397","E00007397","Total",141,88,34,54,2,16,9,7,34,32,0,2,0,1
"2011","E00007407","E00007407","Total",138,57,23,34,0,20,11,9,59,56,1,0,2,2
"2011","E00007391","E00007391","Total",138,70,29,41,0,13,6,7,53,53,0,0,0,2
"2011","E00007393","E00007393","Total",124,40,17,23,5,21,10,11,57,57,0,0,0,1
"2011","E00007396","E00007396","Total",136,68,31,37,1,42,20,22,25,25,0,0,0,0
"2011","E00007404","E00007404","Total",138,74,39,35,0,27,12,15,34,33,0,1,0,3
"2011","E00007408","E00007408","Total",186,69,24,45,18,49,14,35,49,46,0,1,2,1
"2011","E00007248","E00007248","Total",112,96,42,54,0,3,3,0,9,8,0,1,0,4
"2011","E00007281","E00007281","Total",117,98,46,52,0,4,4,0,13,13,0,0,0,2
"2011","E00007282","E00007282","Total",119,88,43,45,1,9,9,0,21,21,0,0,0,0
"2011","E00007283","E00007283","Total",84,48,25,23,1,9,4,5,24,21,0,3,0,2
"2011","E00007285","E00007285","Total",124,75,43,32,0,9,5,4,38,36,0,0,2,2
"2011","E00007250","E00007250","Total",146,64,26,38,1,20,13,7,56,56,0,0,0,5
"2011","E00007251","E00007251","Total",128,41,17,24,1,12,6,6,71,71,0,0,0,3
"2011","E00007252","E00007252","Total",126,36,8,28,1,18,12,6,70,68,0,0,2,1
"2011","E00007287","E00007287","Total",141,65,34,31,2,13,5,8,58,57,0,0,1,3
"2011","E00007288","E00007288","Total",119,48,19,29,1,20,16,4,50,47,0,3,0,0
"2011","E00007249","E00007249","Total",133,70,33,37,1,19,11,8,41,41,0,0,0,2
"2011","E00007286","E00007286","Total",135,81,35,46,0,29,25,4,23,22,0,0,1,2
"2011","E00007289","E00007289","Total",126,52,20,32,0,28,12,16,40,40,0,0,0,6
"2011","E00007290","E00007290","Total",137,48,14,34,1,30,18,12,54,52,0,2,0,4
"2011","E00007344","E00007344","Total",174,45,13,32,2,37,27,10,88,86,0,2,0,2
"2011","E00007367","E00007367","Total",134,110,39,71,0,10,9,1,13,13,0,0,0,1
"2011","E00007372","E00007372","Total",139,111,49,62,0,8,3,5,19,16,0,1,2,1
"2011","E00007374","E00007374","Total",141,80,36,44,0,5,3,2,53,52,0,0,1,3
"2011","E00007385","E00007385","Total",131,62,20,42,0,22,6,16,45,42,0,3,0,2
"2011","E00007386","E00007386","Total",137,98,46,52,0,5,5,0,30,29,0,1,0,4
"2011","E00007388","E00007388","Total",112,68,30,38,2,10,3,7,31,29,0,2,0,1
"2011","E00007389","E00007389","Total",126,49,11,38,0,28,16,12,48,44,0,2,2,1
"2011","E00007394","E00007394","Total",157,102,41,61,0,16,7,9,37,35,0,2,0,2
"2011","E00007336","E00007336","Total",120,15,1,14,0,23,7,16,81,78,0,0,3,1
"2011","E00007347","E00007347","Total",119,45,17,28,0,14,4,10,59,59,0,0,0,1
"2011","E00007348","E00007348","Total",131,80,35,45,0,19,17,2,29,27,0,2,0,3
"2011","E00007352","E00007352","Total",121,25,11,14,1,33,13,20,60,59,0,1,0,2
"2011","E00007353","E00007353","Total",118,37,9,28,0,34,14,20,44,43,0,0,1,3
"2011","E00007405","E00007405","Total",153,43,16,27,1,58,35,23,48,44,0,4,0,3
"2011","E00007410","E00007410","Total",152,78,32,46,0,45,38,7,27,23,0,4,0,2
"2011","E00007411","E00007411","Total",130,68,35,33,1,18,9,9,40,39,0,1,0,3
"2011","E00007413","E00007413","Total",120,69,33,36,0,12,3,9,34,34,0,0,0,5
"2011","E00007414","E00007414","Total",127,48,25,23,1,51,41,10,25,25,0,0,0,2
"2011","E00007376","E00007376","Total",122,44,24,20,1,43,40,3,33,32,0,1,0,1
"2011","E00007379","E00007379","Total",132,72,26,46,5,24,14,10,28,27,0,1,0,3
"2011","E00007381","E00007381","Total",128,77,22,55,2,20,11,9,28,28,0,0,0,1
"2011","E00007382","E00007382","Total",122,27,12,15,0,69,65,4,25,24,0,0,1,1
"2011","E00171135","E00171135","Total",110,15,8,7,1,66,24,42,25,24,0,0,1,3
"2011","E00171136","E00171136","Total",103,10,2,8,6,82,7,75,5,5,0,0,0,0
"2011","E00171138","E00171138","Total",101,24,10,14,0,59,26,33,17,17,0,0,0,1
"2011","E00007378","E00007378","Total",122,100,48,52,0,6,2,4,15,15,0,0,0,1
"2011","E00007406","E00007406","Total",145,91,48,43,1,20,11,9,31,31,0,0,0,2
"2011","E00007409","E00007409","Total",143,82,34,48,1,14,12,2,43,38,0,3,2,3
"2011","E00007412","E00007412","Total",150,93,39,54,2,18,7,11,36,34,0,2,0,1
"2011","E00007415","E00007415","Total",120,52,18,34,0,46,12,34,16,16,0,0,0,6
"2011","E00171128","E00171128","Total",119,34,3,31,24,13,7,6,48,48,0,0,0,0
"2011","E00171130","E00171130","Total",116,47,13,34,1,23,17,6,45,45,0,0,0,0
"2011","E00171131","E00171131","Total",118,34,7,27,2,72,4,68,10,9,0,1,0,0
"2011","E00171133","E00171133","Total",124,23,3,20,0,63,6,57,35,35,0,0,0,3
"2011","E00171139","E00171139","Total",116,15,4,11,0,86,7,79,14,14,0,0,0,1
"2011","E00007399","E00007399","Total",144,29,13,16,0,80,64,16,32,29,1,2,0,3
"2011","E00007401","E00007401","Total",127,8,4,4,0,112,108,4,3,3,0,0,0,4
"2011","E00007402","E00007402","Total",129,18,9,9,1,88,73,15,18,17,0,1,0,4
"2011","E00007403","E00007403","Total",141,93,44,49,2,8,2,6,35,35,0,0,0,3
"2011","E00006974","E00006974","Total",119,110,64,46,0,1,1,0,8,8,0,0,0,0
"2011","E00006975","E00006975","Total",119,95,42,53,0,8,8,0,15,12,1,2,0,1
"2011","E00006976","E00006976","Total",146,78,35,43,2,34,34,0,29,29,0,0,0,3
"2011","E00006977","E00006977","Total",141,113,59,54,1,6,4,2,21,20,0,0,1,0
"2011","E00007420","E00007420","Total",122,66,29,37,1,22,19,3,33,33,0,0,0,0
"2011","E00007452","E00007452","Total",95,9,4,5,0,71,2,69,13,13,0,0,0,2
"2011","E00007453","E00007453","Total",152,98,48,50,0,17,15,2,31,31,0,0,0,6
"2011","E00007454","E00007454","Total",109,32,11,21,0,67,64,3,6,6,0,0,0,4
"2011","E00007456","E00007456","Total",131,98,50,48,0,7,6,1,26,26,0,0,0,0
"2011","E00007457","E00007457","Total",126,56,21,35,0,46,42,4,20,19,0,0,1,4
"2011","E00007427","E00007427","Total",131,109,67,42,2,2,2,0,15,15,0,0,0,3
"2011","E00007435","E00007435","Total",123,105,57,48,0,0,0,0,15,15,0,0,0,3
"2011","E00007455","E00007455","Total",123,106,56,50,0,2,2,0,12,11,0,1,0,3
"2011","E00007458","E00007458","Total",133,112,41,71,0,4,3,1,16,16,0,0,0,1
"2011","E00007419","E00007419","Total",124,104,51,53,0,1,0,1,16,14,0,2,0,3
"2011","E00007428","E00007428","Total",120,86,53,33,1,3,2,1,29,28,0,1,0,1
"2011","E00007429","E00007429","Total",110,94,48,46,0,3,2,1,12,11,0,1,0,1
"2011","E00007431","E00007431","Total",128,107,60,47,0,3,1,2,16,16,0,0,0,2
"2011","E00007443","E00007443","Total",120,103,41,62,0,2,2,0,15,15,0,0,0,0
"2011","E00007761","E00007761","Total",143,112,49,63,0,4,3,1,24,21,0,3,0,3
"2011","E00007764","E00007764","Total",174,85,33,52,2,2,2,0,83,77,2,2,2,2
"2011","E00007768","E00007768","Total",131,94,43,51,1,14,8,6,21,21,0,0,0,1
"2011","E00007772","E00007772","Total",145,79,34,45,0,42,24,18,23,21,0,2,0,1
"2011","E00007773","E00007773","Total",158,94,33,61,2,40,31,9,19,19,0,0,0,3
"2011","E00007075","E00007075","Total",125,54,20,34,0,51,49,2,18,16,0,2,0,2
"2011","E00007092","E00007092","Total",116,53,24,29,1,46,36,10,13,11,1,1,0,3
"2011","E00007094","E00007094","Total",147,32,6,26,2,43,13,30,66,63,0,3,0,4
"2011","E00007100","E00007100","Total",137,95,37,58,0,18,15,3,24,24,0,0,0,0
"2011","E00007102","E00007102","Total",118,73,25,48,0,23,23,0,20,20,0,0,0,2
"2011","E00007076","E00007076","Total",196,25,10,15,1,96,17,79,65,63,0,0,2,9
"2011","E00007089","E00007089","Total",161,46,20,26,1,42,21,21,68,68,0,0,0,4
"2011","E00007106","E00007106","Total",117,41,16,25,0,47,14,33,29,29,0,0,0,0
"2011","E00007115","E00007115","Total",137,62,23,39,1,29,9,20,41,40,0,0,1,4
"2011","E00007121","E00007121","Total",126,36,14,22,2,58,47,11,27,24,0,1,2,3
"2011","E00007103","E00007103","Total",133,33,11,22,0,78,66,12,21,20,0,0,1,1
"2011","E00007108","E00007108","Total",121,65,27,38,0,34,29,5,21,20,0,0,1,1
"2011","E00007109","E00007109","Total",120,67,21,46,1,22,18,4,28,24,0,2,2,2
"2011","E00007110","E00007110","Total",126,63,20,43,0,47,45,2,15,15,0,0,0,1
"2011","E00007112","E00007112","Total",111,29,8,21,1,50,18,32,29,29,0,0,0,2
"2011","E00007254","E00007254","Total",124,25,12,13,0,67,58,9,29,27,1,1,0,3
"2011","E00007255","E00007255","Total",128,55,21,34,1,55,49,6,16,15,1,0,0,1
"2011","E00007284","E00007284","Total",138,45,16,29,0,56,27,29,32,31,0,0,1,5
"2011","E00007291","E00007291","Total",166,44,11,33,2,30,12,18,87,84,0,2,1,3
"2011","E00007292","E00007292","Total",151,45,20,25,0,25,22,3,77,74,1,0,2,4
"2011","E00007257","E00007257","Total",138,60,20,40,1,56,52,4,20,19,0,1,0,1
"2011","E00007259","E00007259","Total",137,66,25,41,0,56,50,6,13,13,0,0,0,2
"2011","E00007261","E00007261","Total",147,88,30,58,0,37,32,5,20,20,0,0,0,2
"2011","E00007567","E00007567","Total",139,100,46,54,0,0,0,0,38,36,0,2,0,1
"2011","E00007578","E00007578","Total",146,91,50,41,10,2,0,2,40,39,0,1,0,3
"2011","E00007579","E00007579","Total",130,119,63,56,0,3,3,0,5,5,0,0,0,3
"2011","E00007580","E00007580","Total",144,50,26,24,1,4,2,2,82,79,0,3,0,7
"2011","E00007581","E00007581","Total",139,79,40,39,8,29,24,5,22,21,0,0,1,1
"2011","E00007596","E00007596","Total",131,124,63,61,0,0,0,0,7,7,0,0,0,0
"2011","E00007597","E00007597","Total",147,96,49,47,0,1,0,1,50,49,0,1,0,0
"2011","E00007598","E00007598","Total",148,123,54,69,0,0,0,0,25,25,0,0,0,0
"2011","E00007601","E00007601","Total",118,103,52,51,0,0,0,0,15,12,0,3,0,0
"2011","E00007599","E00007599","Total",127,105,39,66,1,5,4,1,16,16,0,0,0,0
"2011","E00007600","E00007600","Total",141,101,50,51,0,1,1,0,38,37,0,1,0,1
"2011","E00007602","E00007602","Total",118,94,44,50,0,2,1,1,21,21,0,0,0,1
"2011","E00007604","E00007604","Total",161,120,60,60,0,1,1,0,39,36,0,3,0,1
"2011","E00007606","E00007606","Total",140,119,61,58,2,2,1,1,16,16,0,0,0,1
"2011","E00007603","E00007603","Total",129,122,64,58,0,2,1,1,5,5,0,0,0,0
"2011","E00007608","E00007608","Total",133,124,65,59,0,0,0,0,8,8,0,0,0,1
"2011","E00007610","E00007610","Total",137,121,84,37,0,2,1,1,13,9,2,2,0,1
"2011","E00007612","E00007612","Total",131,117,55,62,1,2,1,1,11,11,0,0,0,0
"2011","E00007614","E00007614","Total",128,112,52,60,0,2,1,1,14,14,0,0,0,0
"2011","E00007615","E00007615","Total",127,113,75,38,0,0,0,0,13,13,0,0,0,1
"2011","E00007618","E00007618","Total",131,92,59,33,0,13,9,4,26,26,0,0,0,0
"2011","E00007620","E00007620","Total",119,83,45,38,1,10,4,6,19,17,0,1,1,6
"2011","E00007417","E00007417","Total",149,66,29,37,0,3,3,0,78,75,0,3,0,2
"2011","E00007418","E00007418","Total",161,69,19,50,0,6,0,6,82,80,0,1,1,4
"2011","E00007421","E00007421","Total",120,89,42,47,1,3,2,1,22,22,0,0,0,5
"2011","E00007423","E00007423","Total",156,107,42,65,0,3,2,1,41,38,0,0,3,5
"2011","E00007433","E00007433","Total",145,106,49,57,2,2,2,0,33,33,0,0,0,2
"2011","E00007430","E00007430","Total",169,83,27,56,0,5,5,0,80,77,0,3,0,1
"2011","E00007432","E00007432","Total",169,24,8,16,0,13,9,4,131,126,3,1,1,1
"2011","E00007436","E00007436","Total",122,90,41,49,1,4,2,2,23,23,0,0,0,4
"2011","E00007437","E00007437","Total",155,103,45,58,0,3,2,1,48,42,0,3,3,1
"2011","E00007440","E00007440","Total",131,88,36,52,0,2,2,0,41,38,0,3,0,0
"2011","E00007770","E00007770","Total",117,97,37,60,1,0,0,0,18,17,0,0,1,1
"2011","E00007774","E00007774","Total",135,104,44,60,0,2,1,1,27,26,0,1,0,2
"2011","E00007776","E00007776","Total",147,96,32,64,1,4,2,2,46,45,0,1,0,0
"2011","E00007781","E00007781","Total",131,72,32,40,0,7,4,3,50,49,0,1,0,2
"2011","E00007782","E00007782","Total",139,60,37,23,0,3,2,1,71,70,0,1,0,5
"2011","E00007753","E00007753","Total",136,104,54,50,0,1,1,0,29,26,2,1,0,2
"2011","E00007777","E00007777","Total",131,98,41,57,1,15,4,11,15,14,0,1,0,2
"2011","E00007778","E00007778","Total",148,104,36,68,2,3,3,0,39,39,0,0,0,0
"2011","E00007779","E00007779","Total",135,95,40,55,0,4,4,0,34,32,0,1,1,2
"2011","E00007780","E00007780","Total",159,49,19,30,0,72,3,69,34,30,1,0,3,4
"2011","E00007783","E00007783","Total",108,89,44,45,0,2,1,1,16,14,0,2,0,1
"2011","E00007784","E00007784","Total",142,100,33,67,1,1,0,1,40,37,1,2,0,0
"2011","E00007785","E00007785","Total",138,120,52,68,0,5,4,1,13,10,0,3,0,0
"2011","E00007786","E00007786","Total",110,84,32,52,0,2,2,0,22,22,0,0,0,2
"2011","E00007787","E00007787","Total",128,60,28,32,1,1,1,0,63,58,0,5,0,3
"2011","E00007096","E00007096","Total",92,8,3,5,0,76,10,66,0,0,0,0,0,8
"2011","E00007099","E00007099","Total",159,36,7,29,11,32,9,23,78,75,0,0,3,2
"2011","E00007107","E00007107","Total",141,38,14,24,2,60,11,49,38,38,0,0,0,3
"2011","E00171142","E00171142","Total",104,19,10,9,0,72,8,64,11,10,0,0,1,2
"2011","E00007101","E00007101","Total",125,37,10,27,0,52,50,2,32,31,0,0,1,4
"2011","E00007111","E00007111","Total",129,69,27,42,1,31,24,7,26,26,0,0,0,2
"2011","E00007113","E00007113","Total",113,67,26,41,1,18,15,3,26,25,0,0,1,1
"2011","E00007117","E00007117","Total",128,47,17,30,0,36,29,7,44,40,0,4,0,1
"2011","E00007119","E00007119","Total",133,26,5,21,1,82,76,6,21,21,0,0,0,3
"2011","E00007074","E00007074","Total",131,45,21,24,0,67,64,3,16,15,0,1,0,3
"2011","E00007079","E00007079","Total",156,39,17,22,12,86,62,24,19,18,0,1,0,0
"2011","E00007085","E00007085","Total",138,65,24,41,2,32,25,7,39,37,0,2,0,0
"2011","E00007086","E00007086","Total",149,12,5,7,5,95,90,5,32,32,0,0,0,5
"2011","E00007087","E00007087","Total",109,9,8,1,0,82,79,3,15,15,0,0,0,3
"2011","E00007093","E00007093","Total",98,7,1,6,3,62,42,20,26,26,0,0,0,0
"2011","E00007098","E00007098","Total",207,7,3,4,0,189,22,167,8,6,0,0,2,3
"2011","E00007105","E00007105","Total",144,24,6,18,0,55,29,26,64,60,0,3,1,1
"2011","E00171141","E00171141","Total",178,12,1,11,80,73,18,55,13,12,0,1,0,0
"2011","E00171144","E00171144","Total",188,5,1,4,8,160,19,141,11,11,0,0,0,4
"2011","E00171173","E00171173","Total",130,21,6,15,1,97,15,82,9,9,0,0,0,2
"2011","E00171175","E00171175","Total",189,6,1,5,1,165,22,143,14,13,0,1,0,3
"2011","E00007077","E00007077","Total",129,41,12,29,0,39,31,8,45,43,0,1,1,4
"2011","E00007114","E00007114","Total",150,32,6,26,0,93,90,3,23,21,0,2,0,2
"2011","E00007116","E00007116","Total",123,23,4,19,1,81,72,9,12,12,0,0,0,6
"2011","E00007120","E00007120","Total",125,27,7,20,1,69,57,12,26,25,0,1,0,2
"2011","E00007123","E00007123","Total",126,30,6,24,0,75,67,8,19,19,0,0,0,2
"2011","E00007253","E00007253","Total",148,89,30,59,0,41,40,1,17,14,1,2,0,1
"2011","E00007256","E00007256","Total",127,92,44,48,0,13,10,3,19,17,0,2,0,3
"2011","E00007258","E00007258","Total",112,76,46,30,0,4,4,0,30,29,1,0,0,2
"2011","E00007263","E00007263","Total",126,83,36,47,1,9,8,1,32,31,0,1,0,1
"2011","E00007260","E00007260","Total",139,114,61,53,1,7,7,0,17,16,0,1,0,0
"2011","E00007262","E00007262","Total",125,100,41,59,1,4,2,2,18,18,0,0,0,2
"2011","E00007269","E00007269","Total",122,84,43,41,0,4,4,0,34,34,0,0,0,0
"2011","E00007270","E00007270","Total",120,75,28,47,0,17,16,1,27,26,1,0,0,1
"2011","E00007265","E00007265","Total",112,57,23,34,0,12,8,4,39,39,0,0,0,4
"2011","E00007266","E00007266","Total",134,77,25,52,2,15,8,7,39,37,0,1,1,1
"2011","E00007267","E00007267","Total",142,78,31,47,2,12,8,4,49,47,0,2,0,1
"2011","E00007271","E00007271","Total",115,62,24,38,0,14,10,4,39,38,0,1,0,0
"2011","E00007275","E00007275","Total",117,70,32,38,1,8,1,7,34,30,0,4,0,4
"2011","E00007264","E00007264","Total",133,82,26,56,0,14,9,5,34,33,0,1,0,3
"2011","E00007268","E00007268","Total",118,67,28,39,0,10,5,5,39,39,0,0,0,2
"2011","E00007272","E00007272","Total",121,72,34,38,0,11,9,2,38,38,0,0,0,0
"2011","E00007273","E00007273","Total",131,60,23,37,3,17,8,9,48,44,0,4,0,3
"2011","E00007276","E00007276","Total",131,85,28,57,0,10,6,4,36,36,0,0,0,0
"2011","E00007422","E00007422","Total",146,79,29,50,0,29,29,0,32,28,0,4,0,6
"2011","E00007424","E00007424","Total",142,111,62,49,0,1,1,0,28,25,0,2,1,2
"2011","E00007425","E00007425","Total",123,102,48,54,0,2,1,1,17,17,0,0,0,2
"2011","E00007426","E00007426","Total",120,97,42,55,0,7,6,1,13,12,0,1,0,3
"2011","E00007434","E00007434","Total",147,107,58,49,2,7,7,0,27,26,0,0,1,4
"2011","E00007438","E00007438","Total",151,126,70,56,1,1,0,1,18,18,0,0,0,5
"2011","E00007441","E00007441","Total",137,104,55,49,0,0,0,0,30,30,0,0,0,3
"2011","E00007445","E00007445","Total",129,92,43,49,0,22,1,21,12,12,0,0,0,3
"2011","E00006926","E00006926","Total",134,110,58,52,1,1,0,1,21,19,0,1,1,1
"2011","E00006933","E00006933","Total",110,73,41,32,2,10,2,8,21,21,0,0,0,4
"2011","E00006935","E00006935","Total",132,106,55,51,1,7,6,1,16,15,0,1,0,2
"2011","E00006938","E00006938","Total",134,95,48,47,0,1,1,0,37,37,0,0,0,1
"2011","E00006943","E00006943","Total",155,101,50,51,0,7,6,1,44,43,0,1,0,3
"2011","E00007582","E00007582","Total",122,48,18,30,1,56,54,2,16,14,0,1,1,1
"2011","E00007587","E00007587","Total",117,38,23,15,1,35,33,2,41,40,0,1,0,2
"2011","E00007588","E00007588","Total",118,50,17,33,0,51,34,17,16,15,0,1,0,1
"2011","E00007593","E00007593","Total",86,17,9,8,0,55,55,0,14,11,1,2,0,0
"2011","E00007594","E00007594","Total",110,27,12,15,0,76,71,5,7,7,0,0,0,0
"2011","E00007585","E00007585","Total",144,27,7,20,0,51,46,5,63,60,0,2,1,3
"2011","E00007589","E00007589","Total",125,51,27,24,1,25,15,10,46,43,0,2,1,2
"2011","E00007616","E00007616","Total",121,32,12,20,0,45,28,17,44,44,0,0,0,0
"2011","E00007619","E00007619","Total",124,52,24,28,0,36,21,15,30,29,0,1,0,6
"2011","E00007621","E00007621","Total",121,25,6,19,0,28,20,8,68,61,0,4,3,0
"2011","E00007586","E00007586","Total",126,81,52,29,0,10,5,5,33,28,0,1,4,2
"2011","E00007590","E00007590","Total",99,46,27,19,0,22,3,19,30,27,0,0,3,1
"2011","E00007591","E00007591","Total",115,87,38,49,0,6,4,2,22,22,0,0,0,0
"2011","E00007595","E00007595","Total",127,97,51,46,0,5,3,2,25,23,0,0,2,0
"2011","E00007605","E00007605","Total",140,108,52,56,0,2,2,0,22,18,0,4,0,8
"2011","E00007607","E00007607","Total",153,131,71,60,0,2,1,1,19,19,0,0,0,1
"2011","E00007609","E00007609","Total",149,118,76,42,0,5,3,2,24,23,0,0,1,2
"2011","E00007613","E00007613","Total",146,56,31,25,0,10,4,6,79,77,1,0,1,1
"2011","E00007078","E00007078","Total",165,77,29,48,0,24,8,16,62,60,0,1,1,2
"2011","E00007082","E00007082","Total",108,33,9,24,0,25,16,9,48,46,0,0,2,2
"2011","E00007084","E00007084","Total",112,40,14,26,2,48,35,13,19,16,0,3,0,3
"2011","E00007118","E00007118","Total",113,12,6,6,1,48,5,43,49,49,0,0,0,3
"2011","E00007122","E00007122","Total",116,40,12,28,4,31,25,6,41,38,0,1,2,0
"2011","E00007080","E00007080","Total",131,21,8,13,2,60,26,34,43,40,0,2,1,5
"2011","E00007081","E00007081","Total",145,83,33,50,2,14,9,5,41,41,0,0,0,5
"2011","E00007083","E00007083","Total",140,82,37,45,2,15,2,13,39,37,0,2,0,2
"2011","E00007088","E00007088","Total",157,81,39,42,7,22,19,3,44,42,0,2,0,3
"2011","E00007090","E00007090","Total",127,51,18,33,0,25,9,16,49,45,1,3,0,2
"2011","E00007710","E00007710","Total",125,79,33,46,2,14,8,6,28,27,0,0,1,2
"2011","E00007718","E00007718","Total",132,90,39,51,1,7,5,2,33,32,0,0,1,1
"2011","E00007736","E00007736","Total",55,39,13,26,1,2,1,1,13,13,0,0,0,0
"2011","E00007742","E00007742","Total",149,73,26,47,0,30,23,7,44,44,0,0,0,2
"2011","E00007749","E00007749","Total",163,64,26,38,0,30,27,3,69,64,1,3,1,0
"2011","E00007713","E00007713","Total",151,97,33,64,1,9,6,3,39,37,1,1,0,5
"2011","E00007719","E00007719","Total",138,95,36,59,0,5,5,0,31,31,0,0,0,7
"2011","E00007734","E00007734","Total",128,49,17,32,0,52,47,5,23,20,0,1,2,4
"2011","E00007746","E00007746","Total",129,54,23,31,0,43,35,8,30,29,0,0,1,2
"2011","E00007724","E00007724","Total",141,67,26,41,1,18,14,4,49,46,1,1,1,6
"2011","E00007725","E00007725","Total",142,91,32,59,0,15,12,3,33,32,0,0,1,3
"2011","E00007729","E00007729","Total",138,25,11,14,0,96,92,4,16,15,1,0,0,1
"2011","E00007735","E00007735","Total",137,22,9,13,0,72,67,5,39,39,0,0,0,4
"2011","E00007728","E00007728","Total",147,67,41,26,1,47,16,31,28,27,0,0,1,4
"2011","E00007745","E00007745","Total",145,69,16,53,1,16,10,6,54,51,0,3,0,5
"2011","E00007751","E00007751","Total",139,82,30,52,0,24,20,4,28,28,0,0,0,5
"2011","E00171145","E00171145","Total",111,19,1,18,9,36,12,24,45,44,0,1,0,2
"2011","E00171147","E00171147","Total",115,49,7,42,1,12,5,7,49,47,0,2,0,4
"2011","E00171184","E00171184","Total",86,44,21,23,3,7,0,7,32,31,1,0,0,0
"2011","E00006927","E00006927","Total",112,46,28,18,0,37,9,28,27,23,0,2,2,2
"2011","E00006929","E00006929","Total",166,83,46,37,0,12,4,8,69,66,1,1,1,2
"2011","E00006939","E00006939","Total",119,69,25,44,12,1,1,0,36,34,0,2,0,1
"2011","E00006940","E00006940","Total",122,78,46,32,0,5,1,4,39,38,0,1,0,0
"2011","E00006944","E00006944","Total",121,65,29,36,1,26,25,1,29,23,0,4,2,0
"2011","E00006911","E00006911","Total",117,14,5,9,0,86,5,81,15,15,0,0,0,2
"2011","E00006912","E00006912","Total",144,56,14,42,2,51,6,45,34,32,0,2,0,1
"2011","E00006915","E00006915","Total",115,68,30,38,1,29,1,28,14,14,0,0,0,3
"2011","E00006928","E00006928","Total",136,33,11,22,1,81,65,16,19,19,0,0,0,2
"2011","E00006931","E00006931","Total",108,83,41,42,1,8,8,0,15,15,0,0,0,1
"2011","E00006919","E00006919","Total",205,103,32,71,7,58,7,51,34,33,0,1,0,3
"2011","E00006920","E00006920","Total",179,97,17,80,4,2,1,1,75,72,0,3,0,1
"2011","E00006921","E00006921","Total",139,109,61,48,0,3,0,3,26,26,0,0,0,1
"2011","E00006924","E00006924","Total",130,79,33,46,2,0,0,0,49,45,0,4,0,0
"2011","E00006925","E00006925","Total",130,65,27,38,0,10,6,4,54,53,0,1,0,1
"2011","E00007444","E00007444","Total",130,94,47,47,0,1,1,0,35,34,0,1,0,0
"2011","E00007446","E00007446","Total",126,96,54,42,0,4,1,3,23,21,0,2,0,3
"2011","E00007448","E00007448","Total",144,110,57,53,0,6,5,1,28,28,0,0,0,0
"2011","E00007450","E00007450","Total",154,71,36,35,0,16,2,14,62,59,0,2,1,5
"2011","E00007708","E00007708","Total",119,77,33,44,0,28,26,2,11,10,0,1,0,3
"2011","E00007712","E00007712","Total",140,114,46,68,0,6,3,3,18,17,0,0,1,2
"2011","E00007739","E00007739","Total",158,126,71,55,1,2,0,2,29,29,0,0,0,0
"2011","E00007743","E00007743","Total",126,103,58,45,0,7,5,2,15,15,0,0,0,1
"2011","E00007715","E00007715","Total",121,51,21,30,0,46,43,3,21,19,0,0,2,3
"2011","E00007721","E00007721","Total",128,49,28,21,0,55,12,43,20,20,0,0,0,4
"2011","E00007722","E00007722","Total",125,100,49,51,1,6,0,6,18,17,0,1,0,0
"2011","E00007732","E00007732","Total",142,99,50,49,0,10,7,3,31,29,0,2,0,2
"2011","E00006922","E00006922","Total",134,90,36,54,0,1,1,0,43,42,1,0,0,0
"2011","E00006923","E00006923","Total",141,96,50,46,2,1,0,1,42,39,0,2,1,0
"2011","E00006932","E00006932","Total",142,85,34,51,0,2,2,0,49,45,0,2,2,6
"2011","E00006941","E00006941","Total",171,75,44,31,0,10,8,2,83,82,0,0,1,3
"2011","E00006946","E00006946","Total",174,95,34,61,0,7,4,3,70,67,0,3,0,2
"2011","E00006910","E00006910","Total",141,38,15,23,3,19,11,8,78,75,0,3,0,3
"2011","E00006914","E00006914","Total",128,56,21,35,0,10,5,5,59,58,0,1,0,3
"2011","E00006916","E00006916","Total",124,50,18,32,0,14,3,11,55,55,0,0,0,5
"2011","E00006936","E00006936","Total",119,84,44,40,0,4,1,3,29,28,0,1,0,2
"2011","E00006937","E00006937","Total",175,47,22,25,0,15,4,11,113,109,0,4,0,0
"2011","E00006917","E00006917","Total",154,96,38,58,0,9,4,5,48,48,0,0,0,1
"2011","E00006930","E00006930","Total",208,83,45,38,0,15,4,11,109,102,1,5,1,1
"2011","E00006934","E00006934","Total",156,99,45,54,0,3,2,1,54,50,0,3,1,0
"2011","E00006942","E00006942","Total",169,102,38,64,1,13,5,8,51,47,0,3,1,2
"2011","E00006947","E00006947","Total",152,69,25,44,0,13,13,0,70,70,0,0,0,0
"2011","E00006913","E00006913","Total",129,96,65,31,0,3,3,0,28,28,0,0,0,2
"2011","E00006918","E00006918","Total",128,90,50,40,0,1,1,0,37,36,0,1,0,0
"2011","E00006945","E00006945","Total",130,92,57,35,0,4,3,1,29,29,0,0,0,5
"2011","E00006948","E00006948","Total",124,64,38,26,1,8,4,4,48,47,0,1,0,3
"2011","E00007416","E00007416","Total",133,76,40,36,0,13,10,3,34,32,1,0,1,10
"2011","E00007439","E00007439","Total",145,61,24,37,0,7,4,3,73,72,0,0,1,4
"2011","E00007442","E00007442","Total",157,33,9,24,2,66,16,50,53,49,0,1,3,3
"2011","E00007447","E00007447","Total",165,90,44,46,21,1,0,1,51,50,0,0,1,2
"2011","E00007449","E00007449","Total",109,55,21,34,0,3,3,0,48,45,0,1,2,3
"2011","E00007451","E00007451","Total",109,32,10,22,1,41,3,38,33,28,0,0,5,2
"2011","E00007583","E00007583","Total",128,40,16,24,0,32,24,8,56,55,0,0,1,0
"2011","E00007584","E00007584","Total",130,116,62,54,0,0,0,0,11,11,0,0,0,3
"2011","E00007592","E00007592","Total",120,61,26,35,1,19,2,17,39,36,0,2,1,0
"2011","E00007611","E00007611","Total",138,93,56,37,0,1,0,1,42,38,0,4,0,2
"2011","E00007617","E00007617","Total",129,93,41,52,0,6,5,1,21,21,0,0,0,9
"2011","E00007274","E00007274","Total",137,57,15,42,1,25,16,9,46,43,1,2,0,8
"2011","E00007277","E00007277","Total",121,51,26,25,1,36,30,6,27,27,0,0,0,6
"2011","E00007278","E00007278","Total",126,28,4,24,0,73,69,4,22,22,0,0,0,3
"2011","E00007279","E00007279","Total",140,19,5,14,1,90,60,30,25,25,0,0,0,5
"2011","E00007280","E00007280","Total",140,30,6,24,0,82,79,3,25,24,0,1,0,3
"2011","E00007714","E00007714","Total",126,54,17,37,0,60,49,11,11,9,0,2,0,1
"2011","E00007717","E00007717","Total",125,28,4,24,0,70,63,7,26,26,0,0,0,1
"2011","E00007720","E00007720","Total",137,84,28,56,0,10,7,3,40,39,0,1,0,3
"2011","E00007750","E00007750","Total",142,48,14,34,0,69,61,8,23,22,0,0,1,2
"2011","E00007709","E00007709","Total",161,31,14,17,0,113,87,26,15,15,0,0,0,2
"2011","E00007716","E00007716","Total",149,25,11,14,0,105,101,4,16,15,0,1,0,3
"2011","E00007733","E00007733","Total",108,30,10,20,0,54,51,3,23,22,0,1,0,1
"2011","E00007738","E00007738","Total",114,16,8,8,0,81,77,4,15,14,0,0,1,2
"2011","E00007741","E00007741","Total",103,22,9,13,0,55,53,2,23,21,0,2,0,3
"2011","E00007747","E00007747","Total",121,39,9,30,1,61,50,11,17,12,0,3,2,3
"2011","E00007723","E00007723","Total",124,13,3,10,0,72,10,62,37,37,0,0,0,2
"2011","E00007730","E00007730","Total",111,17,7,10,0,46,9,37,45,44,0,1,0,3
"2011","E00007737","E00007737","Total",121,33,10,23,0,46,13,33,37,37,0,0,0,5
"2011","E00007740","E00007740","Total",124,28,4,24,0,50,10,40,46,45,0,1,0,0
"2011","E00007744","E00007744","Total",231,23,3,20,1,123,32,91,83,78,1,1,3,1
"2011","E00007711","E00007711","Total",132,65,30,35,1,19,11,8,45,40,0,5,0,2
"2011","E00007726","E00007726","Total",123,74,27,47,0,15,9,6,31,28,0,3,0,3
"2011","E00007727","E00007727","Total",200,51,31,20,0,96,50,46,48,48,0,0,0,5
"2011","E00007752","E00007752","Total",120,77,38,39,1,9,4,5,33,27,0,6,0,0
"2011","E00165799","E00165799","Total",120,80,38,42,1,6,5,1,31,28,0,2,1,2
"2011","E00008407","E00008407","Total",117,29,5,24,2,72,6,66,13,11,0,1,1,1
"2011","E00008433","E00008433","Total",113,48,18,30,0,58,4,54,7,6,0,1,0,0
"2011","E00008434","E00008434","Total",139,11,4,7,0,119,9,110,7,6,0,0,1,2
"2011","E00008439","E00008439","Total",233,21,4,17,10,177,10,167,23,22,0,1,0,2
"2011","E00008440","E00008440","Total",243,45,17,28,23,161,8,153,13,12,0,0,1,1
"2011","E00008408","E00008408","Total",112,40,10,30,0,52,6,46,20,16,0,4,0,0
"2011","E00008409","E00008409","Total",124,16,2,14,1,98,5,93,9,8,0,1,0,0
"2011","E00008436","E00008436","Total",90,21,7,14,0,60,5,55,7,7,0,0,0,2
"2011","E00008437","E00008437","Total",91,3,1,2,0,86,6,80,2,2,0,0,0,0
"2011","E00008441","E00008441","Total",105,21,5,16,0,73,4,69,10,9,0,1,0,1
"2011","E00008411","E00008411","Total",123,14,3,11,1,104,12,92,4,3,0,1,0,0
"2011","E00008412","E00008412","Total",127,12,4,8,0,104,4,100,11,11,0,0,0,0
"2011","E00008415","E00008415","Total",103,3,3,0,0,97,10,87,3,3,0,0,0,0
"2011","E00008416","E00008416","Total",149,41,11,30,0,85,9,76,23,19,0,4,0,0
"2011","E00008438","E00008438","Total",108,3,1,2,1,100,3,97,2,0,0,0,2,2
"2011","E00008414","E00008414","Total",123,70,28,42,0,6,0,6,45,45,0,0,0,2
"2011","E00008417","E00008417","Total",143,60,18,42,1,64,1,63,18,17,0,1,0,0
"2011","E00008419","E00008419","Total",111,51,13,38,0,14,0,14,45,44,0,0,1,1
"2011","E00008442","E00008442","Total",100,39,4,35,0,39,3,36,22,19,1,1,1,0
"2011","E00008443","E00008443","Total",121,36,10,26,0,52,6,46,30,28,0,1,1,3
"2011","E00008406","E00008406","Total",124,47,13,34,0,43,2,41,34,29,0,4,1,0
"2011","E00008425","E00008425","Total",128,56,17,39,1,46,8,38,24,21,1,2,0,1
"2011","E00008426","E00008426","Total",126,72,25,47,8,6,1,5,36,36,0,0,0,4
"2011","E00008427","E00008427","Total",133,21,7,14,1,98,10,88,12,11,0,1,0,1
"2011","E00008428","E00008428","Total",194,60,8,52,27,44,2,42,63,61,0,2,0,0
"2011","E00008430","E00008430","Total",79,3,1,2,0,71,4,67,5,5,0,0,0,0
"2011","E00008431","E00008431","Total",132,81,12,69,1,8,3,5,41,40,0,1,0,1
"2011","E00008432","E00008432","Total",111,53,14,39,1,22,3,19,35,34,0,1,0,0
"2011","E00008435","E00008435","Total",164,47,4,43,0,68,10,58,48,46,1,1,0,1
"2011","E00176552","E00176552","Total",162,85,11,74,3,11,1,10,63,60,0,2,1,0
"2011","E00176557","E00176557","Total",95,25,1,24,0,31,3,28,38,37,0,1,0,1
"2011","E00176526","E00176526","Total",100,21,2,19,30,4,2,2,45,43,0,2,0,0
"2011","E00176532","E00176532","Total",121,32,9,23,7,31,1,30,51,47,0,3,1,0
"2011","E00176536","E00176536","Total",110,36,2,34,2,14,1,13,58,56,0,2,0,0
"2011","E00176565","E00176565","Total",119,18,2,16,3,44,3,41,54,54,0,0,0,0
"2011","E00176570","E00176570","Total",121,41,6,35,5,13,3,10,62,61,0,1,0,0
"2011","E00008423","E00008423","Total",113,71,7,64,0,4,0,4,37,36,0,1,0,1
"2011","E00176527","E00176527","Total",113,45,14,31,3,20,0,20,45,42,0,3,0,0
"2011","E00176529","E00176529","Total",119,27,3,24,11,41,3,38,39,37,1,1,0,1
"2011","E00176531","E00176531","Total",124,60,11,49,16,9,0,9,39,36,0,3,0,0
"2011","E00176567","E00176567","Total",81,27,8,19,4,6,1,5,44,43,0,1,0,0
"2011","E00176528","E00176528","Total",116,62,7,55,1,9,2,7,44,42,0,1,1,0
"2011","E00176530","E00176530","Total",62,13,3,10,0,30,0,30,16,15,0,0,1,3
"2011","E00176542","E00176542","Total",105,62,7,55,0,4,0,4,35,34,0,1,0,4
"2011","E00176543","E00176543","Total",99,52,5,47,1,20,1,19,26,25,0,1,0,0
"2011","E00176558","E00176558","Total",112,39,8,31,0,25,0,25,46,45,0,1,0,2
"2011","E00176575","E00176575","Total",65,46,5,41,0,2,0,2,17,17,0,0,0,0
"2011","E00176550","E00176550","Total",94,23,2,21,4,49,6,43,17,15,0,2,0,1
"2011","E00176559","E00176559","Total",112,26,2,24,13,24,2,22,48,48,0,0,0,1
"2011","E00176563","E00176563","Total",129,75,8,67,0,9,0,9,44,42,0,2,0,1
"2011","E00176574","E00176574","Total",88,23,1,22,4,35,3,32,24,24,0,0,0,2
"2011","E00176576","E00176576","Total",118,33,3,30,0,52,1,51,33,31,0,2,0,0
"2011","E00176587","E00176587","Total",122,46,2,44,5,18,1,17,52,49,0,3,0,1
"2011","E00008404","E00008404","Total",113,33,4,29,16,34,1,33,30,30,0,0,0,0
"2011","E00008413","E00008413","Total",113,56,15,41,0,24,3,21,32,31,0,1,0,1
"2011","E00008418","E00008418","Total",115,58,11,47,7,13,0,13,35,34,0,1,0,2
"2011","E00008421","E00008421","Total",117,52,4,48,1,20,2,18,41,39,0,1,1,3
"2011","E00176593","E00176593","Total",133,62,7,55,13,23,1,22,34,33,0,0,1,1
"2011","E00007821","E00007821","Total",123,32,11,21,2,75,70,5,12,12,0,0,0,2
"2011","E00007822","E00007822","Total",110,39,15,24,1,53,45,8,15,14,0,1,0,2
"2011","E00007823","E00007823","Total",121,46,19,27,0,63,58,5,11,11,0,0,0,1
"2011","E00007824","E00007824","Total",127,46,20,26,0,71,69,2,9,7,0,2,0,1
"2011","E00007826","E00007826","Total",118,56,29,27,0,45,39,6,17,17,0,0,0,0
"2011","E00007825","E00007825","Total",174,62,26,36,0,95,73,22,15,13,0,2,0,2
"2011","E00007828","E00007828","Total",128,43,15,28,0,65,59,6,17,14,0,2,1,3
"2011","E00007829","E00007829","Total",114,48,20,28,0,55,51,4,8,7,0,0,1,3
"2011","E00007832","E00007832","Total",115,16,3,13,0,83,81,2,12,12,0,0,0,4
"2011","E00007834","E00007834","Total",127,24,11,13,0,93,89,4,10,9,0,1,0,0
"2011","E00007799","E00007799","Total",120,44,20,24,0,60,53,7,13,13,0,0,0,3
"2011","E00007827","E00007827","Total",117,46,17,29,0,53,47,6,18,17,0,1,0,0
"2011","E00007830","E00007830","Total",145,55,26,29,0,75,63,12,13,12,0,1,0,2
"2011","E00007831","E00007831","Total",109,42,14,28,0,53,50,3,13,12,0,1,0,1
"2011","E00007833","E00007833","Total",139,47,20,27,0,77,71,6,13,13,0,0,0,2
"2011","E00007836","E00007836","Total",107,47,22,25,0,44,41,3,14,14,0,0,0,2
"2011","E00007800","E00007800","Total",111,60,26,34,0,34,29,5,17,16,0,1,0,0
"2011","E00007801","E00007801","Total",128,60,22,38,0,41,6,35,27,25,1,1,0,0
"2011","E00007802","E00007802","Total",128,67,21,46,0,36,27,9,24,23,0,1,0,1
"2011","E00007837","E00007837","Total",120,55,22,33,0,54,48,6,11,11,0,0,0,0
"2011","E00176571","E00176571","Total",123,50,18,32,3,41,29,12,26,22,0,2,2,3
"2011","E00176573","E00176573","Total",103,23,1,22,5,13,2,11,61,60,0,1,0,1
"2011","E00176586","E00176586","Total",96,29,2,27,9,15,6,9,41,40,0,1,0,2
"2011","E00007798","E00007798","Total",117,30,11,19,0,76,75,1,10,10,0,0,0,1
"2011","E00007803","E00007803","Total",137,78,26,52,0,38,23,15,21,20,0,1,0,0
"2011","E00007807","E00007807","Total",127,44,14,30,0,69,64,5,12,12,0,0,0,2
"2011","E00007835","E00007835","Total",134,62,30,32,0,58,55,3,14,14,0,0,0,0
"2011","E00007838","E00007838","Total",122,40,13,27,0,69,62,7,13,13,0,0,0,0
"2011","E00008497","E00008497","Total",84,15,4,11,0,41,37,4,28,25,0,3,0,0
"2011","E00008510","E00008510","Total",131,13,4,9,1,93,83,10,22,20,1,1,0,2
"2011","E00008521","E00008521","Total",132,17,8,9,1,84,77,7,30,28,0,1,1,0
"2011","E00008528","E00008528","Total",147,43,10,33,0,94,81,13,9,9,0,0,0,1
"2011","E00008498","E00008498","Total",109,31,9,22,0,5,2,3,72,72,0,0,0,1
"2011","E00008499","E00008499","Total",105,16,5,11,0,79,75,4,9,9,0,0,0,1
"2011","E00008500","E00008500","Total",132,54,7,47,1,5,2,3,71,67,0,3,1,1
"2011","E00008501","E00008501","Total",145,52,10,42,1,5,3,2,87,82,0,5,0,0
"2011","E00008503","E00008503","Total",121,28,7,21,0,63,19,44,29,28,0,1,0,1
"2011","E00008492","E00008492","Total",119,11,7,4,1,92,79,13,10,10,0,0,0,5
"2011","E00008502","E00008502","Total",105,15,5,10,0,85,83,2,3,3,0,0,0,2
"2011","E00008505","E00008505","Total",150,13,8,5,1,121,116,5,14,14,0,0,0,1
"2011","E00008507","E00008507","Total",139,15,5,10,0,105,94,11,18,17,0,1,0,1
"2011","E00008508","E00008508","Total",130,21,5,16,1,96,93,3,12,12,0,0,0,0
"2011","E00176502","E00176502","Total",102,14,4,10,2,63,54,9,20,18,0,2,0,3
"2011","E00176555","E00176555","Total",135,19,2,17,1,54,7,47,61,61,0,0,0,0
"2011","E00176588","E00176588","Total",55,10,2,8,1,31,15,16,13,12,0,0,1,0
"2011","E00176501","E00176501","Total",70,7,2,5,20,9,2,7,31,26,0,3,2,3
"2011","E00176513","E00176513","Total",142,71,17,54,1,2,1,1,65,63,0,2,0,3
"2011","E00176521","E00176521","Total",347,20,3,17,114,166,7,159,45,42,0,2,1,2
"2011","E00176507","E00176507","Total",145,22,3,19,1,93,8,85,26,22,2,1,1,3
"2011","E00176514","E00176514","Total",127,23,5,18,54,4,3,1,46,43,0,3,0,0
"2011","E00176539","E00176539","Total",307,90,7,83,81,27,3,24,106,104,0,2,0,3
"2011","E00008514","E00008514","Total",138,3,1,2,0,120,119,1,13,13,0,0,0,2
"2011","E00176508","E00176508","Total",107,8,5,3,2,6,5,1,90,89,0,0,1,1
"2011","E00176538","E00176538","Total",94,4,1,3,0,58,37,21,31,30,0,1,0,1
"2011","E00176568","E00176568","Total",216,23,5,18,9,18,6,12,166,162,1,2,1,0
"2011","E00176509","E00176509","Total",91,20,3,17,3,2,0,2,65,63,1,1,0,1
"2011","E00176511","E00176511","Total",127,46,5,41,1,1,0,1,78,74,0,3,1,1
"2011","E00176512","E00176512","Total",110,31,2,29,2,5,0,5,72,72,0,0,0,0
"2011","E00176544","E00176544","Total",182,36,4,32,30,26,1,25,87,80,0,6,1,3
"2011","E00176583","E00176583","Total",98,38,9,29,2,3,3,0,54,53,0,1,0,1
"2011","E00008509","E00008509","Total",133,20,10,10,0,73,67,6,39,38,0,1,0,1
"2011","E00008517","E00008517","Total",105,7,0,7,0,82,79,3,14,14,0,0,0,2
"2011","E00008518","E00008518","Total",134,30,8,22,0,84,57,27,18,17,0,1,0,2
"2011","E00008519","E00008519","Total",125,20,8,12,0,94,42,52,6,6,0,0,0,5
"2011","E00176510","E00176510","Total",105,7,2,5,3,24,2,22,70,67,0,2,1,1
"2011","E00008516","E00008516","Total",135,19,9,10,0,105,98,7,7,7,0,0,0,4
"2011","E00008522","E00008522","Total",128,37,7,30,1,72,71,1,16,16,0,0,0,2
"2011","E00008524","E00008524","Total",132,7,1,6,1,111,107,4,9,8,0,1,0,4
"2011","E00008533","E00008533","Total",129,28,11,17,21,27,22,5,51,48,0,2,1,2
"2011","E00176562","E00176562","Total",158,10,4,6,0,103,71,32,42,40,0,2,0,3
"2011","E00176589","E00176589","Total",78,5,1,4,0,67,3,64,6,6,0,0,0,0
"2011","E00008491","E00008491","Total",106,10,6,4,0,87,11,76,9,8,0,0,1,0
"2011","E00008520","E00008520","Total",125,30,6,24,0,77,31,46,17,17,0,0,0,1
"2011","E00008529","E00008529","Total",102,40,14,26,0,46,38,8,15,15,0,0,0,1
"2011","E00008532","E00008532","Total",146,15,4,11,6,104,103,1,20,19,0,1,0,1
"2011","E00008494","E00008494","Total",130,34,7,27,0,82,79,3,12,11,0,1,0,2
"2011","E00008495","E00008495","Total",98,52,17,35,0,20,7,13,23,23,0,0,0,3
"2011","E00008531","E00008531","Total",101,31,6,25,2,40,37,3,28,27,0,0,1,0
"2011","E00008534","E00008534","Total",105,74,33,41,0,13,10,3,18,18,0,0,0,0
"2011","E00008535","E00008535","Total",97,58,27,31,0,25,23,2,13,13,0,0,0,1
"2011","E00008536","E00008536","Total",109,76,35,41,0,19,9,10,14,14,0,0,0,0
"2011","E00008493","E00008493","Total",123,1,0,1,0,112,51,61,8,7,0,0,1,2
"2011","E00008513","E00008513","Total",147,9,1,8,0,117,114,3,20,15,0,3,2,1
"2011","E00008525","E00008525","Total",147,12,4,8,0,115,115,0,14,13,0,1,0,6
"2011","E00008527","E00008527","Total",130,25,8,17,0,80,75,5,22,21,0,0,1,3
"2011","E00008530","E00008530","Total",138,10,1,9,1,113,109,4,13,13,0,0,0,1
"2011","E00008496","E00008496","Total",127,4,1,3,0,112,104,8,9,8,0,1,0,2
"2011","E00008511","E00008511","Total",125,15,4,11,0,94,93,1,14,13,0,1,0,2
"2011","E00008512","E00008512","Total",115,4,1,3,1,105,105,0,2,2,0,0,0,3
"2011","E00008515","E00008515","Total",133,6,2,4,0,121,119,2,6,4,0,2,0,0
"2011","E00008526","E00008526","Total",136,22,10,12,0,96,93,3,16,13,0,3,0,2
"2011","E00008328","E00008328","Total",120,40,8,32,0,43,28,15,34,31,0,3,0,3
"2011","E00008331","E00008331","Total",130,27,8,19,1,43,33,10,57,54,0,2,1,2
"2011","E00008332","E00008332","Total",140,64,18,46,0,24,15,9,51,48,0,3,0,1
"2011","E00008333","E00008333","Total",142,60,15,45,2,14,11,3,65,62,0,1,2,1
"2011","E00008336","E00008336","Total",98,52,21,31,2,7,6,1,37,37,0,0,0,0
"2011","E00008330","E00008330","Total",101,11,4,7,1,81,76,5,7,7,0,0,0,1
"2011","E00008335","E00008335","Total",130,57,23,34,0,27,11,16,45,43,0,1,1,1
"2011","E00008340","E00008340","Total",108,21,9,12,2,44,13,31,40,38,0,2,0,1
"2011","E00008344","E00008344","Total",99,16,6,10,0,70,67,3,10,10,0,0,0,3
"2011","E00176533","E00176533","Total",122,43,14,29,0,18,14,4,60,58,0,2,0,1
"2011","E00176581","E00176581","Total",125,30,15,15,1,50,17,33,43,40,0,2,1,1
"2011","E00008318","E00008318","Total",118,76,25,51,0,24,14,10,18,18,0,0,0,0
"2011","E00008329","E00008329","Total",156,93,26,67,1,26,9,17,34,32,0,1,1,2
"2011","E00008334","E00008334","Total",117,67,31,36,0,34,21,13,15,12,0,2,1,1
"2011","E00008337","E00008337","Total",111,66,27,39,0,11,5,6,32,31,0,1,0,2
"2011","E00008342","E00008342","Total",169,69,25,44,2,46,17,29,51,50,0,0,1,1
"2011","E00008339","E00008339","Total",112,43,21,22,1,35,20,15,33,33,0,0,0,0
"2011","E00008343","E00008343","Total",137,70,31,39,1,10,2,8,54,52,0,1,1,2
"2011","E00008345","E00008345","Total",120,68,24,44,0,20,4,16,31,28,0,2,1,1
"2011","E00008346","E00008346","Total",117,42,17,25,0,40,13,27,31,27,1,3,0,4
"2011","E00008351","E00008351","Total",143,42,5,37,0,68,15,53,33,31,0,2,0,0
"2011","E00008341","E00008341","Total",159,64,29,35,1,40,10,30,49,47,0,2,0,5
"2011","E00008347","E00008347","Total",134,82,21,61,2,22,3,19,28,28,0,0,0,0
"2011","E00008349","E00008349","Total",137,84,28,56,1,20,14,6,31,28,0,3,0,1
"2011","E00008352","E00008352","Total",119,63,20,43,2,16,2,14,36,35,0,1,0,2
"2011","E00008354","E00008354","Total",119,80,22,58,1,10,4,6,26,24,0,2,0,2
"2011","E00008136","E00008136","Total",248,18,6,12,5,191,82,109,32,31,0,1,0,2
"2011","E00008139","E00008139","Total",144,19,6,13,1,102,96,6,21,19,0,2,0,1
"2011","E00008140","E00008140","Total",98,29,15,14,0,35,1,34,34,33,0,1,0,0
"2011","E00008143","E00008143","Total",134,24,5,19,0,92,90,2,17,15,0,1,1,1
"2011","E00008144","E00008144","Total",169,17,6,11,0,135,107,28,14,14,0,0,0,3
"2011","E00008104","E00008104","Total",125,54,20,34,1,28,8,20,40,38,0,2,0,2
"2011","E00008107","E00008107","Total",139,57,28,29,1,39,10,29,41,40,0,1,0,1
"2011","E00008108","E00008108","Total",114,57,25,32,0,14,7,7,40,36,0,3,1,3
"2011","E00008117","E00008117","Total",120,57,21,36,1,12,3,9,46,43,1,0,2,4
"2011","E00176541","E00176541","Total",72,32,13,19,1,6,2,4,33,31,1,1,0,0
"2011","E00176546","E00176546","Total",65,28,19,9,1,8,3,5,27,26,0,0,1,1
"2011","E00008101","E00008101","Total",147,81,26,55,0,29,15,14,36,35,0,0,1,1
"2011","E00008102","E00008102","Total",127,84,27,57,1,19,6,13,23,21,0,2,0,0
"2011","E00008119","E00008119","Total",119,41,19,22,0,50,3,47,27,27,0,0,0,1
"2011","E00008123","E00008123","Total",132,99,40,59,0,9,1,8,22,21,0,1,0,2
"2011","E00008128","E00008128","Total",93,61,12,49,0,6,0,6,25,22,0,3,0,1
"2011","E00008114","E00008114","Total",108,37,14,23,1,22,4,18,47,44,0,3,0,1
"2011","E00008115","E00008115","Total",136,58,22,36,2,26,3,23,50,48,0,1,1,0
"2011","E00008116","E00008116","Total",130,23,7,16,0,73,43,30,33,31,0,2,0,1
"2011","E00008118","E00008118","Total",114,66,28,38,0,13,7,6,34,31,0,2,1,1
"2011","E00008122","E00008122","Total",105,68,28,40,0,8,2,6,29,29,0,0,0,0
"2011","E00008132","E00008132","Total",186,47,7,40,19,39,9,30,76,73,1,2,0,5
"2011","E00176548","E00176548","Total",84,20,2,18,20,3,3,0,41,40,0,1,0,0
"2011","E00176549","E00176549","Total",79,32,4,28,3,10,3,7,34,34,0,0,0,0
"2011","E00176569","E00176569","Total",105,28,5,23,30,2,1,1,43,43,0,0,0,2
"2011","E00176584","E00176584","Total",127,19,3,16,4,2,1,1,102,97,0,4,1,0
"2011","E00008133","E00008133","Total",211,75,17,58,11,57,4,53,67,63,0,4,0,1
"2011","E00008134","E00008134","Total",129,20,3,17,0,90,15,75,19,18,0,0,1,0
"2011","E00008135","E00008135","Total",125,73,19,54,1,12,4,8,37,36,0,1,0,2
"2011","E00176564","E00176564","Total",89,18,0,18,0,35,2,33,36,33,0,0,3,0
"2011","E00176577","E00176577","Total",92,28,6,22,3,43,6,37,16,12,0,1,3,2
"2011","E00007795","E00007795","Total",141,76,20,56,0,28,20,8,36,35,0,1,0,1
"2011","E00007805","E00007805","Total",123,82,25,57,0,25,22,3,16,16,0,0,0,0
"2011","E00007808","E00007808","Total",132,95,33,62,0,9,5,4,28,26,0,2,0,0
"2011","E00007809","E00007809","Total",112,79,31,48,1,10,5,5,20,16,0,2,2,2
"2011","E00007810","E00007810","Total",107,81,29,52,1,9,6,3,15,15,0,0,0,1
"2011","E00007793","E00007793","Total",118,76,33,43,1,10,6,4,29,28,0,1,0,2
"2011","E00007804","E00007804","Total",112,66,24,42,0,11,9,2,34,32,0,2,0,1
"2011","E00007806","E00007806","Total",114,73,20,53,1,6,2,4,32,29,0,3,0,2
"2011","E00007813","E00007813","Total",160,100,43,57,0,44,20,24,15,14,0,1,0,1
"2011","E00007814","E00007814","Total",124,91,33,58,1,8,4,4,23,22,0,1,0,1
"2011","E00007794","E00007794","Total",139,95,35,60,1,16,11,5,26,24,1,1,0,1
"2011","E00007796","E00007796","Total",125,71,25,46,0,25,20,5,29,27,0,2,0,0
"2011","E00007812","E00007812","Total",118,83,39,44,2,19,18,1,13,10,0,3,0,1
"2011","E00007817","E00007817","Total",131,111,47,64,0,8,5,3,12,12,0,0,0,0
"2011","E00007811","E00007811","Total",130,39,14,25,0,76,73,3,15,15,0,0,0,0
"2011","E00007815","E00007815","Total",105,8,3,5,0,81,79,2,15,15,0,0,0,1
"2011","E00007816","E00007816","Total",115,9,0,9,0,89,86,3,16,16,0,0,0,1
"2011","E00007818","E00007818","Total",138,18,4,14,0,104,104,0,14,14,0,0,0,2
"2011","E00007819","E00007819","Total",141,13,3,10,4,103,101,2,19,18,0,1,0,2
"2011","E00007820","E00007820","Total",139,90,36,54,1,36,34,2,12,12,0,0,0,0
"2011","E00008103","E00008103","Total",144,23,7,16,1,102,97,5,16,15,0,0,1,2
"2011","E00008138","E00008138","Total",114,18,3,15,1,82,79,3,13,12,0,0,1,0
"2011","E00008141","E00008141","Total",131,36,13,23,1,79,70,9,15,13,0,1,1,0
"2011","E00008142","E00008142","Total",122,18,3,15,2,89,85,4,11,10,0,0,1,2
"2011","E00176534","E00176534","Total",116,26,12,14,1,58,56,2,30,29,0,1,0,1
"2011","E00176572","E00176572","Total",116,6,0,6,1,56,24,32,51,50,0,0,1,2
"2011","E00176582","E00176582","Total",109,9,3,6,22,18,5,13,58,58,0,0,0,2
"2011","E00008109","E00008109","Total",127,12,4,8,0,101,99,2,12,11,0,1,0,2
"2011","E00008110","E00008110","Total",123,54,18,36,1,41,35,6,23,22,0,0,1,4
"2011","E00008112","E00008112","Total",83,6,1,5,0,65,65,0,11,11,0,0,0,1
"2011","E00008120","E00008120","Total",80,45,17,28,0,10,4,6,24,22,0,1,1,1
"2011","E00008125","E00008125","Total",118,24,7,17,0,79,72,7,9,9,0,0,0,6
"2011","E00008127","E00008127","Total",121,26,9,17,1,69,59,10,22,22,0,0,0,3
"2011","E00008105","E00008105","Total",141,25,6,19,0,104,97,7,11,10,0,1,0,1
"2011","E00008111","E00008111","Total",135,7,3,4,1,120,120,0,6,6,0,0,0,1
"2011","E00008121","E00008121","Total",126,37,4,33,0,72,69,3,14,14,0,0,0,3
"2011","E00008145","E00008145","Total",133,7,2,5,11,105,98,7,8,5,0,2,1,2
"2011","E00008146","E00008146","Total",132,10,6,4,0,107,94,13,13,11,0,1,1,2
"2011","E00008113","E00008113","Total",167,61,13,48,1,32,18,14,70,68,1,1,0,3
"2011","E00008124","E00008124","Total",101,61,23,38,0,15,12,3,25,22,0,2,1,0
"2011","E00008126","E00008126","Total",146,45,19,26,0,84,83,1,15,14,0,0,1,2
"2011","E00008129","E00008129","Total",146,51,23,28,1,63,42,21,28,26,0,2,0,3
"2011","E00008130","E00008130","Total",146,72,38,34,0,30,12,18,37,37,0,0,0,7
"2011","E00008452","E00008452","Total",82,23,6,17,0,49,47,2,9,7,0,2,0,1
"2011","E00008453","E00008453","Total",151,7,3,4,1,135,133,2,8,7,0,1,0,0
"2011","E00008456","E00008456","Total",179,10,3,7,0,151,151,0,18,17,0,0,1,0
"2011","E00008457","E00008457","Total",121,42,21,21,1,37,33,4,39,35,1,2,1,2
"2011","E00008460","E00008460","Total",121,34,16,18,0,47,34,13,37,37,0,0,0,3
"2011","E00008450","E00008450","Total",165,9,8,1,0,104,24,80,51,47,0,3,1,1
"2011","E00008451","E00008451","Total",104,10,3,7,0,79,70,9,13,12,1,0,0,2
"2011","E00008455","E00008455","Total",112,6,3,3,9,66,34,32,29,27,1,1,0,2
"2011","E00008463","E00008463","Total",125,3,0,3,1,107,107,0,14,13,0,0,1,0
"2011","E00008454","E00008454","Total",129,51,28,23,1,21,11,10,54,51,0,3,0,2
"2011","E00008462","E00008462","Total",155,38,12,26,11,32,9,23,74,73,0,0,1,0
"2011","E00008464","E00008464","Total",151,55,20,35,1,30,7,23,63,58,0,5,0,2
"2011","E00008465","E00008465","Total",143,32,12,20,0,37,15,22,72,71,0,0,1,2
"2011","E00008466","E00008466","Total",192,21,8,13,17,127,82,45,26,23,0,0,3,1
"2011","E00008448","E00008448","Total",132,73,31,42,0,17,11,6,41,39,0,1,1,1
"2011","E00008468","E00008468","Total",78,21,9,12,0,33,20,13,23,22,0,1,0,1
"2011","E00008471","E00008471","Total",81,12,6,6,2,31,23,8,34,32,0,0,2,2
"2011","E00008476","E00008476","Total",135,8,2,6,2,107,103,4,17,15,0,2,0,1
"2011","E00176561","E00176561","Total",143,58,17,41,4,27,6,21,54,52,0,2,0,0
"2011","E00176585","E00176585","Total",134,33,10,23,51,13,2,11,37,36,0,1,0,0
"2011","E00008467","E00008467","Total",158,24,7,17,4,113,107,6,15,15,0,0,0,2
"2011","E00008473","E00008473","Total",146,15,2,13,0,117,103,14,11,10,0,1,0,3
"2011","E00008479","E00008479","Total",173,14,4,10,0,140,138,2,16,14,0,2,0,3
"2011","E00008482","E00008482","Total",122,23,4,19,0,80,68,12,18,18,0,0,0,1
"2011","E00008485","E00008485","Total",154,17,4,13,0,105,103,2,27,25,0,2,0,5
"2011","E00008445","E00008445","Total",125,64,19,45,0,43,5,38,18,16,0,2,0,0
"2011","E00008469","E00008469","Total",126,56,19,37,0,36,9,27,32,28,0,2,2,2
"2011","E00008478","E00008478","Total",134,92,34,58,2,27,10,17,12,11,0,1,0,1
"2011","E00008484","E00008484","Total",103,32,9,23,1,41,31,10,25,24,0,1,0,4
"2011","E00008486","E00008486","Total",127,78,20,58,0,24,12,12,25,24,0,1,0,0
"2011","E00007890","E00007890","Total",125,24,4,20,0,86,84,2,12,12,0,0,0,3
"2011","E00007898","E00007898","Total",142,35,11,24,2,81,70,11,21,21,0,0,0,3
"2011","E00007900","E00007900","Total",129,69,21,48,0,46,44,2,13,12,0,1,0,1
"2011","E00007902","E00007902","Total",137,64,35,29,0,46,40,6,23,21,0,2,0,4
"2011","E00007903","E00007903","Total",126,39,14,25,1,70,67,3,16,13,0,3,0,0
"2011","E00007895","E00007895","Total",122,47,19,28,0,69,62,7,4,4,0,0,0,2
"2011","E00007928","E00007928","Total",129,48,17,31,1,61,56,5,18,17,0,1,0,1
"2011","E00007929","E00007929","Total",94,34,3,31,0,53,47,6,6,5,0,1,0,1
"2011","E00007930","E00007930","Total",125,70,21,49,0,26,6,20,28,26,0,2,0,1
"2011","E00007931","E00007931","Total",146,37,7,30,1,54,12,42,54,52,0,1,1,0
"2011","E00007891","E00007891","Total",123,5,0,5,0,108,93,15,9,9,0,0,0,1
"2011","E00007896","E00007896","Total",111,4,0,4,0,95,26,69,12,11,0,0,1,0
"2011","E00007897","E00007897","Total",145,37,13,24,0,91,66,25,15,14,0,1,0,2
"2011","E00007904","E00007904","Total",190,43,14,29,0,94,54,40,47,46,0,1,0,6
"2011","E00007908","E00007908","Total",141,92,33,59,1,23,7,16,25,24,0,1,0,0
"2011","E00007915","E00007915","Total",129,10,3,7,0,107,16,91,9,9,0,0,0,3
"2011","E00007919","E00007919","Total",130,60,25,35,0,58,13,45,11,11,0,0,0,1
"2011","E00007921","E00007921","Total",139,115,59,56,0,12,9,3,10,10,0,0,0,2
"2011","E00007923","E00007923","Total",138,14,1,13,0,114,17,97,9,7,0,1,1,1
"2011","E00007925","E00007925","Total",130,17,1,16,0,93,11,82,20,16,0,1,3,0
"2011","E00007927","E00007927","Total",156,45,19,26,2,96,22,74,12,10,0,2,0,1
"2011","E00007888","E00007888","Total",101,56,19,37,0,28,3,25,15,15,0,0,0,2
"2011","E00007892","E00007892","Total",118,64,28,36,0,26,4,22,27,25,0,1,1,1
"2011","E00007893","E00007893","Total",114,46,17,29,0,34,5,29,34,32,0,2,0,0
"2011","E00007894","E00007894","Total",115,74,32,42,0,26,8,18,14,13,0,1,0,1
"2011","E00007899","E00007899","Total",101,63,27,36,0,28,9,19,10,8,0,1,1,0
"2011","E00007905","E00007905","Total",152,53,17,36,0,47,19,28,50,47,0,3,0,2
"2011","E00007889","E00007889","Total",113,55,16,39,1,24,5,19,32,31,0,1,0,1
"2011","E00007901","E00007901","Total",124,63,18,45,0,15,6,9,45,40,0,5,0,1
"2011","E00007907","E00007907","Total",131,101,43,58,0,6,4,2,24,23,0,0,1,0
"2011","E00007909","E00007909","Total",115,62,16,46,0,37,30,7,15,12,0,3,0,1
"2011","E00007910","E00007910","Total",137,95,26,69,0,15,5,10,26,24,0,2,0,1
"2011","E00007912","E00007912","Total",120,83,27,56,2,13,8,5,22,21,0,1,0,0
"2011","E00007887","E00007887","Total",122,84,36,48,0,10,6,4,27,26,0,1,0,1
"2011","E00007914","E00007914","Total",117,88,35,53,1,11,8,3,16,16,0,0,0,1
"2011","E00007920","E00007920","Total",111,88,43,45,0,4,1,3,18,16,0,2,0,1
"2011","E00007922","E00007922","Total",119,70,31,39,1,30,28,2,18,17,0,1,0,0
"2011","E00007924","E00007924","Total",113,69,27,42,0,21,11,10,23,20,2,0,1,0
"2011","E00007926","E00007926","Total",146,89,37,52,1,31,30,1,25,25,0,0,0,0
"2011","E00007906","E00007906","Total",125,35,4,31,2,77,8,69,11,10,0,1,0,0
"2011","E00007911","E00007911","Total",134,53,31,22,0,71,9,62,7,4,1,1,1,3
"2011","E00007913","E00007913","Total",127,41,8,33,2,57,10,47,25,24,0,1,0,2
"2011","E00007916","E00007916","Total",114,2,1,1,0,96,30,66,15,14,0,0,1,1
"2011","E00007917","E00007917","Total",132,36,7,29,3,67,18,49,25,23,0,2,0,1
"2011","E00007918","E00007918","Total",131,13,1,12,0,104,16,88,14,12,1,1,0,0
"2011","E00008444","E00008444","Total",179,59,15,44,1,61,41,20,56,55,1,0,0,2
"2011","E00008470","E00008470","Total",108,6,1,5,1,96,92,4,5,5,0,0,0,0
"2011","E00008474","E00008474","Total",123,7,1,6,0,103,102,1,12,11,0,1,0,1
"2011","E00008480","E00008480","Total",129,26,6,20,0,83,68,15,19,19,0,0,0,1
"2011","E00008489","E00008489","Total",143,42,5,37,0,45,18,27,53,53,0,0,0,3
"2011","E00008458","E00008458","Total",116,26,5,21,1,29,2,27,58,42,6,3,7,2
"2011","E00008459","E00008459","Total",99,18,3,15,1,4,1,3,75,37,20,2,16,1
"2011","E00008461","E00008461","Total",132,6,0,6,3,115,115,0,6,5,0,1,0,2
"2011","E00008472","E00008472","Total",133,13,2,11,1,51,47,4,67,27,22,4,14,1
"2011","E00008475","E00008475","Total",122,9,1,8,0,99,98,1,14,10,0,3,1,0
"2011","E00008446","E00008446","Total",171,66,20,46,2,57,37,20,42,35,3,2,2,4
"2011","E00008447","E00008447","Total",220,36,15,21,21,45,7,38,116,40,46,3,27,2
"2011","E00008488","E00008488","Total",113,7,2,5,4,84,82,2,18,10,6,1,1,0
"2011","E00008490","E00008490","Total",94,12,2,10,0,11,7,4,70,13,30,1,26,1
"2011","E00008477","E00008477","Total",124,19,4,15,0,95,89,6,9,7,1,1,0,1
"2011","E00008481","E00008481","Total",107,12,5,7,0,86,79,7,7,6,0,0,1,2
"2011","E00008483","E00008483","Total",125,33,7,26,0,74,71,3,18,14,2,2,0,0
"2011","E00008487","E00008487","Total",119,36,7,29,0,68,65,3,14,14,0,0,0,1
"2011","E00007839","E00007839","Total",119,51,21,30,0,37,10,27,31,31,0,0,0,0
"2011","E00007841","E00007841","Total",119,28,7,21,0,68,59,9,22,21,0,1,0,1
"2011","E00007843","E00007843","Total",145,69,25,44,1,34,28,6,41,40,0,1,0,0
"2011","E00007858","E00007858","Total",110,52,13,39,0,24,9,15,34,34,0,0,0,0
"2011","E00007867","E00007867","Total",92,51,19,32,0,18,9,9,23,23,0,0,0,0
"2011","E00007877","E00007877","Total",133,30,6,24,7,77,54,23,19,18,0,0,1,0
"2011","E00007880","E00007880","Total",120,31,16,15,0,63,42,21,22,22,0,0,0,4
"2011","E00007859","E00007859","Total",97,46,13,33,1,17,7,10,30,30,0,0,0,3
"2011","E00007861","E00007861","Total",84,53,18,35,0,10,5,5,21,20,0,1,0,0
"2011","E00007862","E00007862","Total",123,83,42,41,0,26,19,7,14,13,0,0,1,0
"2011","E00007865","E00007865","Total",109,69,31,38,0,28,25,3,12,10,0,2,0,0
"2011","E00007866","E00007866","Total",124,92,34,58,1,13,4,9,17,16,0,1,0,1
"2011","E00007869","E00007869","Total",91,47,19,28,0,18,15,3,24,24,0,0,0,2
"2011","E00007842","E00007842","Total",124,41,16,25,1,38,35,3,43,42,0,1,0,1
"2011","E00007860","E00007860","Total",125,70,35,35,0,31,19,12,23,23,0,0,0,1
"2011","E00007863","E00007863","Total",99,36,23,13,0,50,11,39,13,12,1,0,0,0
"2011","E00007870","E00007870","Total",113,61,32,29,2,28,28,0,22,21,0,1,0,0
"2011","E00007874","E00007874","Total",96,29,16,13,1,49,15,34,17,14,0,1,2,0
"2011","E00007876","E00007876","Total",126,38,17,21,0,75,70,5,13,10,0,3,0,0
"2011","E00007864","E00007864","Total",109,24,12,12,1,71,70,1,12,11,0,1,0,1
"2011","E00007871","E00007871","Total",132,85,39,46,1,24,21,3,22,22,0,0,0,0
"2011","E00007872","E00007872","Total",110,73,31,42,0,7,6,1,29,29,0,0,0,1
"2011","E00007873","E00007873","Total",134,49,23,26,1,27,20,7,57,57,0,0,0,0
"2011","E00007875","E00007875","Total",118,74,39,35,0,7,5,2,35,35,0,0,0,2
"2011","E00176580","E00176580","Total",111,50,13,37,27,9,3,6,23,23,0,0,0,2
"2011","E00176592","E00176592","Total",104,22,6,16,24,30,2,28,27,26,0,1,0,1
"2011","E00176594","E00176594","Total",103,83,44,39,0,10,10,0,10,9,0,1,0,0
"2011","E00008363","E00008363","Total",122,92,40,52,0,10,5,5,16,14,0,2,0,4
"2011","E00008380","E00008380","Total",125,99,32,67,0,6,2,4,19,18,0,1,0,1
"2011","E00008381","E00008381","Total",125,81,35,46,5,17,16,1,21,20,0,1,0,1
"2011","E00008390","E00008390","Total",130,90,30,60,0,31,30,1,9,9,0,0,0,0
"2011","E00008392","E00008392","Total",126,105,47,58,0,7,1,6,12,12,0,0,0,2
"2011","E00008368","E00008368","Total",111,68,28,40,0,22,5,17,19,17,0,1,1,2
"2011","E00008369","E00008369","Total",110,63,25,38,0,29,18,11,18,17,0,1,0,0
"2011","E00008370","E00008370","Total",125,75,32,43,0,23,4,19,25,22,0,3,0,2
"2011","E00008402","E00008402","Total",105,58,19,39,0,30,8,22,16,16,0,0,0,1
"2011","E00008403","E00008403","Total",114,35,7,28,1,47,41,6,30,29,0,1,0,1
"2011","E00008364","E00008364","Total",119,21,8,13,0,91,5,86,6,5,0,0,1,1
"2011","E00008371","E00008371","Total",100,60,22,38,0,28,22,6,9,9,0,0,0,3
"2011","E00008383","E00008383","Total",131,96,33,63,0,11,2,9,23,22,0,1,0,1
"2011","E00008386","E00008386","Total",100,57,23,34,1,34,33,1,7,7,0,0,0,1
"2011","E00008391","E00008391","Total",111,68,22,46,1,35,34,1,6,6,0,0,0,1
"2011","E00008361","E00008361","Total",110,52,14,38,2,32,30,2,24,18,0,4,2,0
"2011","E00008372","E00008372","Total",114,55,10,45,1,33,26,7,24,23,0,1,0,1
"2011","E00008374","E00008374","Total",125,102,45,57,3,4,3,1,15,15,0,0,0,1
"2011","E00008378","E00008378","Total",123,91,35,56,0,8,3,5,23,23,0,0,0,1
"2011","E00008385","E00008385","Total",138,75,31,44,5,47,19,28,8,6,0,2,0,3
"2011","E00008191","E00008191","Total",133,37,13,24,0,74,69,5,21,21,0,0,0,1
"2011","E00008215","E00008215","Total",128,42,8,34,2,36,2,34,48,44,0,3,1,0
"2011","E00008228","E00008228","Total",114,31,10,21,0,71,63,8,11,11,0,0,0,1
"2011","E00176485","E00176485","Total",100,19,5,14,13,40,4,36,26,25,0,1,0,2
"2011","E00176486","E00176486","Total",97,48,5,43,1,3,2,1,44,43,0,1,0,1
"2011","E00176487","E00176487","Total",106,21,2,19,0,34,2,32,49,48,0,1,0,2
"2011","E00176520","E00176520","Total",119,80,12,68,5,7,1,6,26,24,0,2,0,1
"2011","E00176537","E00176537","Total",116,31,5,26,0,51,2,49,33,31,0,1,1,1
"2011","E00176545","E00176545","Total",116,30,6,24,1,46,1,45,39,35,0,3,1,0
"2011","E00176578","E00176578","Total",150,72,12,60,2,17,2,15,59,54,0,5,0,0
"2011","E00008208","E00008208","Total",140,97,44,53,2,26,25,1,15,12,0,3,0,0
"2011","E00008209","E00008209","Total",128,47,15,32,0,64,40,24,14,8,0,2,4,3
"2011","E00008214","E00008214","Total",123,66,24,42,0,48,45,3,8,8,0,0,0,1
"2011","E00008216","E00008216","Total",99,39,14,25,0,47,45,2,13,12,0,1,0,0
"2011","E00008217","E00008217","Total",125,54,18,36,0,57,50,7,14,12,0,2,0,0
"2011","E00008210","E00008210","Total",123,53,13,40,0,49,48,1,18,17,0,1,0,3
"2011","E00008211","E00008211","Total",113,32,14,18,0,59,57,2,19,18,0,1,0,3
"2011","E00008212","E00008212","Total",136,55,17,38,0,68,66,2,10,9,0,1,0,3
"2011","E00008220","E00008220","Total",120,68,34,34,1,41,40,1,10,9,0,0,1,0
"2011","E00008221","E00008221","Total",142,64,28,36,0,62,60,2,14,14,0,0,0,2
"2011","E00008225","E00008225","Total",127,14,6,8,2,101,99,2,8,8,0,0,0,2
"2011","E00008213","E00008213","Total",125,85,32,53,0,4,4,0,35,33,0,1,1,1
"2011","E00008219","E00008219","Total",138,63,14,49,0,28,24,4,47,43,0,4,0,0
"2011","E00008222","E00008222","Total",96,34,10,24,1,56,55,1,5,5,0,0,0,0
"2011","E00008223","E00008223","Total",141,111,49,62,2,9,7,2,17,16,0,1,0,2
"2011","E00176496","E00176496","Total",181,108,54,54,0,44,40,4,27,26,0,0,1,2
"2011","E00008388","E00008388","Total",121,101,32,69,0,1,1,0,19,18,0,1,0,0
"2011","E00008395","E00008395","Total",133,104,44,60,1,13,0,13,14,13,0,1,0,1
"2011","E00008396","E00008396","Total",141,123,39,84,0,2,2,0,16,16,0,0,0,0
"2011","E00008400","E00008400","Total",125,68,21,47,0,41,2,39,15,13,1,1,0,1
"2011","E00008365","E00008365","Total",121,108,64,44,0,2,2,0,8,7,0,0,1,3
"2011","E00008366","E00008366","Total",119,100,49,51,0,5,3,2,12,11,1,0,0,2
"2011","E00008384","E00008384","Total",106,87,44,43,0,4,1,3,15,14,0,1,0,0
"2011","E00008393","E00008393","Total",128,103,49,54,1,1,1,0,21,19,1,1,0,2
"2011","E00008401","E00008401","Total",144,119,66,53,0,2,2,0,22,21,0,1,0,1
"2011","E00008367","E00008367","Total",113,77,27,50,0,23,14,9,13,13,0,0,0,0
"2011","E00008375","E00008375","Total",139,83,26,57,0,36,5,31,17,16,0,1,0,3
"2011","E00008376","E00008376","Total",123,90,34,56,0,17,4,13,16,14,0,2,0,0
"2011","E00008377","E00008377","Total",113,63,31,32,1,24,18,6,24,23,0,0,1,1
"2011","E00008394","E00008394","Total",132,114,46,68,2,2,0,2,12,11,0,1,0,2
"2011","E00008397","E00008397","Total",135,116,63,53,0,4,0,4,15,15,0,0,0,0
"2011","E00008398","E00008398","Total",124,49,22,27,0,64,25,39,11,8,0,1,2,0
"2011","E00008399","E00008399","Total",174,118,56,62,15,25,6,19,14,14,0,0,0,2
"2011","E00008362","E00008362","Total",128,71,23,48,0,27,24,3,30,29,0,1,0,0
"2011","E00008373","E00008373","Total",149,35,12,23,1,82,69,13,29,29,0,0,0,2
"2011","E00008379","E00008379","Total",121,54,14,40,0,25,7,18,42,41,0,1,0,0
"2011","E00008382","E00008382","Total",135,71,26,45,0,22,8,14,38,37,0,0,1,4
"2011","E00008387","E00008387","Total",112,63,20,43,0,28,27,1,21,21,0,0,0,0
"2011","E00008389","E00008389","Total",122,65,19,46,0,45,34,11,11,11,0,0,0,1
"2011","E00007840","E00007840","Total",128,42,21,21,0,6,6,0,79,78,1,0,0,1
"2011","E00007844","E00007844","Total",161,95,37,58,0,24,5,19,40,38,0,2,0,2
"2011","E00007878","E00007878","Total",157,49,14,35,0,14,3,11,90,88,0,2,0,4
"2011","E00007879","E00007879","Total",107,54,28,26,0,32,32,0,20,18,1,1,0,1
"2011","E00007882","E00007882","Total",127,83,39,44,1,5,5,0,36,34,0,1,1,2
"2011","E00007884","E00007884","Total",153,90,39,51,0,4,3,1,57,56,0,1,0,2
"2011","E00007849","E00007849","Total",124,67,29,38,0,36,36,0,16,15,0,1,0,5
"2011","E00007851","E00007851","Total",128,72,33,39,0,20,2,18,32,27,1,1,3,4
"2011","E00007853","E00007853","Total",154,89,40,49,0,38,34,4,24,24,0,0,0,3
"2011","E00007855","E00007855","Total",107,30,12,18,0,60,57,3,17,17,0,0,0,0
"2011","E00007856","E00007856","Total",128,95,54,41,0,7,0,7,26,24,0,1,1,0
"2011","E00007848","E00007848","Total",169,65,27,38,5,57,16,41,39,36,1,0,2,3
"2011","E00007850","E00007850","Total",110,60,32,28,0,11,3,8,35,31,1,2,1,4
"2011","E00007881","E00007881","Total",148,95,36,59,0,13,4,9,40,38,0,2,0,0
"2011","E00007883","E00007883","Total",118,74,29,45,0,1,1,0,43,42,1,0,0,0
"2011","E00007885","E00007885","Total",143,66,28,38,0,43,36,7,32,32,0,0,0,2
"2011","E00007886","E00007886","Total",130,52,15,37,0,17,6,11,60,58,1,1,0,1
"2011","E00007845","E00007845","Total",120,85,49,36,0,2,2,0,32,29,0,1,2,1
"2011","E00007846","E00007846","Total",143,64,23,41,0,7,5,2,72,71,0,1,0,0
"2011","E00007847","E00007847","Total",103,78,51,27,0,4,2,2,21,20,0,1,0,0
"2011","E00007852","E00007852","Total",119,75,47,28,1,23,10,13,18,16,2,0,0,2
"2011","E00007854","E00007854","Total",113,61,37,24,0,15,15,0,37,34,0,2,1,0
"2011","E00007857","E00007857","Total",115,57,26,31,0,30,30,0,24,24,0,0,0,4
"2011","E00008196","E00008196","Total",126,57,16,41,1,57,48,9,9,9,0,0,0,2
"2011","E00008197","E00008197","Total",113,54,18,36,0,50,47,3,7,7,0,0,0,2
"2011","E00008203","E00008203","Total",110,71,38,33,1,24,23,1,14,14,0,0,0,0
"2011","E00008230","E00008230","Total",114,58,24,34,2,41,38,3,8,6,0,2,0,5
"2011","E00008231","E00008231","Total",132,85,34,51,1,33,29,4,12,12,0,0,0,1
"2011","E00008232","E00008232","Total",119,58,21,37,0,46,44,2,13,11,0,0,2,2
"2011","E00008198","E00008198","Total",94,43,17,26,0,37,32,5,14,12,0,2,0,0
"2011","E00008200","E00008200","Total",104,69,33,36,0,24,24,0,10,10,0,0,0,1
"2011","E00008201","E00008201","Total",114,93,38,55,0,14,4,10,7,7,0,0,0,0
"2011","E00008226","E00008226","Total",139,111,59,52,0,7,7,0,20,20,0,0,0,1
"2011","E00008229","E00008229","Total",122,77,38,39,1,31,31,0,12,10,0,0,2,1
"2011","E00008192","E00008192","Total",133,116,51,65,2,7,5,2,6,5,0,1,0,2
"2011","E00008195","E00008195","Total",150,85,32,53,1,44,38,6,17,17,0,0,0,3
"2011","E00008199","E00008199","Total",224,147,26,121,0,5,4,1,69,67,0,2,0,3
"2011","E00008202","E00008202","Total",115,74,28,46,0,28,24,4,13,10,0,3,0,0
"2011","E00008204","E00008204","Total",107,30,11,19,0,69,68,1,8,7,0,1,0,0
"2011","E00008193","E00008193","Total",136,89,39,50,1,25,23,2,17,17,0,0,0,4
"2011","E00008194","E00008194","Total",101,48,18,30,0,42,37,5,11,11,0,0,0,0
"2011","E00008205","E00008205","Total",106,59,15,44,1,38,34,4,7,6,0,1,0,1
"2011","E00008206","E00008206","Total",106,56,19,37,4,33,30,3,11,10,0,1,0,2
"2011","E00008207","E00008207","Total",120,35,11,24,2,70,51,19,12,11,0,1,0,1
"2011","E00007975","E00007975","Total",109,101,40,61,1,3,2,1,4,3,0,1,0,0
"2011","E00007977","E00007977","Total",118,110,55,55,0,2,1,1,6,5,0,1,0,0
"2011","E00008000","E00008000","Total",123,119,56,63,0,1,0,1,2,2,0,0,0,1
"2011","E00008001","E00008001","Total",116,108,57,51,0,1,0,1,7,7,0,0,0,0
"2011","E00008005","E00008005","Total",105,101,49,52,0,1,1,0,3,3,0,0,0,0
"2011","E00008007","E00008007","Total",113,93,32,61,1,6,5,1,13,13,0,0,0,0
"2011","E00008008","E00008008","Total",145,131,52,79,0,5,1,4,8,7,1,0,0,1
"2011","E00008009","E00008009","Total",109,97,31,66,1,2,2,0,9,8,0,0,1,0
"2011","E00008013","E00008013","Total",123,112,57,55,2,2,1,1,6,5,0,1,0,1
"2011","E00008014","E00008014","Total",128,107,43,64,0,4,1,3,15,15,0,0,0,2
"2011","E00007994","E00007994","Total",131,71,33,38,1,47,4,43,12,9,0,1,2,0
"2011","E00007995","E00007995","Total",166,141,49,92,2,10,0,10,13,11,0,2,0,0
"2011","E00007996","E00007996","Total",131,67,25,42,0,40,1,39,24,20,0,1,3,0
"2011","E00007999","E00007999","Total",141,121,62,59,2,4,0,4,10,9,0,1,0,4
"2011","E00008004","E00008004","Total",138,125,51,74,0,6,4,2,7,7,0,0,0,0
"2011","E00007976","E00007976","Total",120,62,28,34,0,43,2,41,15,12,0,1,2,0
"2011","E00007993","E00007993","Total",144,133,55,78,0,2,1,1,7,4,0,1,2,2
"2011","E00007997","E00007997","Total",122,53,34,19,0,56,56,0,11,11,0,0,0,2
"2011","E00007998","E00007998","Total",113,69,29,40,0,41,9,32,3,2,0,1,0,0
"2011","E00008002","E00008002","Total",128,74,28,46,1,40,2,38,12,10,0,2,0,1
"2011","E00008010","E00008010","Total",114,48,15,33,0,60,60,0,6,6,0,0,0,0
"2011","E00008083","E00008083","Total",123,55,14,41,0,61,55,6,6,5,0,1,0,1
"2011","E00008084","E00008084","Total",115,60,19,41,0,44,39,5,11,10,0,1,0,0
"2011","E00008086","E00008086","Total",128,62,22,40,0,43,39,4,20,17,1,2,0,3
"2011","E00008089","E00008089","Total",139,64,23,41,1,67,59,8,5,4,0,1,0,2
"2011","E00008072","E00008072","Total",140,38,9,29,2,77,71,6,22,19,0,2,1,1
"2011","E00008085","E00008085","Total",124,54,13,41,9,32,30,2,28,26,0,2,0,1
"2011","E00008088","E00008088","Total",112,95,39,56,0,11,9,2,5,5,0,0,0,1
"2011","E00008090","E00008090","Total",116,28,9,19,1,79,79,0,7,6,0,1,0,1
"2011","E00008091","E00008091","Total",119,60,21,39,1,54,52,2,4,4,0,0,0,0
"2011","E00008068","E00008068","Total",128,56,19,37,1,64,60,4,6,5,0,1,0,1
"2011","E00008069","E00008069","Total",233,110,9,101,10,37,6,31,72,71,0,1,0,4
"2011","E00008096","E00008096","Total",153,64,23,41,1,75,66,9,12,10,0,1,1,1
"2011","E00008100","E00008100","Total",150,63,21,42,6,67,67,0,12,11,0,1,0,2
"2011","E00008093","E00008093","Total",113,85,41,44,0,23,3,20,5,5,0,0,0,0
"2011","E00008094","E00008094","Total",121,53,17,36,1,60,58,2,4,4,0,0,0,3
"2011","E00008095","E00008095","Total",134,61,22,39,1,63,6,57,7,7,0,0,0,2
"2011","E00008097","E00008097","Total",125,55,22,33,1,60,56,4,7,7,0,0,0,2
"2011","E00008099","E00008099","Total",138,88,41,47,0,44,10,34,3,3,0,0,0,3
"2011","E00008064","E00008064","Total",117,51,24,27,0,61,60,1,4,4,0,0,0,1
"2011","E00008071","E00008071","Total",117,48,18,30,0,64,62,2,4,4,0,0,0,1
"2011","E00008074","E00008074","Total",135,56,15,41,0,72,68,4,7,7,0,0,0,0
"2011","E00008078","E00008078","Total",109,37,6,31,0,63,59,4,8,7,0,1,0,1
"2011","E00008082","E00008082","Total",109,47,16,31,1,54,53,1,6,5,0,1,0,1
"2011","E00007978","E00007978","Total",99,85,38,47,0,4,3,1,10,8,0,2,0,0
"2011","E00007979","E00007979","Total",131,76,33,43,0,32,6,26,22,20,0,1,1,1
"2011","E00007981","E00007981","Total",127,98,32,66,0,11,4,7,17,17,0,0,0,1
"2011","E00007982","E00007982","Total",111,90,48,42,0,18,15,3,2,2,0,0,0,1
"2011","E00007984","E00007984","Total",100,81,37,44,0,1,0,1,12,12,0,0,0,6
"2011","E00008003","E00008003","Total",115,72,32,40,0,35,3,32,8,7,0,1,0,0
"2011","E00008006","E00008006","Total",114,63,25,38,0,41,11,30,9,7,0,2,0,1
"2011","E00008011","E00008011","Total",127,60,28,32,0,56,2,54,10,8,0,0,2,1
"2011","E00008012","E00008012","Total",135,120,50,70,1,4,4,0,8,7,0,1,0,2
"2011","E00008015","E00008015","Total",113,96,37,59,0,10,4,6,6,6,0,0,0,1
"2011","E00007980","E00007980","Total",114,108,52,56,0,6,5,1,0,0,0,0,0,0
"2011","E00007983","E00007983","Total",131,127,66,61,0,0,0,0,3,2,0,1,0,1
"2011","E00007986","E00007986","Total",112,99,50,49,0,6,4,2,6,6,0,0,0,1
"2011","E00007989","E00007989","Total",121,58,32,26,0,56,22,34,7,6,0,1,0,0
"2011","E00007991","E00007991","Total",114,64,30,34,0,20,20,0,28,28,0,0,0,2
"2011","E00007974","E00007974","Total",131,21,2,19,0,86,86,0,20,20,0,0,0,4
"2011","E00007985","E00007985","Total",123,118,62,56,0,3,2,1,2,2,0,0,0,0
"2011","E00007987","E00007987","Total",114,102,47,55,0,4,4,0,6,5,0,1,0,2
"2011","E00007988","E00007988","Total",119,28,16,12,0,75,73,2,14,14,0,0,0,2
"2011","E00007990","E00007990","Total",134,77,52,25,0,22,18,4,15,14,0,1,0,20
"2011","E00007992","E00007992","Total",117,73,38,35,0,9,4,5,32,30,0,1,1,3
"2011","E00008021","E00008021","Total",165,116,52,64,0,3,3,0,45,41,1,3,0,1
"2011","E00008024","E00008024","Total",115,94,60,34,0,1,1,0,19,18,0,1,0,1
"2011","E00008033","E00008033","Total",118,69,27,42,0,29,25,4,17,16,0,1,0,3
"2011","E00008036","E00008036","Total",121,64,27,37,0,38,34,4,18,16,0,2,0,1
"2011","E00008051","E00008051","Total",132,71,36,35,0,33,29,4,25,21,0,4,0,3
"2011","E00008057","E00008057","Total",124,29,11,18,0,81,81,0,14,13,1,0,0,0
"2011","E00008050","E00008050","Total",93,78,40,38,0,7,4,3,6,6,0,0,0,2
"2011","E00008052","E00008052","Total",120,114,62,52,0,3,2,1,3,2,0,1,0,0
"2011","E00008053","E00008053","Total",108,95,62,33,0,5,5,0,7,7,0,0,0,1
"2011","E00008054","E00008054","Total",98,94,47,47,0,1,1,0,3,3,0,0,0,0
"2011","E00008055","E00008055","Total",111,103,60,43,0,0,0,0,7,7,0,0,0,1
"2011","E00008019","E00008019","Total",138,56,31,25,2,38,3,35,39,38,0,0,1,3
"2011","E00008020","E00008020","Total",132,101,49,52,2,13,12,1,14,11,2,1,0,2
"2011","E00008025","E00008025","Total",95,66,31,35,1,1,1,0,25,24,0,1,0,2
"2011","E00008027","E00008027","Total",128,36,22,14,0,79,76,3,12,10,0,2,0,1
"2011","E00008042","E00008042","Total",128,73,29,44,1,20,17,3,31,25,0,6,0,3
"2011","E00008058","E00008058","Total",135,47,30,17,0,16,2,14,64,59,1,3,1,8
"2011","E00008030","E00008030","Total",135,114,78,36,8,6,5,1,6,6,0,0,0,1
"2011","E00008035","E00008035","Total",121,85,55,30,0,11,11,0,24,20,0,4,0,1
"2011","E00008043","E00008043","Total",129,119,52,67,0,3,3,0,6,5,0,1,0,1
"2011","E00008045","E00008045","Total",116,96,43,53,2,9,4,5,9,9,0,0,0,0
"2011","E00008046","E00008046","Total",111,89,40,49,0,2,1,1,18,18,0,0,0,2
"2011","E00008048","E00008048","Total",126,70,31,39,2,13,13,0,38,37,0,0,1,3
"2011","E00008245","E00008245","Total",122,23,4,19,0,89,88,1,10,8,0,2,0,0
"2011","E00008247","E00008247","Total",118,38,7,31,0,71,69,2,9,8,0,0,1,0
"2011","E00008250","E00008250","Total",111,44,11,33,0,59,59,0,6,6,0,0,0,2
"2011","E00008252","E00008252","Total",124,53,12,41,0,66,63,3,5,4,0,1,0,0
"2011","E00008255","E00008255","Total",135,41,3,38,0,84,82,2,10,7,1,2,0,0
"2011","E00008235","E00008235","Total",133,87,45,42,0,35,32,3,8,6,0,2,0,3
"2011","E00008238","E00008238","Total",124,39,16,23,0,77,73,4,7,6,0,1,0,1
"2011","E00008251","E00008251","Total",116,48,15,33,1,60,54,6,6,5,0,1,0,1
"2011","E00008253","E00008253","Total",120,42,12,30,1,65,63,2,10,9,0,0,1,2
"2011","E00008256","E00008256","Total",110,28,14,14,4,65,57,8,13,11,0,2,0,0
"2011","E00008236","E00008236","Total",170,15,3,12,0,141,115,26,13,10,1,1,1,1
"2011","E00008244","E00008244","Total",137,47,12,35,0,80,79,1,9,8,0,1,0,1
"2011","E00008254","E00008254","Total",115,33,12,21,0,63,63,0,18,17,1,0,0,1
"2011","E00008257","E00008257","Total",102,41,18,23,0,51,51,0,10,9,0,1,0,0
"2011","E00008258","E00008258","Total",113,43,13,30,1,59,54,5,9,7,0,1,1,1
"2011","E00008239","E00008239","Total",118,99,59,40,0,5,5,0,10,8,0,1,1,4
"2011","E00008242","E00008242","Total",136,59,21,38,1,65,61,4,10,9,0,1,0,1
"2011","E00008246","E00008246","Total",101,14,4,10,0,80,27,53,5,5,0,0,0,2
"2011","E00008248","E00008248","Total",105,41,16,25,0,54,51,3,10,9,0,1,0,0
"2011","E00008249","E00008249","Total",126,50,15,35,1,58,55,3,15,12,1,1,1,2
"2011","E00008234","E00008234","Total",117,81,34,47,0,25,20,5,9,8,0,1,0,2
"2011","E00008240","E00008240","Total",100,80,41,39,0,10,10,0,9,9,0,0,0,1
"2011","E00008241","E00008241","Total",121,57,25,32,0,58,54,4,5,4,0,1,0,1
"2011","E00008243","E00008243","Total",130,58,14,44,0,65,63,2,5,5,0,0,0,2
"2011","E00008276","E00008276","Total",120,48,11,37,0,61,60,1,11,10,0,1,0,0
"2011","E00008028","E00008028","Total",112,48,19,29,0,50,46,4,14,12,0,2,0,0
"2011","E00008037","E00008037","Total",131,88,40,48,1,30,29,1,11,11,0,0,0,1
"2011","E00008038","E00008038","Total",147,133,51,82,0,5,4,1,9,9,0,0,0,0
"2011","E00008039","E00008039","Total",126,91,47,44,0,23,8,15,11,11,0,0,0,1
"2011","E00008044","E00008044","Total",132,42,20,22,0,83,11,72,5,5,0,0,0,2
"2011","E00008016","E00008016","Total",167,110,34,76,2,17,3,14,37,34,0,3,0,1
"2011","E00008040","E00008040","Total",179,131,54,77,0,9,2,7,36,34,0,2,0,3
"2011","E00008041","E00008041","Total",136,109,46,63,0,6,3,3,20,20,0,0,0,1
"2011","E00008047","E00008047","Total",133,57,25,32,0,37,10,27,37,37,0,0,0,2
"2011","E00008049","E00008049","Total",203,89,33,56,46,21,5,16,43,39,0,3,1,4
"2011","E00008017","E00008017","Total",128,40,21,19,5,65,61,4,16,15,0,0,1,2
"2011","E00008018","E00008018","Total",130,60,24,36,1,58,53,5,11,10,0,1,0,0
"2011","E00008022","E00008022","Total",136,32,16,16,1,96,93,3,7,6,0,0,1,0
"2011","E00008023","E00008023","Total",145,25,6,19,0,100,96,4,17,16,0,1,0,3
"2011","E00008026","E00008026","Total",126,35,10,25,1,83,82,1,6,6,0,0,0,1
"2011","E00008056","E00008056","Total",96,59,36,23,1,28,27,1,8,8,0,0,0,0
"2011","E00176492","E00176492","Total",41,5,3,2,0,12,5,7,24,3,0,0,21,0
"2011","E00007934","E00007934","Total",97,55,24,31,2,31,10,21,8,8,0,0,0,1
"2011","E00007935","E00007935","Total",118,101,46,55,0,6,2,4,10,8,1,1,0,1
"2011","E00007938","E00007938","Total",113,61,30,31,0,21,2,19,29,29,0,0,0,2
"2011","E00007939","E00007939","Total",149,86,39,47,0,22,3,19,39,35,1,1,2,2
"2011","E00007946","E00007946","Total",130,117,63,54,0,4,3,1,9,7,0,1,1,0
"2011","E00007936","E00007936","Total",119,86,38,48,0,14,14,0,18,17,0,1,0,1
"2011","E00007937","E00007937","Total",118,97,45,52,1,10,10,0,10,10,0,0,0,0
"2011","E00007942","E00007942","Total",139,123,61,62,0,3,2,1,11,11,0,0,0,2
"2011","E00007943","E00007943","Total",112,68,35,33,1,36,34,2,7,6,0,1,0,0
"2011","E00007948","E00007948","Total",118,108,51,57,0,2,1,1,7,6,0,1,0,1
"2011","E00007933","E00007933","Total",139,54,23,31,0,80,55,25,5,5,0,0,0,0
"2011","E00007952","E00007952","Total",109,63,27,36,0,37,33,4,5,5,0,0,0,4
"2011","E00007953","E00007953","Total",113,43,11,32,0,59,56,3,11,10,0,1,0,0
"2011","E00007956","E00007956","Total",115,60,25,35,0,50,49,1,5,5,0,0,0,0
"2011","E00007958","E00007958","Total",120,51,18,33,1,61,58,3,6,6,0,0,0,1
"2011","E00007969","E00007969","Total",122,76,33,43,0,34,32,2,11,11,0,0,0,1
"2011","E00007932","E00007932","Total",126,48,10,38,0,68,61,7,8,8,0,0,0,2
"2011","E00007965","E00007965","Total",153,13,4,9,1,129,122,7,7,7,0,0,0,3
"2011","E00007968","E00007968","Total",128,40,14,26,1,81,78,3,6,6,0,0,0,0
"2011","E00007970","E00007970","Total",120,56,28,28,0,58,56,2,4,2,0,2,0,2
"2011","E00007971","E00007971","Total",115,52,19,33,0,57,57,0,4,3,0,1,0,2
"2011","E00007972","E00007972","Total",126,43,14,29,0,72,70,2,8,7,0,1,0,3
"2011","E00007963","E00007963","Total",130,118,57,61,0,2,2,0,10,10,0,0,0,0
"2011","E00007964","E00007964","Total",106,90,29,61,0,1,1,0,15,15,0,0,0,0
"2011","E00007966","E00007966","Total",113,103,53,50,0,5,4,1,4,3,0,1,0,1
"2011","E00007967","E00007967","Total",118,115,62,53,0,1,1,0,1,1,0,0,0,1
"2011","E00007973","E00007973","Total",130,103,58,45,1,5,5,0,19,18,0,1,0,2
"2011","E00007941","E00007941","Total",122,103,51,52,0,5,5,0,13,11,0,2,0,1
"2011","E00007954","E00007954","Total",136,88,35,53,1,33,31,2,12,12,0,0,0,2
"2011","E00007955","E00007955","Total",114,75,33,42,1,27,23,4,11,10,0,1,0,0
"2011","E00007960","E00007960","Total",118,61,25,36,0,49,49,0,7,7,0,0,0,1
"2011","E00007961","E00007961","Total",125,115,52,63,1,4,4,0,5,5,0,0,0,0
"2011","E00007940","E00007940","Total",121,76,23,53,0,11,6,5,34,32,0,2,0,0
"2011","E00007944","E00007944","Total",142,90,40,50,0,12,7,5,38,37,0,0,1,2
"2011","E00007947","E00007947","Total",132,116,42,74,2,3,3,0,10,9,0,1,0,1
"2011","E00007949","E00007949","Total",131,81,30,51,1,31,24,7,18,17,0,1,0,0
"2011","E00007950","E00007950","Total",137,80,33,47,1,27,10,17,29,29,0,0,0,0
"2011","E00007945","E00007945","Total",125,71,24,47,1,43,2,41,7,7,0,0,0,3
"2011","E00007951","E00007951","Total",121,76,26,50,1,9,0,9,35,25,0,10,0,0
"2011","E00007957","E00007957","Total",119,107,53,54,1,6,6,0,3,3,0,0,0,2
"2011","E00007959","E00007959","Total",124,111,49,62,0,5,5,0,7,7,0,0,0,1
"2011","E00007962","E00007962","Total",112,106,51,55,0,4,3,1,2,0,0,2,0,0
"2011","E00008319","E00008319","Total",123,96,36,60,1,13,11,2,12,11,0,1,0,1
"2011","E00008322","E00008322","Total",114,15,4,11,0,85,78,7,10,9,1,0,0,4
"2011","E00008356","E00008356","Total",177,70,35,35,6,85,27,58,14,13,0,1,0,2
"2011","E00008357","E00008357","Total",151,105,39,66,3,18,11,7,22,20,0,1,1,3
"2011","E00008358","E00008358","Total",124,48,19,29,1,45,13,32,29,27,0,0,2,1
"2011","E00008316","E00008316","Total",163,126,53,73,0,9,6,3,28,22,0,6,0,0
"2011","E00008320","E00008320","Total",106,57,17,40,0,27,19,8,22,21,0,1,0,0
"2011","E00008321","E00008321","Total",97,68,26,42,0,11,6,5,18,18,0,0,0,0
"2011","E00008324","E00008324","Total",96,21,6,15,0,67,64,3,8,7,0,0,1,0
"2011","E00008325","E00008325","Total",117,90,28,62,1,4,3,1,22,21,0,0,1,0
"2011","E00008359","E00008359","Total",96,40,14,26,0,30,23,7,25,24,0,1,0,1
"2011","E00008338","E00008338","Total",123,86,36,50,0,11,8,3,24,24,0,0,0,2
"2011","E00008348","E00008348","Total",178,38,7,31,12,67,33,34,60,58,0,1,1,1
"2011","E00008350","E00008350","Total",89,10,5,5,0,69,62,7,9,9,0,0,0,1
"2011","E00008353","E00008353","Total",129,50,12,38,1,23,8,15,51,51,0,0,0,4
"2011","E00008355","E00008355","Total",127,1,0,1,1,111,109,2,11,8,0,2,1,3
"2011","E00008323","E00008323","Total",128,52,27,25,1,61,4,57,12,9,0,3,0,2
"2011","E00008326","E00008326","Total",133,107,38,69,0,5,2,3,21,17,1,3,0,0
"2011","E00008327","E00008327","Total",111,94,38,56,1,11,7,4,4,3,0,0,1,1
"2011","E00008360","E00008360","Total",100,82,34,48,0,7,2,5,9,9,0,0,0,2
"2011","E00165792","E00165792","Total",117,103,58,45,0,5,4,1,8,8,0,0,0,1
"2011","E00008259","E00008259","Total",82,68,38,30,0,4,4,0,10,10,0,0,0,0
"2011","E00008260","E00008260","Total",132,122,81,41,0,2,1,1,5,5,0,0,0,3
"2011","E00008261","E00008261","Total",131,65,30,35,0,52,45,7,13,9,0,4,0,1
"2011","E00008263","E00008263","Total",134,24,3,21,0,90,87,3,19,19,0,0,0,1
"2011","E00008265","E00008265","Total",103,52,19,33,0,32,32,0,19,18,0,1,0,0
"2011","E00008262","E00008262","Total",108,99,55,44,0,0,0,0,7,6,0,1,0,2
"2011","E00008264","E00008264","Total",134,121,82,39,0,4,3,1,8,7,1,0,0,1
"2011","E00008267","E00008267","Total",168,134,61,73,0,1,1,0,29,28,0,1,0,4
"2011","E00008269","E00008269","Total",119,64,21,43,7,1,0,1,46,46,0,0,0,1
"2011","E00008270","E00008270","Total",157,22,6,16,0,107,98,9,24,24,0,0,0,4
"2011","E00008233","E00008233","Total",92,9,5,4,0,67,48,19,14,14,0,0,0,2
"2011","E00008266","E00008266","Total",136,95,43,52,0,17,1,16,23,19,1,3,0,1
"2011","E00008268","E00008268","Total",128,102,54,48,1,1,1,0,24,23,0,1,0,0
"2011","E00008271","E00008271","Total",102,71,41,30,0,1,1,0,28,26,0,2,0,2
"2011","E00008273","E00008273","Total",142,91,36,55,8,17,14,3,26,26,0,0,0,0
"2011","E00008277","E00008277","Total",123,70,33,37,0,36,36,0,16,16,0,0,0,1
"2011","E00008237","E00008237","Total",160,69,39,30,0,68,66,2,23,23,0,0,0,0
"2011","E00008272","E00008272","Total",113,97,46,51,0,8,8,0,8,8,0,0,0,0
"2011","E00008274","E00008274","Total",129,97,52,45,0,11,10,1,19,19,0,0,0,2
"2011","E00008275","E00008275","Total",127,114,50,64,0,3,3,0,10,9,0,1,0,0
"2011","E00008059","E00008059","Total",129,68,22,46,1,49,45,4,10,8,0,2,0,1
"2011","E00008063","E00008063","Total",47,9,6,3,0,35,34,1,3,3,0,0,0,0
"2011","E00008079","E00008079","Total",123,49,11,38,0,63,52,11,10,6,0,2,2,1
"2011","E00008080","E00008080","Total",115,70,20,50,1,39,38,1,3,3,0,0,0,2
"2011","E00008087","E00008087","Total",178,64,27,37,1,103,34,69,6,5,0,0,1,4
"2011","E00008092","E00008092","Total",97,58,30,28,8,14,13,1,15,14,1,0,0,2
"2011","E00176484","E00176484","Total",129,20,7,13,0,105,92,13,4,4,0,0,0,0
"2011","E00008154","E00008154","Total",189,38,10,28,5,90,86,4,54,51,0,1,2,2
"2011","E00008156","E00008156","Total",105,8,2,6,1,72,62,10,22,21,0,1,0,2
"2011","E00008188","E00008188","Total",125,16,3,13,0,76,73,3,32,30,0,2,0,1
"2011","E00176498","E00176498","Total",159,11,3,8,0,130,84,46,16,16,0,0,0,2
"2011","E00176535","E00176535","Total",85,12,2,10,0,30,26,4,41,41,0,0,0,2
"2011","E00176540","E00176540","Total",105,12,4,8,14,59,50,9,17,16,0,1,0,3
"2011","E00176551","E00176551","Total",113,11,3,8,2,80,78,2,16,15,0,1,0,4
"2011","E00008155","E00008155","Total",131,25,4,21,2,89,86,3,14,14,0,0,0,1
"2011","E00008158","E00008158","Total",133,14,5,9,0,104,64,40,11,10,0,1,0,4
"2011","E00008189","E00008189","Total",122,30,3,27,0,72,70,2,15,14,0,1,0,5
"2011","E00176488","E00176488","Total",94,24,4,20,10,12,3,9,48,45,0,3,0,0
"2011","E00176490","E00176490","Total",108,22,8,14,0,25,2,23,58,56,0,2,0,3
"2011","E00176491","E00176491","Total",103,15,5,10,6,69,1,68,11,10,0,1,0,2
"2011","E00176497","E00176497","Total",111,33,5,28,5,36,4,32,36,36,0,0,0,1
"2011","E00176489","E00176489","Total",129,29,4,25,15,51,3,48,34,32,0,1,1,0
"2011","E00176500","E00176500","Total",92,44,11,33,2,3,2,1,42,42,0,0,0,1
"2011","E00176547","E00176547","Total",92,29,3,26,1,3,2,1,58,58,0,0,0,1
"2011","E00176560","E00176560","Total",181,85,23,62,0,4,0,4,91,86,0,5,0,1
"2011","E00176579","E00176579","Total",85,31,6,25,0,1,1,0,52,50,0,2,0,1
"2011","E00176590","E00176590","Total",62,40,13,27,0,2,1,1,20,18,0,2,0,0
"2011","E00176493","E00176493","Total",137,17,5,12,3,57,3,54,60,59,0,0,1,0
"2011","E00176494","E00176494","Total",70,15,4,11,0,46,20,26,8,7,0,1,0,1
"2011","E00176495","E00176495","Total",125,24,3,21,0,55,7,48,45,42,0,3,0,1
"2011","E00176499","E00176499","Total",129,15,3,12,49,25,2,23,38,36,0,2,0,2
"2011","E00176515","E00176515","Total",81,23,2,21,1,24,10,14,32,32,0,0,0,1
"2011","E00176522","E00176522","Total",111,9,0,9,0,32,1,31,70,69,0,0,1,0
"2011","E00008285","E00008285","Total",113,49,14,35,0,15,7,8,49,46,0,3,0,0
"2011","E00008293","E00008293","Total",98,37,8,29,0,31,26,5,28,27,0,1,0,2
"2011","E00008307","E00008307","Total",108,45,16,29,0,35,19,16,25,23,0,2,0,3
"2011","E00008310","E00008310","Total",118,30,9,21,0,78,75,3,10,10,0,0,0,0
"2011","E00008313","E00008313","Total",120,70,26,44,0,15,1,14,35,33,0,1,1,0
"2011","E00008288","E00008288","Total",124,14,5,9,1,101,98,3,7,7,0,0,0,1
"2011","E00008291","E00008291","Total",132,12,4,8,0,104,101,3,12,12,0,0,0,4
"2011","E00008308","E00008308","Total",163,68,30,38,0,42,35,7,47,43,1,3,0,6
"2011","E00008311","E00008311","Total",143,23,7,16,1,102,98,4,15,14,0,1,0,2
"2011","E00008312","E00008312","Total",145,27,5,22,0,99,90,9,18,18,0,0,0,1
"2011","E00008282","E00008282","Total",114,47,16,31,0,52,2,50,14,13,0,1,0,1
"2011","E00008284","E00008284","Total",129,34,16,18,0,74,2,72,21,18,0,1,2,0
"2011","E00008287","E00008287","Total",118,49,17,32,0,41,2,39,28,27,0,1,0,0
"2011","E00008296","E00008296","Total",136,56,12,44,1,47,4,43,32,32,0,0,0,0
"2011","E00008302","E00008302","Total",126,23,7,16,0,75,49,26,28,25,1,0,2,0
"2011","E00176505","E00176505","Total",130,13,4,9,9,88,54,34,19,19,0,0,0,1
"2011","E00176506","E00176506","Total",159,6,2,4,2,133,7,126,18,14,0,2,2,0
"2011","E00176554","E00176554","Total",137,46,18,28,1,39,5,34,48,43,1,0,4,3
"2011","E00176503","E00176503","Total",120,49,6,43,2,1,0,1,67,66,0,1,0,1
"2011","E00176519","E00176519","Total",112,40,12,28,8,26,2,24,36,33,0,3,0,2
"2011","E00176553","E00176553","Total",124,25,3,22,16,47,4,43,34,31,0,2,1,2
"2011","E00176595","E00176595","Total",116,20,4,16,13,40,3,37,43,42,0,1,0,0
"2011","E00176504","E00176504","Total",115,51,8,43,0,4,2,2,58,56,0,1,1,2
"2011","E00176516","E00176516","Total",179,66,16,50,4,5,4,1,101,99,0,2,0,3
"2011","E00176518","E00176518","Total",127,46,9,37,2,6,0,6,72,71,0,1,0,1
"2011","E00176524","E00176524","Total",127,53,15,38,0,9,1,8,65,61,0,4,0,0
"2011","E00008280","E00008280","Total",142,76,19,57,0,26,23,3,38,37,0,1,0,2
"2011","E00008290","E00008290","Total",132,64,19,45,2,17,2,15,47,45,0,1,1,2
"2011","E00008295","E00008295","Total",120,65,19,46,1,3,0,3,49,49,0,0,0,2
"2011","E00008297","E00008297","Total",110,41,16,25,0,28,3,25,39,37,1,0,1,2
"2011","E00008303","E00008303","Total",91,56,23,33,0,15,8,7,18,18,0,0,0,2
"2011","E00008309","E00008309","Total",120,48,20,28,0,45,32,13,26,25,0,1,0,1
"2011","E00008279","E00008279","Total",172,60,21,39,0,39,20,19,71,68,0,3,0,2
"2011","E00008299","E00008299","Total",171,88,46,42,0,11,7,4,69,69,0,0,0,3
"2011","E00008300","E00008300","Total",129,17,7,10,0,74,36,38,37,36,0,1,0,1
"2011","E00008301","E00008301","Total",113,7,4,3,0,83,61,22,21,21,0,0,0,2
"2011","E00008304","E00008304","Total",126,63,22,41,1,35,32,3,27,26,0,1,0,0
"2011","E00008305","E00008305","Total",143,70,26,44,0,24,22,2,48,45,0,0,3,1
"2011","E00008283","E00008283","Total",135,44,13,31,0,33,30,3,56,56,0,0,0,2
"2011","E00008294","E00008294","Total",139,57,22,35,3,34,24,10,45,41,0,4,0,0
"2011","E00008298","E00008298","Total",123,80,28,52,0,18,12,6,24,23,0,1,0,1
"2011","E00176523","E00176523","Total",118,40,11,29,0,16,2,14,61,57,0,1,3,1
"2011","E00176566","E00176566","Total",134,82,34,48,3,18,2,16,31,30,0,1,0,0
"2011","E00176591","E00176591","Total",139,75,15,60,15,8,3,5,38,36,1,1,0,3
"2011","E00008278","E00008278","Total",131,68,22,46,1,26,2,24,35,31,0,3,1,1
"2011","E00008286","E00008286","Total",89,43,18,25,0,15,11,4,29,28,0,1,0,2
"2011","E00008306","E00008306","Total",90,56,15,41,0,7,4,3,25,23,0,1,1,2
"2011","E00008314","E00008314","Total",106,45,27,18,1,7,1,6,52,49,1,1,1,1
"2011","E00176517","E00176517","Total",103,41,12,29,1,10,2,8,49,47,0,1,1,2
"2011","E00008147","E00008147","Total",239,57,12,45,21,68,60,8,88,84,0,4,0,5
"2011","E00008148","E00008148","Total",154,22,6,16,0,122,118,4,7,6,0,0,1,3
"2011","E00008153","E00008153","Total",146,33,6,27,0,69,11,58,43,29,13,0,1,1
"2011","E00008186","E00008186","Total",107,8,2,6,0,85,81,4,13,12,0,1,0,1
"2011","E00008187","E00008187","Total",160,12,4,8,1,129,83,46,15,12,2,1,0,3
"2011","E00008149","E00008149","Total",134,34,6,28,0,24,2,22,72,67,2,1,2,4
"2011","E00008161","E00008161","Total",130,50,22,28,1,47,42,5,31,29,0,2,0,1
"2011","E00008164","E00008164","Total",152,57,26,31,0,55,2,53,39,38,0,1,0,1
"2011","E00008165","E00008165","Total",135,43,10,33,0,65,45,20,24,23,1,0,0,3
"2011","E00008166","E00008166","Total",107,38,21,17,1,54,38,16,14,13,1,0,0,0
"2011","E00008167","E00008167","Total",121,86,35,51,1,5,3,2,27,26,0,0,1,2
"2011","E00008159","E00008159","Total",109,53,25,28,1,22,1,21,29,29,0,0,0,4
"2011","E00008170","E00008170","Total",116,90,49,41,0,12,1,11,13,13,0,0,0,1
"2011","E00008173","E00008173","Total",109,81,46,35,0,11,11,0,17,15,0,2,0,0
"2011","E00008175","E00008175","Total",107,57,20,37,0,32,27,5,18,16,0,2,0,0
"2011","E00008176","E00008176","Total",134,66,34,32,0,30,3,27,36,32,0,3,1,2
"2011","E00008179","E00008179","Total",105,76,42,34,0,6,3,3,21,21,0,0,0,2
"2011","E00008181","E00008181","Total",111,54,16,38,0,11,2,9,45,44,0,1,0,1
"2011","E00008172","E00008172","Total",143,65,21,44,0,13,5,8,65,64,0,1,0,0
"2011","E00008177","E00008177","Total",132,58,20,38,0,41,17,24,30,30,0,0,0,3
"2011","E00008182","E00008182","Total",113,73,17,56,0,10,6,4,30,30,0,0,0,0
"2011","E00008183","E00008183","Total",115,19,5,14,0,63,56,7,33,32,0,0,1,0
"2011","E00008184","E00008184","Total",117,45,14,31,0,20,5,15,52,52,0,0,0,0
"2011","E00008185","E00008185","Total",137,53,14,39,0,31,26,5,52,51,0,1,0,1
"2011","E00176525","E00176525","Total",131,48,12,36,15,19,5,14,47,46,0,1,0,2
"2011","E00176556","E00176556","Total",134,48,12,36,0,14,11,3,72,67,0,5,0,0
"2011","E00008168","E00008168","Total",111,7,3,4,0,91,28,63,12,10,0,2,0,1
"2011","E00008169","E00008169","Total",128,75,26,49,0,23,19,4,30,29,0,1,0,0
"2011","E00008171","E00008171","Total",122,60,17,43,2,0,0,0,58,57,1,0,0,2
"2011","E00008174","E00008174","Total",126,81,27,54,0,22,8,14,22,20,0,2,0,1
"2011","E00008178","E00008178","Total",115,28,17,11,0,68,61,7,16,16,0,0,0,3
"2011","E00008180","E00008180","Total",113,57,19,38,0,24,20,4,32,30,0,2,0,0
"2011","E00010623","E00010623","Total",136,90,73,17,0,0,0,0,43,41,1,1,0,3
"2011","E00010624","E00010624","Total",110,78,52,26,0,2,0,2,26,25,0,1,0,4
"2011","E00010625","E00010625","Total",107,99,52,47,0,0,0,0,8,8,0,0,0,0
"2011","E00010629","E00010629","Total",127,89,46,43,0,27,26,1,8,8,0,0,0,3
"2011","E00171094","E00171094","Total",105,90,27,63,0,0,0,0,10,10,0,0,0,5
"2011","E00171096","E00171096","Total",112,97,55,42,0,3,0,3,10,10,0,0,0,2
"2011","E00010598","E00010598","Total",117,21,11,10,0,79,5,74,15,13,0,1,1,2
"2011","E00010600","E00010600","Total",134,81,54,27,2,9,8,1,41,40,0,1,0,1
"2011","E00010603","E00010603","Total",129,91,73,18,1,3,1,2,31,31,0,0,0,3
"2011","E00010611","E00010611","Total",140,95,68,27,2,10,8,2,29,27,0,1,1,4
"2011","E00010626","E00010626","Total",124,75,52,23,1,10,1,9,33,33,0,0,0,5
"2011","E00171093","E00171093","Total",121,77,38,39,2,25,1,24,12,11,1,0,0,5
"2011","E00171111","E00171111","Total",120,56,17,39,37,4,2,2,23,23,0,0,0,0
"2011","E00171116","E00171116","Total",101,25,24,1,0,68,2,66,8,4,1,0,3,0
"2011","E00011116","E00011116","Total",132,121,78,43,0,0,0,0,11,11,0,0,0,0
"2011","E00011126","E00011126","Total",105,86,52,34,1,2,1,1,13,11,1,1,0,3
"2011","E00011128","E00011128","Total",126,91,54,37,0,11,11,0,20,20,0,0,0,4
"2011","E00011129","E00011129","Total",139,117,79,38,1,1,0,1,18,18,0,0,0,2
"2011","E00011132","E00011132","Total",121,113,76,37,2,1,0,1,5,5,0,0,0,0
"2011","E00011127","E00011127","Total",134,83,44,39,1,26,26,0,23,20,1,2,0,1
"2011","E00011130","E00011130","Total",134,113,65,48,0,0,0,0,20,20,0,0,0,1
"2011","E00011131","E00011131","Total",149,105,69,36,1,8,0,8,34,29,0,4,1,1
"2011","E00011133","E00011133","Total",124,59,43,16,2,5,2,3,53,48,2,3,0,5
"2011","E00011136","E00011136","Total",127,82,60,22,0,7,4,3,34,31,0,3,0,4
"2011","E00171097","E00171097","Total",114,79,50,29,0,7,6,1,25,21,0,4,0,3
"2011","E00171099","E00171099","Total",112,49,27,22,0,27,2,25,33,31,1,0,1,3
"2011","E00171127","E00171127","Total",109,61,16,45,0,29,3,26,17,17,0,0,0,2
"2011","E00010601","E00010601","Total",123,117,54,63,0,2,1,1,4,3,1,0,0,0
"2011","E00010602","E00010602","Total",114,31,17,14,0,57,54,3,21,20,1,0,0,5
"2011","E00010609","E00010609","Total",129,103,47,56,0,2,0,2,23,21,1,1,0,1
"2011","E00010627","E00010627","Total",119,98,44,54,0,12,11,1,8,8,0,0,0,1
"2011","E00010628","E00010628","Total",114,42,24,18,1,48,20,28,21,19,0,2,0,2
"2011","E00010597","E00010597","Total",125,81,41,40,0,14,11,3,28,22,0,4,2,2
"2011","E00010599","E00010599","Total",126,83,40,43,0,17,17,0,26,22,0,3,1,0
"2011","E00010606","E00010606","Total",133,122,68,54,0,3,3,0,7,7,0,0,0,1
"2011","E00010607","E00010607","Total",125,106,49,57,0,3,3,0,16,16,0,0,0,0
"2011","E00010596","E00010596","Total",138,88,54,34,4,6,0,6,36,36,0,0,0,4
"2011","E00010604","E00010604","Total",178,83,70,13,0,9,0,9,84,59,14,0,11,2
"2011","E00010605","E00010605","Total",125,117,55,62,0,0,0,0,6,6,0,0,0,2
"2011","E00010608","E00010608","Total",114,105,56,49,0,0,0,0,9,8,1,0,0,0
"2011","E00010610","E00010610","Total",125,105,58,47,1,3,0,3,16,15,0,1,0,0
"2011","E00010612","E00010612","Total",123,111,53,58,0,0,0,0,11,9,0,2,0,1
"2011","E00010616","E00010616","Total",127,119,62,57,0,0,0,0,8,8,0,0,0,0
"2011","E00010617","E00010617","Total",150,133,61,72,0,1,0,1,16,14,0,1,1,0
"2011","E00171089","E00171089","Total",122,72,38,34,0,3,1,2,42,40,0,1,1,5
"2011","E00171110","E00171110","Total",153,49,13,36,0,51,6,45,51,50,1,0,0,2
"2011","E00010613","E00010613","Total",124,85,43,42,1,2,1,1,34,33,0,1,0,2
"2011","E00010614","E00010614","Total",163,45,21,24,1,4,1,3,108,102,1,2,3,5
"2011","E00010615","E00010615","Total",129,77,55,22,0,3,2,1,42,37,0,5,0,7
"2011","E00010618","E00010618","Total",133,78,45,33,0,7,4,3,44,40,0,1,3,4
"2011","E00010619","E00010619","Total",126,92,48,44,0,3,3,0,25,22,2,1,0,6
"2011","E00011113","E00011113","Total",129,38,16,22,0,81,77,4,7,6,0,0,1,3
"2011","E00011134","E00011134","Total",109,58,27,31,1,38,30,8,8,7,0,0,1,4
"2011","E00011135","E00011135","Total",124,67,27,40,0,43,32,11,12,8,0,3,1,2
"2011","E00011137","E00011137","Total",131,40,14,26,2,67,49,18,18,18,0,0,0,4
"2011","E00011142","E00011142","Total",118,44,18,26,0,64,62,2,7,6,1,0,0,3
"2011","E00011114","E00011114","Total",114,103,51,52,0,3,2,1,8,8,0,0,0,0
"2011","E00011117","E00011117","Total",126,100,47,53,0,18,16,2,8,7,0,0,1,0
"2011","E00011138","E00011138","Total",201,110,75,35,15,33,5,28,40,21,14,0,5,3
"2011","E00171114","E00171114","Total",134,31,11,20,0,13,3,10,88,30,39,1,18,2
"2011","E00171119","E00171119","Total",135,73,35,38,0,30,6,24,28,27,0,0,1,4
"2011","E00011118","E00011118","Total",130,45,20,25,0,61,55,6,20,19,1,0,0,4
"2011","E00011122","E00011122","Total",95,78,48,30,0,2,2,0,13,11,1,1,0,2
"2011","E00011124","E00011124","Total",118,104,62,42,0,3,2,1,8,7,0,0,1,3
"2011","E00011139","E00011139","Total",153,97,63,34,0,3,1,2,53,42,4,0,7,0
"2011","E00011140","E00011140","Total",129,55,26,29,0,48,45,3,20,19,0,1,0,6
"2011","E00011141","E00011141","Total",145,107,61,46,0,7,7,0,28,27,0,1,0,3
"2011","E00011115","E00011115","Total",132,117,37,80,1,0,0,0,14,12,0,2,0,0
"2011","E00011119","E00011119","Total",128,99,58,41,0,3,2,1,24,22,0,2,0,2
"2011","E00011121","E00011121","Total",130,120,80,40,0,1,1,0,9,8,0,1,0,0
"2011","E00011123","E00011123","Total",126,113,59,54,0,2,2,0,10,10,0,0,0,1
"2011","E00011125","E00011125","Total",121,107,50,57,0,7,3,4,7,7,0,0,0,0
"2011","E00010730","E00010730","Total",127,121,70,51,0,0,0,0,5,4,0,1,0,1
"2011","E00010743","E00010743","Total",50,41,22,19,0,3,3,0,3,1,2,0,0,3
"2011","E00010744","E00010744","Total",159,112,58,54,1,35,34,1,8,8,0,0,0,3
"2011","E00010748","E00010748","Total",125,90,43,47,2,17,15,2,15,13,0,2,0,1
"2011","E00010751","E00010751","Total",119,98,37,61,0,3,2,1,18,17,0,1,0,0
"2011","E00010776","E00010776","Total",131,126,83,43,0,0,0,0,5,5,0,0,0,0
"2011","E00010778","E00010778","Total",130,122,59,63,0,0,0,0,6,6,0,0,0,2
"2011","E00010780","E00010780","Total",126,118,43,75,0,1,0,1,6,5,0,0,1,1
"2011","E00010784","E00010784","Total",132,109,60,49,0,2,2,0,21,21,0,0,0,0
"2011","E00010761","E00010761","Total",136,97,64,33,0,2,2,0,34,32,0,2,0,3
"2011","E00010777","E00010777","Total",142,131,78,53,0,0,0,0,10,9,0,1,0,1
"2011","E00010779","E00010779","Total",109,99,51,48,0,2,0,2,3,3,0,0,0,5
"2011","E00010781","E00010781","Total",115,105,70,35,0,0,0,0,9,8,0,1,0,1
"2011","E00010764","E00010764","Total",128,121,69,52,0,0,0,0,7,7,0,0,0,0
"2011","E00010786","E00010786","Total",112,108,58,50,0,1,1,0,3,3,0,0,0,0
"2011","E00010789","E00010789","Total",118,107,64,43,0,0,0,0,11,11,0,0,0,0
"2011","E00010790","E00010790","Total",121,116,48,68,0,1,1,0,4,3,0,0,1,0
"2011","E00010732","E00010732","Total",116,100,50,50,0,6,3,3,8,8,0,0,0,2
"2011","E00010739","E00010739","Total",145,84,36,48,1,11,8,3,49,46,0,3,0,0
"2011","E00010753","E00010753","Total",121,73,31,42,3,31,28,3,12,10,0,2,0,2
"2011","E00010758","E00010758","Total",116,65,33,32,0,35,32,3,14,14,0,0,0,2
"2011","E00010759","E00010759","Total",109,84,31,53,1,3,0,3,20,19,0,1,0,1
"2011","E00010727","E00010727","Total",147,111,51,60,5,3,1,2,27,27,0,0,0,1
"2011","E00010729","E00010729","Total",148,74,36,38,0,52,6,46,16,16,0,0,0,6
"2011","E00010733","E00010733","Total",121,103,55,48,1,6,0,6,11,11,0,0,0,0
"2011","E00010738","E00010738","Total",130,113,62,51,0,6,1,5,10,8,0,2,0,1
"2011","E00010755","E00010755","Total",134,126,69,57,0,0,0,0,8,7,0,1,0,0
"2011","E00010728","E00010728","Total",127,80,29,51,0,6,1,5,40,36,0,4,0,1
"2011","E00010736","E00010736","Total",139,127,75,52,0,2,1,1,9,8,0,1,0,1
"2011","E00010746","E00010746","Total",126,115,43,72,1,1,0,1,7,6,0,1,0,2
"2011","E00010749","E00010749","Total",125,112,63,49,0,0,0,0,13,12,0,1,0,0
"2011","E00010756","E00010756","Total",118,78,36,42,0,1,1,0,39,36,0,3,0,0
"2011","E00010734","E00010734","Total",127,83,34,49,2,12,12,0,29,27,0,1,1,1
"2011","E00010740","E00010740","Total",138,99,38,61,1,4,4,0,34,33,1,0,0,0
"2011","E00010741","E00010741","Total",144,104,37,67,0,6,3,3,34,32,0,2,0,0
"2011","E00010742","E00010742","Total",120,56,17,39,1,51,37,14,12,9,0,3,0,0
"2011","E00010731","E00010731","Total",113,92,56,36,0,2,1,1,18,16,0,2,0,1
"2011","E00010745","E00010745","Total",149,106,53,53,3,12,6,6,27,25,1,1,0,1
"2011","E00010747","E00010747","Total",130,88,51,37,0,33,1,32,9,9,0,0,0,0
"2011","E00010750","E00010750","Total",129,118,62,56,1,1,1,0,9,8,0,1,0,0
"2011","E00010752","E00010752","Total",110,44,20,24,13,32,1,31,20,17,0,3,0,1
"2011","E00010735","E00010735","Total",128,31,13,18,0,82,50,32,10,9,0,1,0,5
"2011","E00010737","E00010737","Total",122,28,10,18,0,79,28,51,13,12,0,0,1,2
"2011","E00010754","E00010754","Total",120,54,17,37,1,51,24,27,13,10,0,1,2,1
"2011","E00010757","E00010757","Total",128,36,13,23,1,77,67,10,10,10,0,0,0,4
"2011","E00010763","E00010763","Total",132,117,50,67,0,0,0,0,15,14,0,0,1,0
"2011","E00010768","E00010768","Total",126,84,37,47,1,22,20,2,16,16,0,0,0,3
"2011","E00010782","E00010782","Total",114,94,57,37,1,8,5,3,4,3,1,0,0,7
"2011","E00010783","E00010783","Total",119,108,52,56,1,1,1,0,7,6,0,1,0,2
"2011","E00010762","E00010762","Total",165,125,82,43,2,0,0,0,34,33,0,1,0,4
"2011","E00010765","E00010765","Total",122,77,42,35,1,0,0,0,42,42,0,0,0,2
"2011","E00010766","E00010766","Total",169,38,18,20,4,3,3,0,120,116,2,2,0,4
"2011","E00010770","E00010770","Total",132,101,45,56,0,5,3,2,26,26,0,0,0,0
"2011","E00010785","E00010785","Total",112,62,32,30,2,21,3,18,26,25,0,1,0,1
"2011","E00010788","E00010788","Total",139,114,74,40,1,4,0,4,16,16,0,0,0,4
"2011","E00010772","E00010772","Total",142,80,29,51,1,35,30,5,24,23,0,1,0,2
"2011","E00010773","E00010773","Total",137,18,10,8,0,103,93,10,10,9,0,1,0,6
"2011","E00010775","E00010775","Total",127,47,19,28,1,72,56,16,6,6,0,0,0,1
"2011","E00010787","E00010787","Total",118,57,23,34,0,45,36,9,14,13,0,1,0,2
"2011","E00010760","E00010760","Total",110,97,42,55,0,3,2,1,10,10,0,0,0,0
"2011","E00010767","E00010767","Total",135,92,59,33,1,1,0,1,37,34,1,2,0,4
"2011","E00010769","E00010769","Total",134,119,72,47,0,2,1,1,12,12,0,0,0,1
"2011","E00010771","E00010771","Total",129,79,44,35,0,4,3,1,40,38,0,1,1,6
"2011","E00010774","E00010774","Total",130,124,63,61,0,2,2,0,4,3,0,0,1,0
"2011","E00010647","E00010647","Total",178,81,35,46,1,44,38,6,48,47,0,1,0,4
"2011","E00010648","E00010648","Total",123,76,33,43,0,3,1,2,44,44,0,0,0,0
"2011","E00010651","E00010651","Total",127,74,33,41,2,23,21,2,26,24,0,2,0,2
"2011","E00010656","E00010656","Total",140,110,48,62,0,1,1,0,28,22,0,6,0,1
"2011","E00010649","E00010649","Total",114,18,6,12,0,75,73,2,18,17,0,1,0,3
"2011","E00010650","E00010650","Total",111,22,11,11,0,73,71,2,15,15,0,0,0,1
"2011","E00010653","E00010653","Total",126,89,36,53,0,13,10,3,22,22,0,0,0,2
"2011","E00010654","E00010654","Total",137,76,35,41,1,35,33,2,23,23,0,0,0,2
"2011","E00010632","E00010632","Total",136,97,37,60,1,8,6,2,28,26,0,2,0,2
"2011","E00010633","E00010633","Total",130,99,47,52,0,1,1,0,27,26,0,1,0,3
"2011","E00010638","E00010638","Total",136,98,57,41,0,4,2,2,32,31,1,0,0,2
"2011","E00010652","E00010652","Total",144,116,51,65,0,3,1,2,24,22,0,1,1,1
"2011","E00010635","E00010635","Total",144,113,65,48,0,4,3,1,23,22,0,1,0,4
"2011","E00010640","E00010640","Total",126,96,41,55,0,3,3,0,24,24,0,0,0,3
"2011","E00010655","E00010655","Total",184,95,44,51,1,8,5,3,77,73,1,2,1,3
"2011","E00010657","E00010657","Total",128,108,56,52,0,1,1,0,19,19,0,0,0,0
"2011","E00010630","E00010630","Total",145,97,43,54,0,8,7,1,40,39,0,0,1,0
"2011","E00010634","E00010634","Total",120,93,53,40,1,0,0,0,24,21,1,0,2,2
"2011","E00010636","E00010636","Total",143,50,28,22,1,6,3,3,80,70,0,9,1,6
"2011","E00010639","E00010639","Total",119,85,50,35,2,5,1,4,25,22,1,2,0,2
"2011","E00010569","E00010569","Total",126,104,44,60,1,0,0,0,17,15,0,2,0,4
"2011","E00010573","E00010573","Total",148,134,54,80,1,1,1,0,11,10,0,1,0,1
"2011","E00010576","E00010576","Total",116,73,30,43,0,26,24,2,14,13,0,1,0,3
"2011","E00010581","E00010581","Total",127,106,43,63,0,0,0,0,21,19,0,2,0,0
"2011","E00010584","E00010584","Total",134,116,48,68,0,3,2,1,15,10,0,5,0,0
"2011","E00010571","E00010571","Total",135,120,55,65,0,1,0,1,14,14,0,0,0,0
"2011","E00010577","E00010577","Total",137,124,63,61,0,0,0,0,10,10,0,0,0,3
"2011","E00010578","E00010578","Total",136,124,51,73,3,1,1,0,8,8,0,0,0,0
"2011","E00010589","E00010589","Total",151,118,41,77,0,4,4,0,24,23,0,1,0,5
"2011","E00010575","E00010575","Total",135,125,60,65,0,2,1,1,6,6,0,0,0,2
"2011","E00010590","E00010590","Total",136,114,40,74,0,2,2,0,19,17,0,2,0,1
"2011","E00010591","E00010591","Total",134,105,52,53,0,7,4,3,22,20,0,2,0,0
"2011","E00010592","E00010592","Total",128,111,66,45,1,1,1,0,15,5,6,0,4,0
"2011","E00010593","E00010593","Total",121,85,38,47,0,14,14,0,20,19,0,1,0,2
"2011","E00010574","E00010574","Total",137,121,63,58,0,2,2,0,13,12,0,0,1,1
"2011","E00010587","E00010587","Total",128,103,46,57,3,3,2,1,16,14,0,2,0,3
"2011","E00010594","E00010594","Total",135,90,45,45,0,0,0,0,42,40,0,2,0,3
"2011","E00010595","E00010595","Total",142,127,55,72,1,1,1,0,13,13,0,0,0,0
"2011","E00010570","E00010570","Total",120,71,29,42,0,28,21,7,20,19,0,1,0,1
"2011","E00010572","E00010572","Total",135,108,51,57,0,4,1,3,23,22,1,0,0,0
"2011","E00010579","E00010579","Total",147,103,47,56,1,7,3,4,34,32,0,1,1,2
"2011","E00010580","E00010580","Total",132,88,39,49,0,24,23,1,20,20,0,0,0,0
"2011","E00010582","E00010582","Total",147,127,49,78,1,1,1,0,17,16,0,0,1,1
"2011","E00010954","E00010954","Total",130,56,24,32,1,69,58,11,4,4,0,0,0,0
"2011","E00010955","E00010955","Total",137,83,26,57,2,42,40,2,9,8,0,1,0,1
"2011","E00010958","E00010958","Total",106,42,16,26,0,42,38,4,20,20,0,0,0,2
"2011","E00010960","E00010960","Total",108,27,9,18,0,60,60,0,17,17,0,0,0,4
"2011","E00010961","E00010961","Total",104,10,5,5,0,82,27,55,12,12,0,0,0,0
"2011","E00010931","E00010931","Total",132,90,56,34,0,13,12,1,27,27,0,0,0,2
"2011","E00010934","E00010934","Total",128,89,30,59,0,7,5,2,30,27,2,1,0,2
"2011","E00010935","E00010935","Total",130,71,49,22,1,5,1,4,50,49,0,1,0,3
"2011","E00010937","E00010937","Total",119,79,38,41,4,4,0,4,32,32,0,0,0,0
"2011","E00010938","E00010938","Total",150,60,20,40,0,60,54,6,24,22,0,2,0,6
"2011","E00010956","E00010956","Total",135,73,55,18,0,40,35,5,21,18,0,3,0,1
"2011","E00010940","E00010940","Total",135,78,48,30,0,35,32,3,21,19,0,2,0,1
"2011","E00010949","E00010949","Total",135,103,52,51,9,3,2,1,17,17,0,0,0,3
"2011","E00010950","E00010950","Total",115,101,52,49,1,4,3,1,9,8,0,1,0,0
"2011","E00010952","E00010952","Total",105,59,28,31,1,32,21,11,12,12,0,0,0,1
"2011","E00010953","E00010953","Total",136,99,48,51,1,4,4,0,30,30,0,0,0,2
"2011","E00010962","E00010962","Total",135,91,53,38,1,25,25,0,15,14,0,1,0,3
"2011","E00010932","E00010932","Total",152,132,79,53,0,3,2,1,15,14,0,1,0,2
"2011","E00010945","E00010945","Total",119,115,65,50,0,2,0,2,2,2,0,0,0,0
"2011","E00010946","E00010946","Total",122,107,69,38,0,4,3,1,7,5,0,0,2,4
"2011","E00010947","E00010947","Total",108,96,40,56,0,3,3,0,9,9,0,0,0,0
"2011","E00010948","E00010948","Total",124,120,71,49,0,2,1,1,1,1,0,0,0,1
"2011","E00010631","E00010631","Total",127,88,40,48,0,6,2,4,27,24,0,3,0,6
"2011","E00010637","E00010637","Total",129,97,47,50,0,6,1,5,26,24,0,2,0,0
"2011","E00010642","E00010642","Total",113,86,31,55,1,5,5,0,20,19,0,1,0,1
"2011","E00010643","E00010643","Total",123,84,39,45,1,9,4,5,28,27,0,1,0,1
"2011","E00010641","E00010641","Total",123,71,35,36,1,21,10,11,29,26,0,0,3,1
"2011","E00010644","E00010644","Total",124,92,54,38,1,2,1,1,24,18,0,6,0,5
"2011","E00010645","E00010645","Total",111,87,34,53,1,2,1,1,20,19,0,1,0,1
"2011","E00010646","E00010646","Total",154,60,26,34,2,14,11,3,78,74,2,2,0,0
"2011","E00011001","E00011001","Total",136,94,36,58,0,2,1,1,37,33,1,2,1,3
"2011","E00011005","E00011005","Total",114,89,48,41,0,0,0,0,22,21,0,1,0,3
"2011","E00011006","E00011006","Total",123,81,43,38,0,3,1,2,36,32,1,3,0,3
"2011","E00011012","E00011012","Total",126,80,38,42,0,2,0,2,42,41,0,1,0,2
"2011","E00010993","E00010993","Total",107,71,36,35,0,15,11,4,19,18,0,0,1,2
"2011","E00010995","E00010995","Total",135,98,50,48,0,3,1,2,32,31,0,1,0,2
"2011","E00010997","E00010997","Total",121,91,39,52,0,11,10,1,19,14,0,2,3,0
"2011","E00011007","E00011007","Total",142,98,56,42,1,2,0,2,32,30,0,2,0,9
"2011","E00010996","E00010996","Total",138,99,40,59,0,4,2,2,35,32,0,3,0,0
"2011","E00010999","E00010999","Total",117,98,60,38,0,2,1,1,16,15,0,0,1,1
"2011","E00011018","E00011018","Total",118,89,31,58,0,2,1,1,26,24,0,1,1,1
"2011","E00011019","E00011019","Total",151,90,32,58,0,10,2,8,48,45,0,2,1,3
"2011","E00011150","E00011150","Total",153,112,50,62,4,9,4,5,27,24,0,2,1,1
"2011","E00011151","E00011151","Total",135,91,48,43,0,0,0,0,43,40,0,3,0,1
"2011","E00011153","E00011153","Total",150,94,39,55,5,13,2,11,37,35,0,2,0,1
"2011","E00011156","E00011156","Total",136,35,12,23,2,39,34,5,58,57,0,1,0,2
"2011","E00011171","E00011171","Total",135,86,45,41,1,30,23,7,18,14,0,3,1,0
"2011","E00011144","E00011144","Total",133,87,37,50,1,13,9,4,30,26,0,4,0,2
"2011","E00011148","E00011148","Total",114,75,31,44,2,20,16,4,17,15,0,2,0,0
"2011","E00011159","E00011159","Total",165,83,40,43,1,8,2,6,73,69,0,4,0,0
"2011","E00011165","E00011165","Total",170,51,17,34,4,13,2,11,98,96,0,1,1,4
"2011","E00011167","E00011167","Total",172,72,28,44,0,47,9,38,51,49,0,2,0,2
"2011","E00011158","E00011158","Total",133,78,34,44,1,7,1,6,46,45,0,1,0,1
"2011","E00011160","E00011160","Total",146,86,30,56,4,11,1,10,43,40,1,2,0,2
"2011","E00011161","E00011161","Total",135,92,37,55,1,15,3,12,27,24,0,3,0,0
"2011","E00011163","E00011163","Total",134,87,44,43,0,11,2,9,29,28,0,1,0,7
"2011","E00011145","E00011145","Total",121,81,41,40,0,10,6,4,30,30,0,0,0,0
"2011","E00011146","E00011146","Total",118,33,12,21,0,72,62,10,8,8,0,0,0,5
"2011","E00011152","E00011152","Total",132,48,20,28,1,45,33,12,37,36,0,0,1,1
"2011","E00011154","E00011154","Total",131,88,38,50,0,21,15,6,22,21,0,0,1,0
"2011","E00011166","E00011166","Total",108,25,11,14,0,62,53,9,17,17,0,0,0,4
"2011","E00011162","E00011162","Total",128,72,29,43,0,23,5,18,33,32,0,1,0,0
"2011","E00011164","E00011164","Total",121,79,26,53,0,10,4,6,32,31,0,1,0,0
"2011","E00011168","E00011168","Total",155,96,37,59,1,8,1,7,47,45,0,2,0,3
"2011","E00011169","E00011169","Total",178,95,28,67,12,19,1,18,50,45,0,5,0,2
"2011","E00010583","E00010583","Total",136,116,49,67,0,1,1,0,17,15,0,1,1,2
"2011","E00010585","E00010585","Total",147,132,61,71,0,0,0,0,13,13,0,0,0,2
"2011","E00010586","E00010586","Total",147,118,43,75,0,4,2,2,21,17,0,3,1,4
"2011","E00010588","E00010588","Total",145,125,45,80,0,0,0,0,20,20,0,0,0,0
"2011","E00010994","E00010994","Total",136,114,53,61,0,6,0,6,15,13,0,2,0,1
"2011","E00011008","E00011008","Total",148,128,71,57,0,1,0,1,17,16,0,1,0,2
"2011","E00011009","E00011009","Total",136,105,44,61,0,6,4,2,24,24,0,0,0,1
"2011","E00011013","E00011013","Total",150,113,53,60,0,7,4,3,27,25,0,1,1,3
"2011","E00011016","E00011016","Total",146,113,56,57,0,1,0,1,29,29,0,0,0,3
"2011","E00011017","E00011017","Total",171,149,66,83,0,4,2,2,17,13,0,3,1,1
"2011","E00010998","E00010998","Total",122,107,51,56,0,1,0,1,14,12,0,2,0,0
"2011","E00011002","E00011002","Total",119,94,46,48,0,2,2,0,18,17,0,1,0,5
"2011","E00011003","E00011003","Total",139,119,61,58,0,0,0,0,19,18,0,1,0,1
"2011","E00011011","E00011011","Total",128,99,60,39,0,4,4,0,24,22,0,1,1,1
"2011","E00011000","E00011000","Total",121,87,40,47,0,10,9,1,23,23,0,0,0,1
"2011","E00011004","E00011004","Total",154,58,22,36,3,2,0,2,88,84,0,4,0,3
"2011","E00011010","E00011010","Total",150,63,22,41,0,2,0,2,79,76,0,3,0,6
"2011","E00011014","E00011014","Total",164,42,21,21,0,10,7,3,111,108,0,2,1,1
"2011","E00011015","E00011015","Total",123,32,13,19,0,28,20,8,61,57,0,2,2,2
"2011","E00010902","E00010902","Total",128,109,60,49,0,1,1,0,17,17,0,0,0,1
"2011","E00010904","E00010904","Total",229,49,9,40,33,35,2,33,109,103,2,2,2,3
"2011","E00010907","E00010907","Total",128,96,51,45,3,2,0,2,26,26,0,0,0,1
"2011","E00010929","E00010929","Total",207,84,32,52,12,59,8,51,50,49,0,0,1,2
"2011","E00010930","E00010930","Total",103,17,7,10,0,41,4,37,43,43,0,0,0,2
"2011","E00010905","E00010905","Total",178,66,23,43,5,26,7,19,78,77,0,1,0,3
"2011","E00010908","E00010908","Total",145,22,6,16,10,92,67,25,20,19,0,1,0,1
"2011","E00010909","E00010909","Total",148,99,55,44,0,3,1,2,44,41,0,3,0,2
"2011","E00010910","E00010910","Total",180,66,19,47,1,54,4,50,58,54,0,1,3,1
"2011","E00010911","E00010911","Total",132,65,27,38,1,14,3,11,51,51,0,0,0,1
"2011","E00010923","E00010923","Total",148,130,71,59,0,2,0,2,13,13,0,0,0,3
"2011","E00010925","E00010925","Total",155,122,60,62,0,8,1,7,25,25,0,0,0,0
"2011","E00010926","E00010926","Total",154,94,31,63,2,8,3,5,49,46,0,3,0,1
"2011","E00171113","E00171113","Total",102,35,13,22,12,8,5,3,45,43,0,2,0,2
"2011","E00171117","E00171117","Total",123,67,34,33,1,6,2,4,47,46,0,1,0,2
"2011","E00010903","E00010903","Total",126,63,19,44,4,9,3,6,50,49,0,1,0,0
"2011","E00010912","E00010912","Total",144,83,35,48,0,16,1,15,45,43,1,1,0,0
"2011","E00010922","E00010922","Total",119,43,15,28,0,48,45,3,25,24,0,0,1,3
"2011","E00010927","E00010927","Total",139,76,29,47,4,20,7,13,38,36,0,1,1,1
"2011","E00010928","E00010928","Total",149,129,57,72,0,1,0,1,18,15,0,0,3,1
"2011","E00011147","E00011147","Total",136,89,34,55,2,9,5,4,35,30,0,3,2,1
"2011","E00011149","E00011149","Total",140,108,52,56,0,8,4,4,23,22,0,1,0,1
"2011","E00011155","E00011155","Total",131,100,47,53,0,9,5,4,19,19,0,0,0,3
"2011","E00011157","E00011157","Total",151,52,20,32,14,55,5,50,30,27,0,1,2,0
"2011","E00011170","E00011170","Total",121,53,15,38,1,1,0,1,65,64,1,0,0,1
"2011","E00010791","E00010791","Total",122,98,51,47,0,0,0,0,22,20,1,1,0,2
"2011","E00010809","E00010809","Total",131,40,18,22,1,52,10,42,33,31,0,0,2,5
"2011","E00010811","E00010811","Total",119,101,56,45,1,3,2,1,13,12,0,1,0,1
"2011","E00010813","E00010813","Total",90,54,22,32,1,12,6,6,21,21,0,0,0,2
"2011","E00010814","E00010814","Total",141,105,50,55,0,16,3,13,19,17,0,2,0,1
"2011","E00010816","E00010816","Total",125,83,24,59,1,4,3,1,37,37,0,0,0,0
"2011","E00010793","E00010793","Total",143,129,63,66,0,3,2,1,10,8,1,1,0,1
"2011","E00010794","E00010794","Total",124,113,64,49,0,1,0,1,9,9,0,0,0,1
"2011","E00010817","E00010817","Total",120,111,58,53,0,1,1,0,7,7,0,0,0,1
"2011","E00010818","E00010818","Total",114,104,51,53,0,1,0,1,7,7,0,0,0,2
"2011","E00010819","E00010819","Total",142,91,50,41,1,9,6,3,40,38,0,2,0,1
"2011","E00010842","E00010842","Total",154,75,28,47,2,41,30,11,35,34,0,1,0,1
"2011","E00010844","E00010844","Total",129,64,25,39,1,33,33,0,30,29,0,1,0,1
"2011","E00010846","E00010846","Total",133,91,38,53,0,10,7,3,31,30,0,1,0,1
"2011","E00010847","E00010847","Total",129,95,36,59,0,3,3,0,30,26,0,4,0,1
"2011","E00010821","E00010821","Total",137,111,51,60,0,4,3,1,22,19,0,2,1,0
"2011","E00010825","E00010825","Total",127,112,57,55,0,2,2,0,9,7,0,2,0,4
"2011","E00010843","E00010843","Total",129,111,52,59,0,3,0,3,13,12,0,1,0,2
"2011","E00010845","E00010845","Total",144,122,60,62,0,3,0,3,19,18,0,1,0,0
"2011","E00010933","E00010933","Total",129,118,68,50,0,0,0,0,9,9,0,0,0,2
"2011","E00010939","E00010939","Total",125,110,66,44,0,2,1,1,11,9,0,1,1,2
"2011","E00010951","E00010951","Total",126,111,77,34,0,2,1,1,13,13,0,0,0,0
"2011","E00010957","E00010957","Total",137,119,70,49,0,1,0,1,16,15,0,0,1,1
"2011","E00010959","E00010959","Total",121,112,69,43,1,0,0,0,6,5,0,0,1,2
"2011","E00010936","E00010936","Total",134,115,73,42,0,3,1,2,11,11,0,0,0,5
"2011","E00010941","E00010941","Total",129,87,58,29,0,29,4,25,12,11,0,0,1,1
"2011","E00010942","E00010942","Total",136,116,69,47,0,1,1,0,18,18,0,0,0,1
"2011","E00010943","E00010943","Total",188,74,36,38,0,9,3,6,104,97,4,1,2,1
"2011","E00010944","E00010944","Total",127,87,41,46,0,13,2,11,26,24,1,1,0,1
"2011","E00010969","E00010969","Total",121,90,40,50,0,3,0,3,26,25,0,1,0,2
"2011","E00010970","E00010970","Total",139,132,86,46,0,0,0,0,6,5,0,1,0,1
"2011","E00010971","E00010971","Total",128,112,70,42,0,5,5,0,9,9,0,0,0,2
"2011","E00010972","E00010972","Total",130,121,72,49,0,1,1,0,6,5,0,1,0,2
"2011","E00010973","E00010973","Total",120,53,38,15,0,35,2,33,27,26,0,0,1,5
"2011","E00010974","E00010974","Total",154,128,57,71,1,1,1,0,24,23,0,0,1,0
"2011","E00010977","E00010977","Total",165,133,73,60,0,2,1,1,30,28,0,2,0,0
"2011","E00010978","E00010978","Total",122,29,9,20,0,76,68,8,16,16,0,0,0,1
"2011","E00010979","E00010979","Total",158,69,33,36,6,46,33,13,31,30,0,1,0,6
"2011","E00010981","E00010981","Total",141,123,49,74,0,1,1,0,17,17,0,0,0,0
"2011","E00010849","E00010849","Total",127,77,38,39,0,14,11,3,35,34,0,1,0,1
"2011","E00010851","E00010851","Total",131,91,50,41,5,6,4,2,27,26,0,0,1,2
"2011","E00010852","E00010852","Total",153,73,37,36,4,1,1,0,73,70,2,0,1,2
"2011","E00010854","E00010854","Total",117,75,36,39,0,3,2,1,38,37,0,1,0,1
"2011","E00010853","E00010853","Total",117,68,37,31,0,12,9,3,33,31,0,1,1,4
"2011","E00010859","E00010859","Total",138,106,55,51,0,3,1,2,28,28,0,0,0,1
"2011","E00010870","E00010870","Total",114,96,52,44,1,1,0,1,13,12,0,1,0,3
"2011","E00010871","E00010871","Total",115,92,47,45,0,4,2,2,17,17,0,0,0,2
"2011","E00010857","E00010857","Total",121,82,51,31,0,4,3,1,30,30,0,0,0,5
"2011","E00010861","E00010861","Total",117,68,35,33,0,6,2,4,43,42,0,1,0,0
"2011","E00010865","E00010865","Total",116,37,14,23,0,70,61,9,8,8,0,0,0,1
"2011","E00010868","E00010868","Total",123,83,34,49,0,7,4,3,32,31,1,0,0,1
"2011","E00010855","E00010855","Total",128,68,31,37,1,38,32,6,20,17,0,2,1,1
"2011","E00010856","E00010856","Total",117,34,7,27,2,67,66,1,8,8,0,0,0,6
"2011","E00010858","E00010858","Total",124,61,25,36,2,47,45,2,11,10,0,0,1,3
"2011","E00010866","E00010866","Total",142,57,18,39,1,56,55,1,23,21,0,2,0,5
"2011","E00010860","E00010860","Total",143,108,65,43,2,2,1,1,28,26,0,1,1,3
"2011","E00010867","E00010867","Total",130,21,13,8,0,90,9,81,16,15,0,0,1,3
"2011","E00010869","E00010869","Total",154,104,54,50,1,0,0,0,49,46,2,1,0,0
"2011","E00010873","E00010873","Total",104,64,35,29,0,21,21,0,19,18,0,0,1,0
"2011","E00010803","E00010803","Total",125,121,74,47,0,0,0,0,3,3,0,0,0,1
"2011","E00010805","E00010805","Total",125,109,57,52,0,0,0,0,15,15,0,0,0,1
"2011","E00010806","E00010806","Total",102,65,41,24,1,2,0,2,32,32,0,0,0,2
"2011","E00010807","E00010807","Total",135,124,62,62,0,3,2,1,8,7,0,1,0,0
"2011","E00010808","E00010808","Total",129,118,70,48,0,0,0,0,10,9,0,1,0,1
"2011","E00010792","E00010792","Total",123,105,52,53,1,2,0,2,14,13,1,0,0,1
"2011","E00010796","E00010796","Total",119,96,38,58,1,2,0,2,20,18,0,2,0,0
"2011","E00010810","E00010810","Total",120,113,60,53,0,1,1,0,5,4,0,1,0,1
"2011","E00010812","E00010812","Total",135,121,61,60,0,3,3,0,11,10,0,1,0,0
"2011","E00010815","E00010815","Total",144,116,55,61,0,15,13,2,8,8,0,0,0,5
"2011","E00010797","E00010797","Total",132,105,42,63,2,7,4,3,17,17,0,0,0,1
"2011","E00010801","E00010801","Total",175,59,30,29,25,11,3,8,77,73,2,2,0,3
"2011","E00010802","E00010802","Total",145,116,75,41,2,2,1,1,24,22,0,2,0,1
"2011","E00010804","E00010804","Total",141,122,62,60,2,0,0,0,15,15,0,0,0,2
"2011","E00010795","E00010795","Total",124,106,54,52,0,0,0,0,17,14,1,2,0,1
"2011","E00010798","E00010798","Total",118,111,54,57,0,0,0,0,7,7,0,0,0,0
"2011","E00010799","E00010799","Total",127,118,57,61,0,1,1,0,8,7,0,1,0,0
"2011","E00010800","E00010800","Total",122,112,48,64,3,0,0,0,6,4,0,2,0,1
"2011","E00010677","E00010677","Total",208,72,25,47,2,4,2,2,130,129,0,1,0,0
"2011","E00010681","E00010681","Total",170,93,40,53,13,6,3,3,57,55,0,2,0,1
"2011","E00010682","E00010682","Total",146,45,18,27,0,7,1,6,92,88,1,3,0,2
"2011","E00010687","E00010687","Total",131,63,29,34,1,0,0,0,66,65,0,1,0,1
"2011","E00010689","E00010689","Total",129,52,27,25,1,9,0,9,65,64,0,1,0,2
"2011","E00010659","E00010659","Total",222,49,8,41,2,7,1,6,161,154,3,0,4,3
"2011","E00010671","E00010671","Total",152,79,34,45,0,15,1,14,58,53,1,4,0,0
"2011","E00010672","E00010672","Total",195,53,22,31,1,10,3,7,129,125,0,4,0,2
"2011","E00010676","E00010676","Total",160,64,30,34,4,48,6,42,43,40,0,3,0,1
"2011","E00010686","E00010686","Total",155,65,22,43,1,2,0,2,87,87,0,0,0,0
"2011","E00010906","E00010906","Total",162,100,45,55,1,5,0,5,54,53,0,1,0,2
"2011","E00010913","E00010913","Total",127,100,50,50,2,3,0,3,22,20,0,2,0,0
"2011","E00010914","E00010914","Total",132,86,27,59,0,1,0,1,45,44,0,1,0,0
"2011","E00010916","E00010916","Total",124,87,35,52,0,1,0,1,36,35,0,0,1,0
"2011","E00010921","E00010921","Total",137,63,19,44,1,3,1,2,68,65,2,0,1,2
"2011","E00010915","E00010915","Total",118,84,37,47,0,3,1,2,28,28,0,0,0,3
"2011","E00010917","E00010917","Total",144,103,57,46,4,2,0,2,34,34,0,0,0,1
"2011","E00010918","E00010918","Total",125,74,39,35,0,2,1,1,49,49,0,0,0,0
"2011","E00010919","E00010919","Total",139,85,36,49,0,1,0,1,53,50,0,3,0,0
"2011","E00010920","E00010920","Total",163,69,30,39,1,4,1,3,89,87,1,1,0,0
"2011","E00010828","E00010828","Total",158,86,37,49,0,31,29,2,40,37,0,3,0,1
"2011","E00010831","E00010831","Total",136,109,49,60,2,2,0,2,22,19,0,2,1,1
"2011","E00010834","E00010834","Total",144,117,55,62,0,4,2,2,21,18,0,2,1,2
"2011","E00010835","E00010835","Total",127,102,53,49,1,3,0,3,20,17,0,2,1,1
"2011","E00010836","E00010836","Total",120,74,30,44,1,10,5,5,35,34,0,1,0,0
"2011","E00010837","E00010837","Total",139,93,43,50,0,1,0,1,43,43,0,0,0,2
"2011","E00010838","E00010838","Total",149,72,22,50,1,9,2,7,64,60,0,3,1,3
"2011","E00010839","E00010839","Total",139,99,38,61,2,3,2,1,34,31,0,2,1,1
"2011","E00010840","E00010840","Total",152,84,34,50,0,1,0,1,66,62,2,2,0,1
"2011","E00010841","E00010841","Total",125,47,13,34,3,8,0,8,65,63,0,1,1,2
"2011","E00010823","E00010823","Total",125,92,37,55,0,4,3,1,29,27,0,2,0,0
"2011","E00010826","E00010826","Total",188,54,23,31,38,63,25,38,31,30,0,1,0,2
"2011","E00010829","E00010829","Total",142,96,41,55,1,8,7,1,35,32,0,3,0,2
"2011","E00010832","E00010832","Total",119,92,50,42,0,3,2,1,22,19,0,3,0,2
"2011","E00010833","E00010833","Total",154,89,43,46,1,4,2,2,56,50,1,5,0,4
"2011","E00010820","E00010820","Total",134,67,33,34,0,6,3,3,60,59,0,1,0,1
"2011","E00010822","E00010822","Total",139,111,41,70,1,3,1,2,23,22,0,1,0,1
"2011","E00010824","E00010824","Total",138,94,48,46,0,1,0,1,41,41,0,0,0,2
"2011","E00010827","E00010827","Total",137,86,39,47,1,8,4,4,41,38,0,2,1,1
"2011","E00010830","E00010830","Total",135,92,43,49,2,8,6,2,33,32,0,0,1,0
"2011","E00010963","E00010963","Total",127,111,49,62,0,2,0,2,13,11,0,2,0,1
"2011","E00010964","E00010964","Total",128,112,45,67,0,2,1,1,14,13,0,1,0,0
"2011","E00010965","E00010965","Total",128,120,59,61,0,1,0,1,7,7,0,0,0,0
"2011","E00010967","E00010967","Total",170,129,59,70,0,13,3,10,28,26,0,2,0,0
"2011","E00010968","E00010968","Total",114,88,17,71,0,1,1,0,24,24,0,0,0,1
"2011","E00010975","E00010975","Total",140,110,54,56,0,11,10,1,19,17,0,2,0,0
"2011","E00010976","E00010976","Total",136,128,90,38,0,1,0,1,4,4,0,0,0,3
"2011","E00010980","E00010980","Total",128,125,65,60,0,0,0,0,3,2,0,0,1,0
"2011","E00010982","E00010982","Total",118,93,55,38,0,14,13,1,9,9,0,0,0,2
"2011","E00010984","E00010984","Total",135,110,52,58,0,10,10,0,13,11,0,2,0,2
"2011","E00010983","E00010983","Total",117,86,57,29,0,7,5,2,19,19,0,0,0,5
"2011","E00010986","E00010986","Total",125,86,40,46,1,19,19,0,16,15,0,0,1,3
"2011","E00010987","E00010987","Total",128,121,63,58,0,4,4,0,3,3,0,0,0,0
"2011","E00010991","E00010991","Total",121,118,49,69,0,0,0,0,3,2,0,1,0,0
"2011","E00010992","E00010992","Total",119,102,38,64,0,0,0,0,17,17,0,0,0,0
"2011","E00010966","E00010966","Total",109,104,47,57,0,0,0,0,4,1,0,2,1,1
"2011","E00010985","E00010985","Total",117,107,52,55,0,2,2,0,7,6,0,1,0,1
"2011","E00010988","E00010988","Total",130,117,55,62,0,0,0,0,12,12,0,0,0,1
"2011","E00010989","E00010989","Total",130,123,56,67,0,1,1,0,6,6,0,0,0,0
"2011","E00010990","E00010990","Total",130,124,55,69,0,5,5,0,1,1,0,0,0,0
"2011","E00010665","E00010665","Total",130,73,64,9,2,2,0,2,51,48,0,2,1,2
"2011","E00010666","E00010666","Total",151,70,49,21,1,28,5,23,49,46,0,3,0,3
"2011","E00010669","E00010669","Total",145,46,19,27,6,15,7,8,77,66,1,3,7,1
"2011","E00010680","E00010680","Total",238,76,29,47,19,45,5,40,93,91,0,2,0,5
"2011","E00010683","E00010683","Total",128,75,29,46,1,2,1,1,50,49,0,1,0,0
"2011","E00010688","E00010688","Total",125,51,24,27,2,3,1,2,67,65,0,1,1,2
"2011","E00171100","E00171100","Total",132,22,10,12,0,26,24,2,81,80,0,1,0,3
"2011","E00171102","E00171102","Total",154,38,11,27,2,2,1,1,109,107,0,2,0,3
"2011","E00010661","E00010661","Total",120,36,20,16,0,6,0,6,78,74,1,3,0,0
"2011","E00010662","E00010662","Total",130,94,44,50,0,2,1,1,29,27,0,1,1,5
"2011","E00010663","E00010663","Total",139,78,39,39,2,6,3,3,50,50,0,0,0,3
"2011","E00010678","E00010678","Total",128,93,47,46,1,3,1,2,30,30,0,0,0,1
"2011","E00010685","E00010685","Total",111,95,48,47,0,1,0,1,13,10,0,2,1,2
"2011","E00010658","E00010658","Total",119,76,44,32,0,2,1,1,39,35,0,4,0,2
"2011","E00010660","E00010660","Total",175,61,18,43,6,16,8,8,87,85,0,1,1,5
"2011","E00010664","E00010664","Total",227,79,26,53,3,45,11,34,96,92,0,3,1,4
"2011","E00010668","E00010668","Total",117,63,33,30,1,18,2,16,34,33,0,1,0,1
"2011","E00010670","E00010670","Total",126,86,40,46,1,8,6,2,26,24,2,0,0,5
"2011","E00010690","E00010690","Total",125,30,16,14,0,47,12,35,46,37,1,0,8,2
"2011","E00010673","E00010673","Total",115,19,5,14,0,68,65,3,21,21,0,0,0,7
"2011","E00010674","E00010674","Total",100,18,6,12,0,57,22,35,22,10,0,0,12,3
"2011","E00010675","E00010675","Total",136,50,18,32,11,49,32,17,23,20,0,1,2,3
"2011","E00010679","E00010679","Total",121,79,34,45,0,2,1,1,38,35,0,3,0,2
"2011","E00010684","E00010684","Total",114,89,45,44,3,6,1,5,15,13,0,1,1,1
"2011","E00011172","E00011172","Total",121,41,10,31,0,7,4,3,73,72,0,1,0,0
"2011","E00011181","E00011181","Total",126,73,20,53,1,9,4,5,41,40,0,1,0,2
"2011","E00011184","E00011184","Total",123,73,24,49,0,4,2,2,46,45,0,0,1,0
"2011","E00011185","E00011185","Total",142,68,28,40,1,43,34,9,29,27,0,2,0,1
"2011","E00011186","E00011186","Total",136,46,18,28,1,20,18,2,65,63,0,1,1,4
"2011","E00011174","E00011174","Total",118,75,37,38,1,4,3,1,38,36,1,1,0,0
"2011","E00011175","E00011175","Total",125,89,37,52,0,3,3,0,31,30,0,1,0,2
"2011","E00011179","E00011179","Total",114,85,41,44,0,8,1,7,20,20,0,0,0,1
"2011","E00011180","E00011180","Total",117,81,30,51,0,13,1,12,22,21,0,0,1,1
"2011","E00011182","E00011182","Total",122,75,28,47,2,7,3,4,37,34,0,3,0,1
"2011","E00011188","E00011188","Total",123,69,29,40,0,23,20,3,25,23,0,2,0,6
"2011","E00011189","E00011189","Total",125,95,32,63,0,2,0,2,27,26,0,1,0,1
"2011","E00011190","E00011190","Total",136,45,21,24,28,42,30,12,18,17,1,0,0,3
"2011","E00011191","E00011191","Total",141,70,27,43,0,43,36,7,23,21,0,2,0,5
"2011","E00011192","E00011192","Total",130,100,41,59,0,3,1,2,26,24,0,2,0,1
"2011","E00011176","E00011176","Total",120,101,50,51,1,1,1,0,16,15,0,0,1,1
"2011","E00011177","E00011177","Total",119,103,55,48,0,4,1,3,12,11,0,0,1,0
"2011","E00011199","E00011199","Total",128,110,55,55,0,3,0,3,14,14,0,0,0,1
"2011","E00011200","E00011200","Total",127,86,45,41,1,4,2,2,32,32,0,0,0,4
"2011","E00011201","E00011201","Total",119,104,56,48,0,1,1,0,14,14,0,0,0,0
"2011","E00011020","E00011020","Total",127,122,74,48,0,0,0,0,5,5,0,0,0,0
"2011","E00011021","E00011021","Total",118,111,62,49,0,0,0,0,7,5,0,2,0,0
"2011","E00011025","E00011025","Total",111,87,45,42,0,4,2,2,19,18,0,1,0,1
"2011","E00011048","E00011048","Total",127,118,60,58,0,0,0,0,9,9,0,0,0,0
"2011","E00011022","E00011022","Total",131,110,59,51,0,0,0,0,18,12,1,5,0,3
"2011","E00011023","E00011023","Total",137,131,79,52,0,1,1,0,5,5,0,0,0,0
"2011","E00011024","E00011024","Total",152,32,7,25,1,3,0,3,115,109,2,2,2,1
"2011","E00011026","E00011026","Total",126,104,56,48,3,3,0,3,14,11,0,3,0,2
"2011","E00011173","E00011173","Total",137,72,27,45,0,3,0,3,61,60,0,1,0,1
"2011","E00011178","E00011178","Total",123,111,59,52,0,1,0,1,10,10,0,0,0,1
"2011","E00011183","E00011183","Total",118,91,37,54,0,3,0,3,22,22,0,0,0,2
"2011","E00011187","E00011187","Total",138,127,87,40,0,0,0,0,10,10,0,0,0,1
"2011","E00011193","E00011193","Total",119,92,40,52,1,1,0,1,24,21,0,3,0,1
"2011","E00011194","E00011194","Total",123,100,36,64,0,2,0,2,20,16,0,4,0,1
"2011","E00011197","E00011197","Total",136,111,47,64,2,7,1,6,16,12,0,4,0,0
"2011","E00011198","E00011198","Total",102,79,31,48,1,9,3,6,13,12,0,1,0,0
"2011","E00171105","E00171105","Total",175,59,23,36,1,83,9,74,27,26,0,1,0,5
"2011","E00010706","E00010706","Total",118,28,10,18,0,63,46,17,24,23,0,0,1,3
"2011","E00010709","E00010709","Total",143,10,3,7,1,115,107,8,14,14,0,0,0,3
"2011","E00010711","E00010711","Total",220,8,2,6,10,173,115,58,23,22,0,0,1,6
"2011","E00010712","E00010712","Total",142,60,30,30,2,25,17,8,55,51,0,4,0,0
"2011","E00010715","E00010715","Total",139,34,7,27,0,75,71,4,23,22,0,1,0,7
"2011","E00010718","E00010718","Total",134,99,59,40,0,5,4,1,27,23,1,3,0,3
"2011","E00010692","E00010692","Total",135,71,23,48,1,5,3,2,57,55,0,2,0,1
"2011","E00010695","E00010695","Total",149,94,43,51,7,4,3,1,44,41,0,3,0,0
"2011","E00010696","E00010696","Total",130,68,23,45,0,11,8,3,49,46,0,3,0,2
"2011","E00010702","E00010702","Total",121,104,73,31,0,2,1,1,15,15,0,0,0,0
"2011","E00010726","E00010726","Total",103,92,48,44,0,3,2,1,7,7,0,0,0,1
"2011","E00010698","E00010698","Total",119,92,38,54,0,3,1,2,22,22,0,0,0,2
"2011","E00010699","E00010699","Total",123,81,34,47,1,7,0,7,33,31,0,2,0,1
"2011","E00010701","E00010701","Total",148,72,21,51,1,10,6,4,64,63,0,1,0,1
"2011","E00010704","E00010704","Total",119,84,32,52,1,4,3,1,28,26,0,1,1,2
"2011","E00011052","E00011052","Total",161,60,22,38,0,48,1,47,50,44,1,2,3,3
"2011","E00011055","E00011055","Total",163,93,42,51,1,6,3,3,61,60,0,1,0,2
"2011","E00011061","E00011061","Total",169,95,39,56,3,6,1,5,62,61,0,1,0,3
"2011","E00011062","E00011062","Total",159,107,73,34,1,4,1,3,46,40,0,5,1,1
"2011","E00171103","E00171103","Total",162,77,16,61,36,8,1,7,39,38,0,1,0,2
"2011","E00171107","E00171107","Total",157,30,4,26,3,35,1,34,89,83,0,1,5,0
"2011","E00171108","E00171108","Total",145,74,24,50,2,10,0,10,59,56,0,1,2,0
"2011","E00011049","E00011049","Total",111,31,14,17,0,64,42,22,12,11,0,0,1,4
"2011","E00011058","E00011058","Total",110,27,13,14,0,66,1,65,16,15,0,0,1,1
"2011","E00011059","E00011059","Total",133,83,32,51,2,21,7,14,27,26,0,0,1,0
"2011","E00011060","E00011060","Total",123,79,32,47,0,17,3,14,25,22,0,3,0,2
"2011","E00011050","E00011050","Total",133,93,45,48,2,6,2,4,32,28,1,3,0,0
"2011","E00011057","E00011057","Total",145,20,9,11,9,75,69,6,36,34,0,1,1,5
"2011","E00011065","E00011065","Total",114,45,8,37,0,6,0,6,63,62,0,1,0,0
"2011","E00011066","E00011066","Total",123,68,29,39,3,4,0,4,47,46,0,1,0,1
"2011","E00011069","E00011069","Total",132,96,45,51,1,4,1,3,29,25,0,2,2,2
"2011","E00011053","E00011053","Total",114,84,28,56,0,4,1,3,24,23,0,1,0,2
"2011","E00011056","E00011056","Total",147,115,53,62,1,6,2,4,24,22,1,1,0,1
"2011","E00011064","E00011064","Total",127,100,46,54,0,7,3,4,20,20,0,0,0,0
"2011","E00011067","E00011067","Total",125,91,39,52,1,8,0,8,23,22,0,1,0,2
"2011","E00011078","E00011078","Total",157,18,4,14,0,117,11,106,22,19,0,1,2,0
"2011","E00011079","E00011079","Total",141,31,2,29,1,97,18,79,8,6,0,0,2,4
"2011","E00011081","E00011081","Total",126,25,5,20,0,87,6,81,10,7,0,0,3,4
"2011","E00171091","E00171091","Total",128,37,18,19,2,77,11,66,9,7,0,0,2,3
"2011","E00010691","E00010691","Total",209,107,38,69,0,1,1,0,99,98,0,1,0,2
"2011","E00010693","E00010693","Total",124,90,42,48,0,1,0,1,29,25,2,1,1,4
"2011","E00010700","E00010700","Total",138,82,37,45,1,9,9,0,41,39,0,2,0,5
"2011","E00010703","E00010703","Total",139,72,24,48,4,1,1,0,59,56,1,2,0,3
"2011","E00010707","E00010707","Total",116,66,29,37,1,2,2,0,43,43,0,0,0,4
"2011","E00010708","E00010708","Total",102,59,28,31,0,0,0,0,39,32,4,3,0,4
"2011","E00010710","E00010710","Total",107,47,20,27,0,0,0,0,49,44,5,0,0,11
"2011","E00010713","E00010713","Total",116,58,28,30,0,6,4,2,50,47,0,3,0,2
"2011","E00010714","E00010714","Total",123,63,29,34,2,1,0,1,51,46,1,3,1,6
"2011","E00010716","E00010716","Total",125,88,42,46,0,2,1,1,33,31,0,0,2,2
"2011","E00010719","E00010719","Total",132,112,62,50,0,4,1,3,16,16,0,0,0,0
"2011","E00010717","E00010717","Total",108,65,30,35,1,10,7,3,30,29,0,1,0,2
"2011","E00010720","E00010720","Total",157,78,38,40,3,16,12,4,59,55,2,2,0,1
"2011","E00010721","E00010721","Total",119,36,11,25,1,55,53,2,23,22,0,1,0,4
"2011","E00010722","E00010722","Total",146,105,54,51,1,5,3,2,35,34,0,1,0,0
"2011","E00010723","E00010723","Total",127,46,21,25,23,11,10,1,45,45,0,0,0,2
"2011","E00010694","E00010694","Total",112,72,28,44,0,2,2,0,33,30,3,0,0,5
"2011","E00010697","E00010697","Total",142,79,41,38,0,1,1,0,47,33,12,2,0,15
"2011","E00010705","E00010705","Total",62,15,4,11,0,0,0,0,30,23,4,2,1,17
"2011","E00010724","E00010724","Total",68,30,16,14,0,0,0,0,10,5,5,0,0,28
"2011","E00010725","E00010725","Total",84,54,20,34,0,1,1,0,19,15,2,1,1,10
"2011","E00011083","E00011083","Total",108,85,53,32,1,1,0,1,20,19,0,1,0,1
"2011","E00011091","E00011091","Total",107,75,35,40,1,3,0,3,26,24,0,2,0,2
"2011","E00011106","E00011106","Total",124,103,52,51,0,2,1,1,18,17,0,1,0,1
"2011","E00011107","E00011107","Total",123,64,29,35,0,7,3,4,49,45,0,2,2,3
"2011","E00011110","E00011110","Total",144,90,27,63,0,5,0,5,46,42,0,1,3,3
"2011","E00011105","E00011105","Total",114,67,24,43,1,3,1,2,41,40,1,0,0,2
"2011","E00011108","E00011108","Total",116,72,24,48,0,5,2,3,36,34,0,2,0,3
"2011","E00011109","E00011109","Total",117,72,32,40,1,6,1,5,38,34,0,1,3,0
"2011","E00011111","E00011111","Total",129,53,25,28,1,6,2,4,67,66,0,0,1,2
"2011","E00011112","E00011112","Total",129,60,29,31,2,34,1,33,29,29,0,0,0,4
"2011","E00011085","E00011085","Total",126,78,38,40,0,4,1,3,42,41,1,0,0,2
"2011","E00011089","E00011089","Total",121,96,49,47,0,2,1,1,22,17,1,4,0,1
"2011","E00011093","E00011093","Total",134,82,47,35,2,24,1,23,25,22,0,3,0,1
"2011","E00011096","E00011096","Total",130,63,22,41,0,18,2,16,48,46,0,2,0,1
"2011","E00011087","E00011087","Total",129,98,35,63,0,2,2,0,28,27,0,1,0,1
"2011","E00011098","E00011098","Total",127,104,43,61,1,2,0,2,19,13,0,5,1,1
"2011","E00011099","E00011099","Total",121,87,34,53,1,4,1,3,29,26,0,3,0,0
"2011","E00011101","E00011101","Total",111,74,29,45,0,11,8,3,26,23,0,3,0,0
"2011","E00011068","E00011068","Total",108,85,33,52,0,8,3,5,14,14,0,0,0,1
"2011","E00011071","E00011071","Total",134,89,37,52,0,7,4,3,38,38,0,0,0,0
"2011","E00011073","E00011073","Total",130,69,21,48,1,31,21,10,29,28,0,1,0,0
"2011","E00011076","E00011076","Total",110,30,17,13,1,47,47,0,28,27,0,1,0,4
"2011","E00011077","E00011077","Total",130,86,28,58,0,11,8,3,31,29,0,2,0,2
"2011","E00011063","E00011063","Total",125,81,30,51,0,36,33,3,7,5,0,1,1,1
"2011","E00011070","E00011070","Total",125,20,6,14,0,93,75,18,7,7,0,0,0,5
"2011","E00011072","E00011072","Total",119,27,12,15,0,81,74,7,10,10,0,0,0,1
"2011","E00011074","E00011074","Total",114,30,9,21,1,41,26,15,39,37,1,1,0,3
"2011","E00011075","E00011075","Total",112,69,17,52,0,10,8,2,33,31,0,2,0,0
"2011","E00011084","E00011084","Total",116,92,32,60,1,4,2,2,19,17,0,1,1,0
"2011","E00011086","E00011086","Total",136,105,41,64,2,6,4,2,22,21,0,1,0,1
"2011","E00011090","E00011090","Total",122,78,31,47,0,28,24,4,16,14,0,1,1,0
"2011","E00011097","E00011097","Total",119,93,42,51,1,4,2,2,17,15,0,2,0,4
"2011","E00011082","E00011082","Total",122,92,38,54,0,5,3,2,23,21,0,2,0,2
"2011","E00011088","E00011088","Total",111,86,32,54,1,8,3,5,16,15,0,0,1,0
"2011","E00011092","E00011092","Total",134,113,36,77,0,4,1,3,15,14,0,1,0,2
"2011","E00011094","E00011094","Total",119,78,28,50,2,6,3,3,33,26,0,4,3,0
"2011","E00011095","E00011095","Total",105,73,32,41,1,7,2,5,24,24,0,0,0,0
"2011","E00011100","E00011100","Total",119,94,36,58,0,5,1,4,20,19,0,1,0,0
"2011","E00011102","E00011102","Total",118,47,12,35,1,46,18,28,15,15,0,0,0,9
"2011","E00011103","E00011103","Total",138,97,30,67,0,21,13,8,18,17,0,1,0,2
"2011","E00011104","E00011104","Total",122,38,11,27,0,77,68,9,6,6,0,0,0,1
"2011","E00011031","E00011031","Total",126,25,7,18,1,20,17,3,76,75,0,1,0,4
"2011","E00011034","E00011034","Total",118,70,39,31,0,4,0,4,42,39,0,3,0,2
"2011","E00011039","E00011039","Total",124,91,42,49,0,2,0,2,31,29,0,2,0,0
"2011","E00011040","E00011040","Total",150,43,11,32,1,8,5,3,96,93,0,2,1,2
"2011","E00011042","E00011042","Total",116,93,44,49,0,0,0,0,22,21,0,1,0,1
"2011","E00011029","E00011029","Total",114,93,54,39,1,0,0,0,19,17,0,2,0,1
"2011","E00011030","E00011030","Total",119,83,29,54,1,1,0,1,33,32,0,1,0,1
"2011","E00011035","E00011035","Total",102,79,35,44,0,1,0,1,22,19,0,3,0,0
"2011","E00011041","E00011041","Total",122,93,41,52,0,3,1,2,25,25,0,0,0,1
"2011","E00011044","E00011044","Total",112,88,36,52,0,3,1,2,19,19,0,0,0,2
"2011","E00011045","E00011045","Total",131,102,49,53,0,4,1,3,25,22,1,1,1,0
"2011","E00011046","E00011046","Total",154,121,54,67,0,3,1,2,30,30,0,0,0,0
"2011","E00011047","E00011047","Total",127,104,43,61,0,5,2,3,18,17,0,0,1,0
"2011","E00011027","E00011027","Total",117,93,42,51,0,2,0,2,22,22,0,0,0,0
"2011","E00011028","E00011028","Total",129,110,50,60,0,2,0,2,15,14,0,1,0,2
"2011","E00011032","E00011032","Total",119,93,44,49,1,2,2,0,21,20,0,1,0,2
"2011","E00011033","E00011033","Total",139,105,45,60,0,3,2,1,31,28,0,3,0,0
"2011","E00011036","E00011036","Total",120,101,43,58,1,3,2,1,13,12,0,1,0,2
"2011","E00011038","E00011038","Total",140,116,43,73,0,0,0,0,23,21,0,2,0,1
"2011","E00011043","E00011043","Total",136,111,44,67,2,2,0,2,21,20,0,1,0,0
"2011","E00165801","E00165801","Total",124,109,49,60,0,1,0,1,11,11,0,0,0,3
"2011","E00010862","E00010862","Total",127,58,22,36,2,49,45,4,15,14,0,0,1,3
"2011","E00010863","E00010863","Total",132,114,58,56,0,2,2,0,15,14,0,1,0,1
"2011","E00010864","E00010864","Total",149,121,58,63,0,5,4,1,19,18,0,1,0,4
"2011","E00010848","E00010848","Total",126,102,40,62,0,1,0,1,22,20,0,1,1,1
"2011","E00010850","E00010850","Total",136,86,43,43,0,2,1,1,43,41,0,1,1,5
"2011","E00010872","E00010872","Total",116,92,49,43,0,0,0,0,22,19,0,2,1,2
"2011","E00010874","E00010874","Total",156,92,49,43,9,4,4,0,47,46,1,0,0,4
"2011","E00010875","E00010875","Total",119,58,15,43,32,13,2,11,16,16,0,0,0,0
"2011","E00010892","E00010892","Total",118,103,49,54,0,1,0,1,14,14,0,0,0,0
"2011","E00010896","E00010896","Total",129,99,44,55,5,7,4,3,18,18,0,0,0,0
"2011","E00010900","E00010900","Total",127,85,31,54,1,23,20,3,17,16,0,1,0,1
"2011","E00010880","E00010880","Total",136,113,53,60,0,0,0,0,23,23,0,0,0,0
"2011","E00010893","E00010893","Total",128,107,52,55,1,2,0,2,17,15,1,1,0,1
"2011","E00010897","E00010897","Total",129,108,55,53,0,3,1,2,15,14,0,1,0,3
"2011","E00010899","E00010899","Total",136,111,58,53,0,1,0,1,21,21,0,0,0,3
"2011","E00010877","E00010877","Total",119,96,51,45,0,3,2,1,19,15,0,3,1,1
"2011","E00010890","E00010890","Total",114,92,46,46,1,0,0,0,21,20,0,1,0,0
"2011","E00010895","E00010895","Total",113,98,53,45,0,3,2,1,11,11,0,0,0,1
"2011","E00010898","E00010898","Total",137,99,44,55,1,3,0,3,34,34,0,0,0,0
"2011","E00010878","E00010878","Total",131,92,56,36,0,9,1,8,27,25,0,2,0,3
"2011","E00010879","E00010879","Total",140,125,66,59,0,1,0,1,13,12,0,1,0,1
"2011","E00010881","E00010881","Total",135,115,65,50,1,2,1,1,14,14,0,0,0,3
"2011","E00010876","E00010876","Total",109,93,43,50,1,2,2,0,12,11,0,0,1,1
"2011","E00010882","E00010882","Total",144,86,53,33,2,1,0,1,55,55,0,0,0,0
"2011","E00010883","E00010883","Total",152,116,69,47,0,0,0,0,34,34,0,0,0,2
"2011","E00010901","E00010901","Total",130,94,41,53,0,4,3,1,31,30,0,1,0,1
"2011","E00010884","E00010884","Total",109,94,41,53,0,1,1,0,12,10,0,2,0,2
"2011","E00010885","E00010885","Total",122,81,34,47,0,0,0,0,38,36,1,1,0,3
"2011","E00010886","E00010886","Total",126,109,48,61,0,2,2,0,15,15,0,0,0,0
"2011","E00010888","E00010888","Total",95,60,18,42,1,6,3,3,26,26,0,0,0,2
"2011","E00010887","E00010887","Total",130,106,53,53,1,7,7,0,13,12,0,1,0,3
"2011","E00010889","E00010889","Total",125,106,42,64,2,4,1,3,13,13,0,0,0,0
"2011","E00010891","E00010891","Total",125,107,55,52,1,3,1,2,12,12,0,0,0,2
"2011","E00010894","E00010894","Total",122,115,54,61,0,2,2,0,3,2,0,1,0,2
"2011","E00011366","E00011366","Total",67,55,37,18,0,2,2,0,10,10,0,0,0,0
"2011","E00011367","E00011367","Total",113,85,33,52,0,21,21,0,6,6,0,0,0,1
"2011","E00011368","E00011368","Total",132,76,29,47,1,45,42,3,10,9,0,1,0,0
"2011","E00011369","E00011369","Total",183,116,35,81,11,40,26,14,16,13,0,3,0,0
"2011","E00011371","E00011371","Total",106,74,31,43,0,30,26,4,1,1,0,0,0,1
"2011","E00011372","E00011372","Total",93,47,21,26,0,40,38,2,5,5,0,0,0,1
"2011","E00011370","E00011370","Total",128,68,24,44,1,49,41,8,8,7,0,1,0,2
"2011","E00011374","E00011374","Total",132,57,30,27,1,68,65,3,4,4,0,0,0,2
"2011","E00011376","E00011376","Total",120,80,33,47,0,31,27,4,8,6,1,1,0,1
"2011","E00011377","E00011377","Total",133,75,31,44,2,43,40,3,11,11,0,0,0,2
"2011","E00011378","E00011378","Total",118,32,14,18,1,83,80,3,2,2,0,0,0,0
"2011","E00011550","E00011550","Total",115,105,90,15,0,2,2,0,6,5,0,1,0,2
"2011","E00011551","E00011551","Total",123,115,88,27,0,2,2,0,5,5,0,0,0,1
"2011","E00011552","E00011552","Total",144,78,31,47,0,60,49,11,4,3,0,1,0,2
"2011","E00011553","E00011553","Total",143,85,26,59,1,44,42,2,11,8,1,2,0,2
"2011","E00011555","E00011555","Total",117,56,26,30,0,55,49,6,5,5,0,0,0,1
"2011","E00011554","E00011554","Total",149,55,23,32,0,84,75,9,9,9,0,0,0,1
"2011","E00011556","E00011556","Total",100,74,45,29,7,4,4,0,15,14,0,1,0,0
"2011","E00011557","E00011557","Total",127,78,37,41,4,29,26,3,15,15,0,0,0,1
"2011","E00011558","E00011558","Total",127,69,29,40,1,40,35,5,14,14,0,0,0,3
"2011","E00011560","E00011560","Total",127,71,28,43,0,45,41,4,9,9,0,0,0,2
"2011","E00011362","E00011362","Total",137,48,21,27,4,75,70,5,7,7,0,0,0,3
"2011","E00011389","E00011389","Total",112,104,48,56,0,1,0,1,7,7,0,0,0,0
"2011","E00011397","E00011397","Total",115,42,11,31,0,65,63,2,6,6,0,0,0,2
"2011","E00011399","E00011399","Total",109,36,12,24,0,63,61,2,8,8,0,0,0,2
"2011","E00011401","E00011401","Total",135,86,41,45,0,42,40,2,6,5,0,1,0,1
"2011","E00011373","E00011373","Total",118,87,35,52,0,22,20,2,8,5,0,3,0,1
"2011","E00011375","E00011375","Total",144,68,23,45,1,58,54,4,16,16,0,0,0,1
"2011","E00011384","E00011384","Total",127,74,26,48,1,42,35,7,10,8,0,2,0,0
"2011","E00011385","E00011385","Total",126,76,29,47,1,34,28,6,12,12,0,0,0,3
"2011","E00011393","E00011393","Total",119,62,22,40,1,48,46,2,8,7,0,1,0,0
"2011","E00011363","E00011363","Total",162,61,21,40,1,83,80,3,12,11,0,1,0,5
"2011","E00011382","E00011382","Total",120,16,2,14,0,88,87,1,15,13,0,2,0,1
"2011","E00011383","E00011383","Total",84,55,21,34,0,11,11,0,18,16,0,2,0,0
"2011","E00011387","E00011387","Total",123,26,9,17,1,80,77,3,13,10,0,2,1,3
"2011","E00011390","E00011390","Total",128,78,28,50,0,39,32,7,9,7,0,2,0,2
"2011","E00011395","E00011395","Total",139,14,5,9,0,113,110,3,10,9,0,1,0,2
"2011","E00011365","E00011365","Total",117,72,30,42,0,35,35,0,8,7,0,1,0,2
"2011","E00011404","E00011404","Total",134,38,17,21,2,86,37,49,4,3,0,1,0,4
"2011","E00011406","E00011406","Total",121,81,30,51,1,26,22,4,11,11,0,0,0,2
"2011","E00011409","E00011409","Total",113,73,23,50,1,26,24,2,11,9,0,2,0,2
"2011","E00011410","E00011410","Total",109,67,19,48,0,29,27,2,13,12,0,1,0,0
"2011","E00011462","E00011462","Total",114,65,21,44,0,39,38,1,7,5,0,2,0,3
"2011","E00011464","E00011464","Total",115,87,39,48,2,20,20,0,6,6,0,0,0,0
"2011","E00011469","E00011469","Total",125,77,29,48,0,45,36,9,3,3,0,0,0,0
"2011","E00011477","E00011477","Total",190,122,31,91,0,48,32,16,17,16,0,0,1,3
"2011","E00011478","E00011478","Total",120,86,33,53,0,16,15,1,18,18,0,0,0,0
"2011","E00011510","E00011510","Total",110,94,47,47,1,6,5,1,8,7,0,1,0,1
"2011","E00011516","E00011516","Total",127,124,66,58,0,0,0,0,3,3,0,0,0,0
"2011","E00011517","E00011517","Total",112,97,51,46,1,11,11,0,2,2,0,0,0,1
"2011","E00011519","E00011519","Total",152,116,60,56,0,23,9,14,11,10,0,0,1,2
"2011","E00011527","E00011527","Total",126,109,64,45,1,4,4,0,11,11,0,0,0,1
"2011","E00011522","E00011522","Total",134,63,28,35,2,57,53,4,11,11,0,0,0,1
"2011","E00011524","E00011524","Total",120,61,25,36,0,45,45,0,14,11,0,3,0,0
"2011","E00011529","E00011529","Total",137,72,27,45,1,52,45,7,11,9,1,1,0,1
"2011","E00011530","E00011530","Total",147,109,52,57,1,25,15,10,11,9,0,1,1,1
"2011","E00166792","E00166792","Total",87,50,6,44,4,17,5,12,13,13,0,0,0,3
"2011","E00166793","E00166793","Total",118,59,17,42,3,41,17,24,15,13,0,2,0,0
"2011","E00166794","E00166794","Total",80,69,47,22,0,6,5,1,4,3,0,1,0,1
"2011","E00011495","E00011495","Total",130,102,53,49,0,11,10,1,11,7,0,3,1,6
"2011","E00011497","E00011497","Total",145,125,79,46,1,12,4,8,5,4,0,1,0,2
"2011","E00011511","E00011511","Total",127,99,54,45,0,13,10,3,13,13,0,0,0,2
"2011","E00011531","E00011531","Total",122,97,41,56,0,11,9,2,12,10,0,0,2,2
"2011","E00011494","E00011494","Total",122,51,13,38,1,61,57,4,7,7,0,0,0,2
"2011","E00011506","E00011506","Total",130,33,10,23,0,86,76,10,10,8,0,2,0,1
"2011","E00011509","E00011509","Total",126,68,23,45,1,51,44,7,3,3,0,0,0,3
"2011","E00011513","E00011513","Total",107,42,10,32,0,60,54,6,4,4,0,0,0,1
"2011","E00011515","E00011515","Total",140,79,34,45,2,51,44,7,7,7,0,0,0,1
"2011","E00011500","E00011500","Total",135,95,39,56,0,28,23,5,11,11,0,0,0,1
"2011","E00011501","E00011501","Total",135,67,28,39,0,59,51,8,5,5,0,0,0,4
"2011","E00011502","E00011502","Total",126,88,33,55,0,31,29,2,5,4,0,1,0,2
"2011","E00011504","E00011504","Total",121,79,31,48,0,28,28,0,12,10,0,2,0,2
"2011","E00011507","E00011507","Total",119,97,50,47,1,8,7,1,11,11,0,0,0,2
"2011","E00011361","E00011361","Total",124,58,26,32,0,54,49,5,11,10,1,0,0,1
"2011","E00011379","E00011379","Total",93,42,16,26,0,40,35,5,10,10,0,0,0,1
"2011","E00011380","E00011380","Total",104,25,9,16,0,72,68,4,7,6,0,0,1,0
"2011","E00011381","E00011381","Total",118,61,28,33,1,42,39,3,12,12,0,0,0,2
"2011","E00011386","E00011386","Total",106,8,0,8,0,88,85,3,8,7,0,1,0,2
"2011","E00011388","E00011388","Total",76,32,7,25,0,38,33,5,6,6,0,0,0,0
"2011","E00011391","E00011391","Total",113,56,20,36,0,44,41,3,13,10,1,1,1,0
"2011","E00011392","E00011392","Total",110,12,2,10,0,88,85,3,10,9,1,0,0,0
"2011","E00011394","E00011394","Total",121,58,23,35,1,51,48,3,6,6,0,0,0,5
"2011","E00011396","E00011396","Total",126,24,5,19,1,91,90,1,8,8,0,0,0,2
"2011","E00011400","E00011400","Total",87,17,5,12,0,58,55,3,10,7,0,2,1,2
"2011","E00011403","E00011403","Total",111,44,15,29,0,57,57,0,9,7,0,1,1,1
"2011","E00011364","E00011364","Total",118,59,13,46,0,52,49,3,6,6,0,0,0,1
"2011","E00011398","E00011398","Total",122,72,27,45,1,36,35,1,11,10,0,1,0,2
"2011","E00011402","E00011402","Total",166,92,24,68,6,57,45,12,10,8,0,2,0,1
"2011","E00011405","E00011405","Total",128,90,35,55,0,26,24,2,11,10,0,1,0,1
"2011","E00011407","E00011407","Total",117,42,10,32,1,62,57,5,11,11,0,0,0,1
"2011","E00011408","E00011408","Total",114,82,32,50,0,28,27,1,3,3,0,0,0,1
"2011","E00011465","E00011465","Total",136,44,16,28,0,83,81,2,8,8,0,0,0,1
"2011","E00011468","E00011468","Total",121,40,17,23,0,70,68,2,10,10,0,0,0,1
"2011","E00011470","E00011470","Total",137,34,7,27,0,79,78,1,23,20,0,3,0,1
"2011","E00011471","E00011471","Total",132,42,18,24,1,79,67,12,9,8,0,1,0,1
"2011","E00011473","E00011473","Total",144,81,28,53,0,57,53,4,5,3,0,2,0,1
"2011","E00011532","E00011532","Total",128,44,14,30,0,77,69,8,6,6,0,0,0,1
"2011","E00011533","E00011533","Total",128,51,11,40,0,67,59,8,8,8,0,0,0,2
"2011","E00011561","E00011561","Total",139,62,21,41,0,59,54,5,14,13,0,1,0,4
"2011","E00011562","E00011562","Total",109,50,15,35,0,53,48,5,4,4,0,0,0,2
"2011","E00011565","E00011565","Total",119,52,18,34,0,57,53,4,8,7,0,1,0,2
"2011","E00011534","E00011534","Total",113,38,8,30,0,57,56,1,17,13,0,3,1,1
"2011","E00011536","E00011536","Total",132,36,10,26,0,89,78,11,7,7,0,0,0,0
"2011","E00011541","E00011541","Total",118,53,22,31,0,57,56,1,7,6,0,0,1,1
"2011","E00011566","E00011566","Total",113,55,23,32,0,46,44,2,12,11,0,1,0,0
"2011","E00011569","E00011569","Total",127,31,11,20,0,90,88,2,6,6,0,0,0,0
"2011","E00011571","E00011571","Total",137,28,6,22,1,99,96,3,8,5,0,1,2,1
"2011","E00011518","E00011518","Total",125,79,33,46,1,37,16,21,8,8,0,0,0,0
"2011","E00011520","E00011520","Total",105,96,48,48,0,3,2,1,5,5,0,0,0,1
"2011","E00011523","E00011523","Total",123,111,49,62,0,1,0,1,10,10,0,0,0,1
"2011","E00011525","E00011525","Total",106,90,34,56,0,5,2,3,10,10,0,0,0,1
"2011","E00011526","E00011526","Total",139,116,57,59,2,2,2,0,18,14,3,1,0,1
"2011","E00011493","E00011493","Total",130,110,44,66,0,11,5,6,8,8,0,0,0,1
"2011","E00011496","E00011496","Total",121,77,38,39,0,30,28,2,10,8,0,1,1,4
"2011","E00011498","E00011498","Total",118,103,55,48,1,7,5,2,6,6,0,0,0,1
"2011","E00011499","E00011499","Total",123,115,51,64,0,2,2,0,6,6,0,0,0,0
"2011","E00011503","E00011503","Total",116,88,54,34,0,18,18,0,8,8,0,0,0,2
"2011","E00011505","E00011505","Total",125,107,46,61,1,7,5,2,10,10,0,0,0,0
"2011","E00011508","E00011508","Total",172,125,53,72,5,21,19,2,19,19,0,0,0,2
"2011","E00011512","E00011512","Total",116,46,22,24,1,55,42,13,13,12,0,1,0,1
"2011","E00011521","E00011521","Total",134,110,52,58,0,9,7,2,15,13,0,2,0,0
"2011","E00011528","E00011528","Total",123,64,32,32,0,46,26,20,12,12,0,0,0,1
"2011","E00011613","E00011613","Total",130,80,34,46,0,42,41,1,7,7,0,0,0,1
"2011","E00011622","E00011622","Total",119,62,28,34,1,7,6,1,42,41,1,0,0,7
"2011","E00011626","E00011626","Total",132,101,63,38,7,4,2,2,20,20,0,0,0,0
"2011","E00011627","E00011627","Total",118,104,46,58,1,7,4,3,5,5,0,0,0,1
"2011","E00011630","E00011630","Total",128,109,47,62,0,2,2,0,14,12,0,2,0,3
"2011","E00011615","E00011615","Total",92,80,31,49,0,3,3,0,9,8,0,1,0,0
"2011","E00011616","E00011616","Total",125,95,50,45,0,23,20,3,5,4,0,1,0,2
"2011","E00011617","E00011617","Total",127,102,52,50,0,11,10,1,12,10,0,2,0,2
"2011","E00011619","E00011619","Total",130,121,50,71,0,1,0,1,7,6,0,0,1,1
"2011","E00011621","E00011621","Total",122,101,60,41,0,1,1,0,17,15,0,1,1,3
"2011","E00011535","E00011535","Total",119,40,16,24,0,69,60,9,9,8,0,1,0,1
"2011","E00011538","E00011538","Total",139,106,52,54,3,11,10,1,19,18,1,0,0,0
"2011","E00011540","E00011540","Total",119,103,71,32,0,7,7,0,9,7,0,2,0,0
"2011","E00011545","E00011545","Total",139,103,45,58,0,15,15,0,19,17,0,2,0,2
"2011","E00011570","E00011570","Total",135,61,34,27,1,68,63,5,3,3,0,0,0,2
"2011","E00011537","E00011537","Total",193,67,22,45,1,104,42,62,21,20,0,1,0,0
"2011","E00011543","E00011543","Total",129,58,13,45,0,61,56,5,9,9,0,0,0,1
"2011","E00011544","E00011544","Total",121,66,26,40,1,46,42,4,7,7,0,0,0,1
"2011","E00011546","E00011546","Total",147,67,20,47,1,59,56,3,19,17,0,0,2,1
"2011","E00011549","E00011549","Total",122,77,33,44,4,31,20,11,9,8,0,0,1,1
"2011","E00011539","E00011539","Total",133,76,23,53,0,49,42,7,5,5,0,0,0,3
"2011","E00011542","E00011542","Total",134,81,29,52,1,42,41,1,8,7,0,1,0,2
"2011","E00011547","E00011547","Total",135,91,35,56,0,37,29,8,7,7,0,0,0,0
"2011","E00011548","E00011548","Total",128,57,21,36,4,53,50,3,13,11,0,2,0,1
"2011","E00011559","E00011559","Total",138,106,42,64,2,9,8,1,20,15,1,3,1,1
"2011","E00011563","E00011563","Total",127,76,29,47,0,29,24,5,21,21,0,0,0,1
"2011","E00011564","E00011564","Total",124,100,31,69,0,12,8,4,11,10,0,1,0,1
"2011","E00011567","E00011567","Total",130,56,16,40,1,59,57,2,14,11,0,1,2,0
"2011","E00011568","E00011568","Total",122,85,40,45,1,27,24,3,9,8,0,1,0,0
"2011","E00011572","E00011572","Total",130,61,16,45,1,60,59,1,8,8,0,0,0,0
"2011","E00011455","E00011455","Total",134,85,28,57,1,12,2,10,35,35,0,0,0,1
"2011","E00011479","E00011479","Total",116,107,56,51,0,1,0,1,8,8,0,0,0,0
"2011","E00011488","E00011488","Total",111,88,35,53,0,3,1,2,20,19,0,1,0,0
"2011","E00011489","E00011489","Total",158,59,17,42,0,23,7,16,75,68,1,3,3,1
"2011","E00011490","E00011490","Total",122,88,36,52,0,8,5,3,25,25,0,0,0,1
"2011","E00011491","E00011491","Total",160,114,30,84,1,16,1,15,28,27,0,1,0,1
"2011","E00011451","E00011451","Total",129,96,44,52,0,14,9,5,18,18,0,0,0,1
"2011","E00011454","E00011454","Total",121,61,31,30,0,43,20,23,16,14,0,1,1,1
"2011","E00011458","E00011458","Total",117,105,58,47,1,5,5,0,4,4,0,0,0,2
"2011","E00011487","E00011487","Total",128,114,57,57,0,3,2,1,9,9,0,0,0,2
"2011","E00011492","E00011492","Total",131,119,67,52,0,6,6,0,5,4,0,1,0,1
"2011","E00011452","E00011452","Total",96,87,49,38,0,0,0,0,7,7,0,0,0,2
"2011","E00011461","E00011461","Total",124,120,66,54,0,1,1,0,2,2,0,0,0,1
"2011","E00011463","E00011463","Total",123,114,64,50,0,3,3,0,5,5,0,0,0,1
"2011","E00011466","E00011466","Total",112,96,52,44,0,5,5,0,11,11,0,0,0,0
"2011","E00011467","E00011467","Total",124,113,61,52,0,5,2,3,6,4,0,2,0,0
"2011","E00011476","E00011476","Total",112,75,42,33,0,26,0,26,10,9,0,1,0,1
"2011","E00011472","E00011472","Total",124,116,72,44,1,2,2,0,4,4,0,0,0,1
"2011","E00011474","E00011474","Total",139,103,45,58,0,28,0,28,6,6,0,0,0,2
"2011","E00011475","E00011475","Total",122,102,58,44,1,9,4,5,9,6,0,3,0,1
"2011","E00011482","E00011482","Total",142,121,58,63,1,4,2,2,14,13,0,1,0,2
"2011","E00011483","E00011483","Total",127,107,49,58,0,4,3,1,16,16,0,0,0,0
"2011","E00011450","E00011450","Total",130,115,79,36,0,3,1,2,11,11,0,0,0,1
"2011","E00011480","E00011480","Total",104,84,39,45,0,13,12,1,6,4,0,2,0,1
"2011","E00011481","E00011481","Total",131,84,28,56,0,1,0,1,46,45,0,1,0,0
"2011","E00011484","E00011484","Total",111,60,34,26,0,35,31,4,15,13,1,1,0,1
"2011","E00011485","E00011485","Total",118,112,78,34,0,1,0,1,5,5,0,0,0,0
"2011","E00011486","E00011486","Total",121,107,55,52,0,3,2,1,11,11,0,0,0,0
"2011","E00011652","E00011652","Total",113,108,64,44,0,1,1,0,4,3,0,1,0,0
"2011","E00011682","E00011682","Total",159,144,69,75,0,2,2,0,13,11,0,2,0,0
"2011","E00011685","E00011685","Total",124,118,66,52,0,0,0,0,6,6,0,0,0,0
"2011","E00011687","E00011687","Total",120,114,75,39,0,1,1,0,5,5,0,0,0,0
"2011","E00011657","E00011657","Total",135,131,71,60,0,1,1,0,2,2,0,0,0,1
"2011","E00011660","E00011660","Total",129,121,78,43,0,4,4,0,4,3,0,1,0,0
"2011","E00011669","E00011669","Total",137,118,65,53,0,10,10,0,7,7,0,0,0,2
"2011","E00011688","E00011688","Total",121,117,70,47,0,0,0,0,3,3,0,0,0,1
"2011","E00011689","E00011689","Total",152,137,66,71,1,0,0,0,13,13,0,0,0,1
"2011","E00011653","E00011653","Total",111,105,57,48,0,4,4,0,2,2,0,0,0,0
"2011","E00011655","E00011655","Total",129,119,48,71,0,6,5,1,3,3,0,0,0,1
"2011","E00011666","E00011666","Total",131,128,69,59,0,1,1,0,2,2,0,0,0,0
"2011","E00011686","E00011686","Total",119,107,62,45,0,0,0,0,11,10,0,1,0,1
"2011","E00011691","E00011691","Total",122,91,46,45,0,6,6,0,25,24,0,1,0,0
"2011","E00011670","E00011670","Total",119,104,48,56,0,4,4,0,10,9,0,1,0,1
"2011","E00011672","E00011672","Total",112,108,51,57,0,2,2,0,2,2,0,0,0,0
"2011","E00011673","E00011673","Total",127,122,66,56,0,1,1,0,1,1,0,0,0,3
"2011","E00011675","E00011675","Total",118,113,69,44,0,1,1,0,3,2,0,1,0,1
"2011","E00011678","E00011678","Total",126,118,68,50,1,1,1,0,5,5,0,0,0,1
"2011","E00011680","E00011680","Total",136,131,83,48,0,2,2,0,2,2,0,0,0,1
"2011","E00011681","E00011681","Total",147,141,74,67,0,2,1,1,4,3,0,1,0,0
"2011","E00011683","E00011683","Total",140,130,78,52,0,3,3,0,7,6,0,1,0,0
"2011","E00011684","E00011684","Total",134,134,73,61,0,0,0,0,0,0,0,0,0,0
"2011","E00011612","E00011612","Total",117,109,57,52,1,1,1,0,4,3,0,1,0,2
"2011","E00011629","E00011629","Total",124,91,47,44,0,23,23,0,9,8,1,0,0,1
"2011","E00011631","E00011631","Total",117,101,41,60,0,5,5,0,10,10,0,0,0,1
"2011","E00011633","E00011633","Total",118,95,42,53,1,10,8,2,10,10,0,0,0,2
"2011","E00011635","E00011635","Total",119,111,51,60,0,2,2,0,6,6,0,0,0,0
"2011","E00011614","E00011614","Total",116,108,49,59,0,1,1,0,4,3,0,1,0,3
"2011","E00011638","E00011638","Total",115,109,54,55,0,0,0,0,4,4,0,0,0,2
"2011","E00011639","E00011639","Total",133,119,51,68,2,6,6,0,6,5,0,1,0,0
"2011","E00011640","E00011640","Total",136,117,54,63,0,9,9,0,10,10,0,0,0,0
"2011","E00011641","E00011641","Total",142,108,44,64,1,5,4,1,26,24,0,2,0,2
"2011","E00011618","E00011618","Total",139,131,71,60,0,1,1,0,6,6,0,0,0,1
"2011","E00011620","E00011620","Total",133,93,44,49,0,23,22,1,17,17,0,0,0,0
"2011","E00011623","E00011623","Total",126,115,59,56,0,2,1,1,9,9,0,0,0,0
"2011","E00011624","E00011624","Total",145,128,51,77,1,4,2,2,10,10,0,0,0,2
"2011","E00011628","E00011628","Total",140,92,36,56,0,33,28,5,15,14,0,0,1,0
"2011","E00011654","E00011654","Total",120,88,45,43,0,12,9,3,20,17,0,3,0,0
"2011","E00011658","E00011658","Total",126,121,55,66,0,0,0,0,5,4,0,1,0,0
"2011","E00011661","E00011661","Total",103,34,15,19,0,60,58,2,8,8,0,0,0,1
"2011","E00011662","E00011662","Total",132,61,28,33,0,59,58,1,11,10,0,0,1,1
"2011","E00011690","E00011690","Total",111,95,48,47,2,10,10,0,4,3,0,1,0,0
"2011","E00011663","E00011663","Total",141,129,55,74,1,1,1,0,10,9,1,0,0,0
"2011","E00011665","E00011665","Total",126,104,56,48,0,3,3,0,17,16,0,1,0,2
"2011","E00011667","E00011667","Total",126,120,63,57,1,0,0,0,5,5,0,0,0,0
"2011","E00011671","E00011671","Total",130,96,39,57,0,9,3,6,25,24,0,1,0,0
"2011","E00011674","E00011674","Total",119,110,57,53,1,3,3,0,4,3,0,1,0,1
"2011","E00011676","E00011676","Total",128,109,47,62,0,4,3,1,14,13,0,1,0,1
"2011","E00011677","E00011677","Total",135,117,52,65,0,0,0,0,17,16,0,1,0,1
"2011","E00011679","E00011679","Total",127,109,54,55,0,3,3,0,13,12,0,1,0,2
"2011","E00011343","E00011343","Total",126,108,56,52,1,11,10,1,4,3,0,1,0,2
"2011","E00011344","E00011344","Total",127,118,57,61,1,0,0,0,8,6,0,2,0,0
"2011","E00011345","E00011345","Total",138,102,47,55,1,25,22,3,8,6,0,2,0,2
"2011","E00011346","E00011346","Total",128,121,76,45,1,4,3,1,2,2,0,0,0,0
"2011","E00011347","E00011347","Total",178,149,66,83,0,11,2,9,17,17,0,0,0,1
"2011","E00011350","E00011350","Total",122,116,58,58,0,0,0,0,5,4,0,1,0,1
"2011","E00011351","E00011351","Total",119,114,60,54,0,0,0,0,4,4,0,0,0,1
"2011","E00011352","E00011352","Total",132,120,64,56,0,1,0,1,10,10,0,0,0,1
"2011","E00011356","E00011356","Total",127,117,48,69,0,1,0,1,9,9,0,0,0,0
"2011","E00011453","E00011453","Total",133,104,58,46,0,8,6,2,20,20,0,0,0,1
"2011","E00011456","E00011456","Total",123,71,37,34,2,42,37,5,6,5,0,0,1,2
"2011","E00011457","E00011457","Total",176,131,26,105,1,10,0,10,33,32,0,1,0,1
"2011","E00011459","E00011459","Total",125,113,55,58,0,1,1,0,10,10,0,0,0,1
"2011","E00011460","E00011460","Total",113,86,36,50,0,5,5,0,21,19,0,2,0,1
"2011","E00011865","E00011865","Total",156,140,63,77,0,5,3,2,11,11,0,0,0,0
"2011","E00011867","E00011867","Total",155,101,49,52,1,36,3,33,14,12,0,2,0,3
"2011","E00011869","E00011869","Total",132,93,44,49,0,3,3,0,32,28,2,1,1,4
"2011","E00011878","E00011878","Total",132,111,45,66,1,2,1,1,17,15,0,2,0,1
"2011","E00011899","E00011899","Total",136,87,36,51,0,36,3,33,13,11,0,1,1,0
"2011","E00011862","E00011862","Total",113,100,33,67,0,2,0,2,11,10,0,1,0,0
"2011","E00011868","E00011868","Total",116,107,43,64,0,3,2,1,5,5,0,0,0,1
"2011","E00011873","E00011873","Total",129,114,46,68,0,7,0,7,8,8,0,0,0,0
"2011","E00011875","E00011875","Total",127,116,50,66,0,1,1,0,9,9,0,0,0,1
"2011","E00011880","E00011880","Total",119,113,46,67,0,1,0,1,5,4,1,0,0,0
"2011","E00011893","E00011893","Total",152,114,59,55,17,2,2,0,17,16,0,0,1,2
"2011","E00011894","E00011894","Total",130,123,54,69,1,1,1,0,4,4,0,0,0,1
"2011","E00011896","E00011896","Total",126,119,48,71,0,3,2,1,4,4,0,0,0,0
"2011","E00011897","E00011897","Total",136,105,60,45,3,12,4,8,16,15,0,1,0,0
"2011","E00011898","E00011898","Total",115,106,49,57,0,3,3,0,4,3,0,1,0,2
"2011","E00011217","E00011217","Total",112,90,37,53,0,3,2,1,19,19,0,0,0,0
"2011","E00011224","E00011224","Total",125,78,23,55,7,9,6,3,30,29,0,1,0,1
"2011","E00011225","E00011225","Total",120,84,33,51,0,13,4,9,22,22,0,0,0,1
"2011","E00011226","E00011226","Total",121,100,40,60,0,3,3,0,17,17,0,0,0,1
"2011","E00166778","E00166778","Total",166,71,21,50,3,53,2,51,35,32,0,2,1,4
"2011","E00166791","E00166791","Total",105,67,19,48,4,7,1,6,24,23,0,1,0,3
"2011","E00011214","E00011214","Total",120,88,34,54,1,11,9,2,17,16,0,0,1,3
"2011","E00011218","E00011218","Total",121,51,24,27,0,58,56,2,10,9,0,1,0,2
"2011","E00011220","E00011220","Total",132,102,40,62,3,4,3,1,22,21,0,1,0,1
"2011","E00011221","E00011221","Total",138,107,36,71,0,6,3,3,24,23,0,1,0,1
"2011","E00011222","E00011222","Total",119,89,27,62,1,8,8,0,20,16,0,4,0,1
"2011","E00011625","E00011625","Total",121,54,26,28,2,49,41,8,16,15,0,1,0,0
"2011","E00011632","E00011632","Total",138,88,49,39,0,43,41,2,6,6,0,0,0,1
"2011","E00011634","E00011634","Total",111,46,24,22,0,55,48,7,10,10,0,0,0,0
"2011","E00011636","E00011636","Total",127,101,42,59,1,13,13,0,12,12,0,0,0,0
"2011","E00011637","E00011637","Total",140,55,30,25,0,73,71,2,11,11,0,0,0,1
"2011","E00011643","E00011643","Total",118,92,52,40,1,15,14,1,10,10,0,0,0,0
"2011","E00011642","E00011642","Total",118,106,50,56,0,6,5,1,6,4,0,1,1,0
"2011","E00011645","E00011645","Total",124,107,43,64,1,4,3,1,11,10,0,1,0,1
"2011","E00011647","E00011647","Total",122,114,59,55,0,1,1,0,7,7,0,0,0,0
"2011","E00011649","E00011649","Total",145,124,54,70,1,7,7,0,11,10,0,1,0,2
"2011","E00011651","E00011651","Total",134,100,40,60,2,5,5,0,26,26,0,0,0,1
"2011","E00011611","E00011611","Total",151,97,33,64,0,9,9,0,44,43,0,1,0,1
"2011","E00011644","E00011644","Total",121,100,46,54,1,15,12,3,5,5,0,0,0,0
"2011","E00011646","E00011646","Total",182,141,63,78,0,26,12,14,15,15,0,0,0,0
"2011","E00011648","E00011648","Total",151,120,59,61,1,18,5,13,11,11,0,0,0,1
"2011","E00011650","E00011650","Total",132,72,31,41,2,35,35,0,22,22,0,0,0,1
"2011","E00011656","E00011656","Total",126,98,44,54,0,6,3,3,18,18,0,0,0,4
"2011","E00011659","E00011659","Total",132,127,66,61,0,0,0,0,5,5,0,0,0,0
"2011","E00011664","E00011664","Total",118,52,36,16,0,54,39,15,10,10,0,0,0,2
"2011","E00011668","E00011668","Total",136,130,59,71,0,1,1,0,5,4,0,1,0,0
"2011","E00011735","E00011735","Total",111,107,61,46,0,0,0,0,4,4,0,0,0,0
"2011","E00011737","E00011737","Total",93,70,32,38,0,0,0,0,22,19,0,3,0,1
"2011","E00011739","E00011739","Total",123,107,57,50,0,2,0,2,12,11,0,1,0,2
"2011","E00011740","E00011740","Total",125,108,63,45,0,3,3,0,13,12,0,1,0,1
"2011","E00011741","E00011741","Total",109,106,57,49,0,0,0,0,3,3,0,0,0,0
"2011","E00011864","E00011864","Total",119,118,58,60,0,0,0,0,1,1,0,0,0,0
"2011","E00011866","E00011866","Total",123,117,58,59,0,2,1,1,4,4,0,0,0,0
"2011","E00011895","E00011895","Total",144,125,60,65,0,1,0,1,18,18,0,0,0,0
"2011","E00011900","E00011900","Total",134,119,38,81,1,2,1,1,12,12,0,0,0,0
"2011","E00011870","E00011870","Total",142,121,55,66,0,1,1,0,19,18,0,1,0,1
"2011","E00011871","E00011871","Total",134,102,69,33,0,6,4,2,23,21,1,1,0,3
"2011","E00011876","E00011876","Total",135,88,48,40,0,4,4,0,43,41,1,1,0,0
"2011","E00011883","E00011883","Total",112,79,49,30,0,4,1,3,26,22,1,3,0,3
"2011","E00011886","E00011886","Total",136,98,36,62,0,2,0,2,36,34,0,2,0,0
"2011","E00011874","E00011874","Total",114,40,12,28,0,50,50,0,24,23,0,1,0,0
"2011","E00011879","E00011879","Total",154,150,83,67,0,1,1,0,2,2,0,0,0,1
"2011","E00011882","E00011882","Total",117,98,61,37,1,5,4,1,13,13,0,0,0,0
"2011","E00166773","E00166773","Total",187,69,14,55,5,38,37,1,74,71,0,3,0,1
"2011","E00166775","E00166775","Total",153,70,8,62,15,23,18,5,43,40,0,3,0,2
"2011","E00166795","E00166795","Total",183,88,24,64,1,6,6,0,87,84,0,3,0,1
"2011","E00166796","E00166796","Total",128,22,9,13,0,89,87,2,15,14,0,0,1,2
"2011","E00011863","E00011863","Total",111,103,50,53,0,1,0,1,6,6,0,0,0,1
"2011","E00011881","E00011881","Total",137,128,66,62,0,2,2,0,7,7,0,0,0,0
"2011","E00011884","E00011884","Total",115,50,20,30,0,45,1,44,19,19,0,0,0,1
"2011","E00011887","E00011887","Total",149,65,26,39,11,52,3,49,17,17,0,0,0,4
"2011","E00011888","E00011888","Total",133,125,80,45,0,1,1,0,6,6,0,0,0,1
"2011","E00011215","E00011215","Total",205,90,29,61,3,50,10,40,61,59,1,1,0,1
"2011","E00011216","E00011216","Total",150,18,3,15,0,125,7,118,6,6,0,0,0,1
"2011","E00011219","E00011219","Total",214,90,29,61,22,23,17,6,75,73,0,2,0,4
"2011","E00011223","E00011223","Total",146,86,34,52,0,12,7,5,48,45,0,2,1,0
"2011","E00011228","E00011228","Total",132,16,7,9,0,108,104,4,6,6,0,0,0,2
"2011","E00011732","E00011732","Total",124,113,70,43,0,3,1,2,8,8,0,0,0,0
"2011","E00011734","E00011734","Total",115,108,60,48,0,1,0,1,4,4,0,0,0,2
"2011","E00011736","E00011736","Total",168,126,54,72,0,23,5,18,17,16,1,0,0,2
"2011","E00011743","E00011743","Total",150,103,48,55,2,8,6,2,37,34,0,3,0,0
"2011","E00166776","E00166776","Total",102,34,8,26,3,18,16,2,47,46,0,1,0,0
"2011","E00166777","E00166777","Total",107,16,7,9,1,66,27,39,21,19,0,1,1,3
"2011","E00166779","E00166779","Total",66,8,2,6,30,11,1,10,17,17,0,0,0,0
"2011","E00011760","E00011760","Total",137,24,12,12,0,86,78,8,26,25,0,1,0,1
"2011","E00011763","E00011763","Total",230,84,49,35,1,49,44,5,91,91,0,0,0,5
"2011","E00011764","E00011764","Total",129,71,31,40,2,18,16,2,37,36,0,1,0,1
"2011","E00011765","E00011765","Total",153,108,36,72,0,16,13,3,27,24,0,3,0,2
"2011","E00166785","E00166785","Total",134,12,2,10,1,98,89,9,20,19,0,1,0,3
"2011","E00166786","E00166786","Total",136,29,2,27,0,46,9,37,61,59,0,2,0,0
"2011","E00166788","E00166788","Total",118,15,2,13,7,54,4,50,42,40,0,1,1,0
"2011","E00011753","E00011753","Total",191,48,25,23,4,40,5,35,97,94,0,3,0,2
"2011","E00166781","E00166781","Total",196,69,11,58,42,20,3,17,63,61,0,1,1,2
"2011","E00166782","E00166782","Total",103,55,41,14,2,5,2,3,41,38,1,1,1,0
"2011","E00166787","E00166787","Total",173,49,6,43,37,33,3,30,54,54,0,0,0,0
"2011","E00011746","E00011746","Total",138,120,46,74,1,2,1,1,15,12,0,3,0,0
"2011","E00011749","E00011749","Total",121,86,42,44,2,5,3,2,25,23,0,2,0,3
"2011","E00011750","E00011750","Total",136,71,41,30,0,37,2,35,26,23,0,3,0,2
"2011","E00011756","E00011756","Total",128,63,19,44,0,20,3,17,45,42,0,3,0,0
"2011","E00166783","E00166783","Total",121,65,51,14,2,11,4,7,43,39,0,4,0,0
"2011","E00011329","E00011329","Total",127,111,55,56,1,4,4,0,11,7,2,2,0,0
"2011","E00011354","E00011354","Total",139,126,59,67,0,4,1,3,8,7,0,1,0,1
"2011","E00011358","E00011358","Total",126,121,65,56,0,1,0,1,2,2,0,0,0,2
"2011","E00011359","E00011359","Total",144,122,67,55,0,1,0,1,21,21,0,0,0,0
"2011","E00011327","E00011327","Total",128,111,60,51,1,4,3,1,11,8,0,3,0,1
"2011","E00011328","E00011328","Total",115,105,56,49,1,0,0,0,9,9,0,0,0,0
"2011","E00011330","E00011330","Total",128,116,56,60,0,2,1,1,9,9,0,0,0,1
"2011","E00011331","E00011331","Total",174,132,62,70,0,0,0,0,41,39,0,2,0,1
"2011","E00011334","E00011334","Total",147,141,77,64,0,2,1,1,3,2,0,1,0,1
"2011","E00011575","E00011575","Total",128,122,68,54,0,0,0,0,6,6,0,0,0,0
"2011","E00011602","E00011602","Total",122,111,65,46,1,7,6,1,3,3,0,0,0,0
"2011","E00011603","E00011603","Total",152,141,58,83,1,7,4,3,3,2,1,0,0,0
"2011","E00011606","E00011606","Total",142,133,56,77,1,1,1,0,7,7,0,0,0,0
"2011","E00011578","E00011578","Total",129,122,59,63,0,3,2,1,4,4,0,0,0,0
"2011","E00011581","E00011581","Total",124,118,75,43,0,2,2,0,3,2,0,1,0,1
"2011","E00011582","E00011582","Total",140,130,69,61,0,0,0,0,9,9,0,0,0,1
"2011","E00011604","E00011604","Total",88,67,41,26,0,16,15,1,5,4,0,1,0,0
"2011","E00011605","E00011605","Total",133,120,60,60,0,1,1,0,12,12,0,0,0,0
"2011","E00011744","E00011744","Total",121,112,57,55,0,1,1,0,8,6,0,2,0,0
"2011","E00011745","E00011745","Total",133,123,67,56,0,3,1,2,7,6,0,1,0,0
"2011","E00011747","E00011747","Total",105,89,39,50,0,3,1,2,13,12,0,1,0,0
"2011","E00011748","E00011748","Total",102,96,45,51,0,0,0,0,5,5,0,0,0,1
"2011","E00011751","E00011751","Total",113,105,40,65,0,3,3,0,4,4,0,0,0,1
"2011","E00011885","E00011885","Total",116,110,56,54,0,1,0,1,4,4,0,0,0,1
"2011","E00011889","E00011889","Total",247,140,50,90,0,30,17,13,75,70,0,4,1,2
"2011","E00011890","E00011890","Total",106,90,38,52,0,0,0,0,16,15,0,1,0,0
"2011","E00011891","E00011891","Total",165,111,52,59,2,12,2,10,38,37,0,1,0,2
"2011","E00011892","E00011892","Total",131,118,51,67,0,0,0,0,12,11,0,1,0,1
"2011","E00011332","E00011332","Total",136,63,48,15,0,51,1,50,18,17,0,0,1,4
"2011","E00011333","E00011333","Total",132,130,64,66,0,0,0,0,2,2,0,0,0,0
"2011","E00011349","E00011349","Total",114,64,35,29,0,46,1,45,4,4,0,0,0,0
"2011","E00011353","E00011353","Total",127,116,64,52,0,1,0,1,9,8,1,0,0,1
"2011","E00011355","E00011355","Total",125,121,58,63,0,0,0,0,4,4,0,0,0,0
"2011","E00011326","E00011326","Total",125,120,73,47,0,2,1,1,2,2,0,0,0,1
"2011","E00011348","E00011348","Total",129,124,71,53,0,0,0,0,3,3,0,0,0,2
"2011","E00011357","E00011357","Total",133,130,71,59,0,0,0,0,3,3,0,0,0,0
"2011","E00011360","E00011360","Total",128,118,62,56,0,0,0,0,6,5,0,1,0,4
"2011","E00011335","E00011335","Total",110,106,56,50,0,1,1,0,3,3,0,0,0,0
"2011","E00011337","E00011337","Total",129,123,77,46,0,0,0,0,5,5,0,0,0,1
"2011","E00011338","E00011338","Total",128,121,74,47,0,1,1,0,5,4,1,0,0,1
"2011","E00011341","E00011341","Total",123,115,62,53,0,1,0,1,7,7,0,0,0,0
"2011","E00011336","E00011336","Total",133,123,75,48,0,0,0,0,9,9,0,0,0,1
"2011","E00011339","E00011339","Total",117,110,59,51,1,2,1,1,4,3,0,1,0,0
"2011","E00011340","E00011340","Total",127,123,67,56,0,0,0,0,4,4,0,0,0,0
"2011","E00011342","E00011342","Total",140,132,86,46,0,2,2,0,5,5,0,0,0,1
"2011","E00011577","E00011577","Total",151,120,62,58,0,9,8,1,22,20,1,0,1,0
"2011","E00011580","E00011580","Total",110,19,11,8,0,83,82,1,7,7,0,0,0,1
"2011","E00011584","E00011584","Total",135,113,63,50,1,3,3,0,17,13,0,4,0,1
"2011","E00011586","E00011586","Total",124,104,41,63,0,4,2,2,14,12,0,2,0,2
"2011","E00011607","E00011607","Total",132,115,45,70,0,12,12,0,5,5,0,0,0,0
"2011","E00011733","E00011733","Total",137,67,34,33,1,16,15,1,53,50,0,3,0,0
"2011","E00011766","E00011766","Total",164,97,40,57,0,14,13,1,51,50,0,1,0,2
"2011","E00011769","E00011769","Total",138,51,23,28,0,56,55,1,27,27,0,0,0,4
"2011","E00011772","E00011772","Total",132,55,22,33,4,16,16,0,54,52,1,1,0,3
"2011","E00011773","E00011773","Total",140,101,31,70,0,4,0,4,35,35,0,0,0,0
"2011","E00011731","E00011731","Total",163,128,49,79,1,10,10,0,22,21,0,1,0,2
"2011","E00011770","E00011770","Total",123,90,30,60,1,2,2,0,30,30,0,0,0,0
"2011","E00011774","E00011774","Total",129,76,24,52,0,7,4,3,46,44,0,2,0,0
"2011","E00011775","E00011775","Total",125,102,43,59,1,3,2,1,18,18,0,0,0,1
"2011","E00011776","E00011776","Total",113,102,42,60,0,4,2,2,6,6,0,0,0,1
"2011","E00011754","E00011754","Total",116,84,36,48,0,6,4,2,25,24,0,1,0,1
"2011","E00011755","E00011755","Total",124,77,18,59,0,5,4,1,41,38,0,3,0,1
"2011","E00011757","E00011757","Total",118,70,28,42,1,11,0,11,35,35,0,0,0,1
"2011","E00011759","E00011759","Total",122,93,30,63,1,8,8,0,19,19,0,0,0,1
"2011","E00011767","E00011767","Total",127,82,23,59,1,16,16,0,28,27,0,1,0,0
"2011","E00011771","E00011771","Total",115,90,43,47,2,3,2,1,18,18,0,0,0,2
"2011","E00011730","E00011730","Total",150,99,32,67,1,20,3,17,29,28,0,1,0,1
"2011","E00011758","E00011758","Total",158,99,28,71,1,9,7,2,48,46,0,2,0,1
"2011","E00011761","E00011761","Total",145,93,24,69,2,15,15,0,34,32,0,2,0,1
"2011","E00011762","E00011762","Total",177,94,27,67,3,18,13,5,62,60,0,2,0,0
"2011","E00011768","E00011768","Total",161,103,27,76,1,3,2,1,51,47,0,2,2,3
"2011","E00011229","E00011229","Total",122,102,61,41,1,4,3,1,13,11,0,2,0,2
"2011","E00011231","E00011231","Total",132,108,53,55,0,3,3,0,21,16,1,3,1,0
"2011","E00011233","E00011233","Total",124,90,36,54,1,8,8,0,23,21,0,2,0,2
"2011","E00011240","E00011240","Total",137,116,51,65,1,7,5,2,11,9,0,2,0,2
"2011","E00011241","E00011241","Total",122,99,58,41,0,1,0,1,20,20,0,0,0,2
"2011","E00011230","E00011230","Total",213,125,39,86,3,17,10,7,68,65,0,3,0,0
"2011","E00011232","E00011232","Total",150,109,38,71,1,8,6,2,29,27,0,2,0,3
"2011","E00011234","E00011234","Total",130,102,24,78,1,4,3,1,21,21,0,0,0,2
"2011","E00011235","E00011235","Total",117,88,32,56,2,4,3,1,21,21,0,0,0,2
"2011","E00011237","E00011237","Total",119,98,35,63,0,6,6,0,15,14,0,0,1,0
"2011","E00011203","E00011203","Total",120,96,44,52,0,6,5,1,18,17,0,1,0,0
"2011","E00011208","E00011208","Total",121,92,41,51,0,13,9,4,16,15,0,1,0,0
"2011","E00011210","E00011210","Total",117,56,31,25,0,36,34,2,23,23,0,0,0,2
"2011","E00011239","E00011239","Total",106,26,14,12,0,66,61,5,14,13,0,0,1,0
"2011","E00011243","E00011243","Total",128,101,56,45,0,6,0,6,21,19,0,2,0,0
"2011","E00011205","E00011205","Total",123,106,52,54,1,3,2,1,13,12,0,1,0,0
"2011","E00011206","E00011206","Total",113,90,34,56,1,10,6,4,12,11,0,0,1,0
"2011","E00011207","E00011207","Total",134,116,47,69,1,6,2,4,10,10,0,0,0,1
"2011","E00166784","E00166784","Total",219,22,2,20,0,147,16,131,48,42,1,2,3,2
"2011","E00166789","E00166789","Total",62,58,23,35,0,0,0,0,4,4,0,0,0,0
"2011","E00166790","E00166790","Total",95,38,14,24,2,13,4,9,40,38,0,2,0,2
"2011","E00011202","E00011202","Total",139,96,25,71,0,4,3,1,36,34,0,1,1,3
"2011","E00011204","E00011204","Total",107,88,29,59,0,6,6,0,12,10,0,1,1,1
"2011","E00011238","E00011238","Total",120,105,42,63,0,4,2,2,11,11,0,0,0,0
"2011","E00011242","E00011242","Total",128,103,35,68,0,11,8,3,12,12,0,0,0,2
"2011","E00011244","E00011244","Total",148,108,26,82,1,8,4,4,31,27,0,3,1,0
"2011","E00011209","E00011209","Total",147,80,21,59,0,53,50,3,14,12,0,2,0,0
"2011","E00011211","E00011211","Total",114,57,23,34,1,48,47,1,8,8,0,0,0,0
"2011","E00011212","E00011212","Total",129,56,11,45,1,60,58,2,11,10,0,1,0,1
"2011","E00011213","E00011213","Total",136,117,55,62,1,5,3,2,13,12,0,0,1,0
"2011","E00011255","E00011255","Total",124,117,61,56,0,3,2,1,4,4,0,0,0,0
"2011","E00011267","E00011267","Total",126,117,77,40,0,1,0,1,7,7,0,0,0,1
"2011","E00011270","E00011270","Total",116,92,53,39,0,15,15,0,7,5,1,1,0,2
"2011","E00011281","E00011281","Total",122,120,68,52,0,0,0,0,2,2,0,0,0,0
"2011","E00011285","E00011285","Total",129,121,75,46,0,1,0,1,6,5,0,1,0,1
"2011","E00011247","E00011247","Total",129,124,57,67,0,1,1,0,4,4,0,0,0,0
"2011","E00011248","E00011248","Total",118,101,48,53,0,6,6,0,11,8,0,3,0,0
"2011","E00011249","E00011249","Total",129,116,70,46,0,3,3,0,9,8,0,1,0,1
"2011","E00011258","E00011258","Total",116,101,52,49,1,1,1,0,13,11,0,2,0,0
"2011","E00011259","E00011259","Total",128,114,64,50,0,4,4,0,9,7,0,1,1,1
"2011","E00011245","E00011245","Total",143,120,81,39,0,6,6,0,16,15,0,1,0,1
"2011","E00011271","E00011271","Total",131,98,58,40,0,25,24,1,7,6,0,1,0,1
"2011","E00011275","E00011275","Total",121,48,15,33,0,50,48,2,22,20,0,2,0,1
"2011","E00011279","E00011279","Total",123,34,16,18,1,83,81,2,4,4,0,0,0,1
"2011","E00011282","E00011282","Total",130,88,48,40,1,3,3,0,31,29,1,1,0,7
"2011","E00011284","E00011284","Total",149,129,87,42,1,4,3,1,11,10,0,1,0,4
"2011","E00011266","E00011266","Total",123,116,68,48,0,2,2,0,3,3,0,0,0,2
"2011","E00011269","E00011269","Total",152,122,54,68,0,14,14,0,14,11,2,1,0,2
"2011","E00011272","E00011272","Total",114,109,62,47,1,0,0,0,4,4,0,0,0,0
"2011","E00011276","E00011276","Total",119,112,64,48,0,3,3,0,3,3,0,0,0,1
"2011","E00011278","E00011278","Total",104,98,49,49,1,1,1,0,3,2,0,1,0,1
"2011","E00011911","E00011911","Total",116,99,57,42,0,5,2,3,8,8,0,0,0,4
"2011","E00011931","E00011931","Total",128,118,68,50,1,7,7,0,2,2,0,0,0,0
"2011","E00011932","E00011932","Total",123,118,68,50,0,0,0,0,4,4,0,0,0,1
"2011","E00011934","E00011934","Total",118,104,79,25,1,10,9,1,3,3,0,0,0,0
"2011","E00011937","E00011937","Total",123,112,56,56,1,1,1,0,8,8,0,0,0,1
"2011","E00011265","E00011265","Total",115,112,75,37,0,1,1,0,0,0,0,0,0,2
"2011","E00011268","E00011268","Total",118,117,66,51,0,0,0,0,1,1,0,0,0,0
"2011","E00011273","E00011273","Total",137,132,86,46,0,1,0,1,3,3,0,0,0,1
"2011","E00011274","E00011274","Total",118,114,66,48,0,0,0,0,3,3,0,0,0,1
"2011","E00011277","E00011277","Total",127,124,65,59,0,0,0,0,3,3,0,0,0,0
"2011","E00011250","E00011250","Total",125,120,70,50,0,1,1,0,3,3,0,0,0,1
"2011","E00011251","E00011251","Total",134,128,88,40,0,1,1,0,4,4,0,0,0,1
"2011","E00011261","E00011261","Total",125,123,71,52,0,0,0,0,2,2,0,0,0,0
"2011","E00011262","E00011262","Total",135,112,61,51,0,2,2,0,20,18,0,1,1,1
"2011","E00011280","E00011280","Total",117,110,68,42,0,0,0,0,6,4,0,2,0,1
"2011","E00011246","E00011246","Total",127,120,64,56,0,0,0,0,5,5,0,0,0,2
"2011","E00011252","E00011252","Total",122,119,74,45,0,0,0,0,3,3,0,0,0,0
"2011","E00011253","E00011253","Total",136,129,69,60,0,2,1,1,5,4,0,1,0,0
"2011","E00011254","E00011254","Total",134,128,54,74,0,0,0,0,5,5,0,0,0,1
"2011","E00011260","E00011260","Total",132,99,84,15,1,0,0,0,31,30,0,1,0,1
"2011","E00011933","E00011933","Total",123,109,71,38,2,8,7,1,3,3,0,0,0,1
"2011","E00011935","E00011935","Total",141,122,74,48,0,1,0,1,18,17,0,1,0,0
"2011","E00011938","E00011938","Total",131,109,45,64,0,0,0,0,22,18,0,4,0,0
"2011","E00011939","E00011939","Total",121,101,53,48,1,10,10,0,7,4,1,2,0,2
"2011","E00011940","E00011940","Total",128,121,62,59,0,1,1,0,5,3,1,1,0,1
"2011","E00011789","E00011789","Total",130,123,54,69,0,0,0,0,6,5,1,0,0,1
"2011","E00011791","E00011791","Total",114,102,77,25,1,1,1,0,7,7,0,0,0,3
"2011","E00011792","E00011792","Total",141,130,63,67,1,3,2,1,7,5,1,1,0,0
"2011","E00011793","E00011793","Total",130,123,58,65,0,0,0,0,6,6,0,0,0,1
"2011","E00011778","E00011778","Total",147,112,80,32,0,1,1,0,31,27,0,3,1,3
"2011","E00011779","E00011779","Total",112,97,68,29,0,9,8,1,5,5,0,0,0,1
"2011","E00011795","E00011795","Total",109,89,48,41,0,1,1,0,18,16,0,2,0,1
"2011","E00011798","E00011798","Total",112,82,50,32,0,2,2,0,27,27,0,0,0,1
"2011","E00011802","E00011802","Total",140,52,29,23,0,84,84,0,2,2,0,0,0,2
"2011","E00011803","E00011803","Total",122,69,42,27,1,48,43,5,4,3,0,1,0,0
"2011","E00011777","E00011777","Total",132,55,17,38,0,3,2,1,74,72,0,2,0,0
"2011","E00011796","E00011796","Total",150,84,47,37,3,31,7,24,25,24,0,1,0,7
"2011","E00011800","E00011800","Total",112,31,13,18,0,72,3,69,9,9,0,0,0,0
"2011","E00011801","E00011801","Total",121,63,27,36,0,43,15,28,15,15,0,0,0,0
"2011","E00011805","E00011805","Total",152,72,33,39,0,10,7,3,67,64,1,1,1,3
"2011","E00011807","E00011807","Total",155,139,82,57,1,3,2,1,11,10,0,1,0,1
"2011","E00011804","E00011804","Total",124,96,47,49,5,14,1,13,9,8,0,1,0,0
"2011","E00011808","E00011808","Total",136,123,73,50,0,4,2,2,8,5,0,2,1,1
"2011","E00011812","E00011812","Total",154,63,26,37,1,73,39,34,14,10,1,3,0,3
"2011","E00011816","E00011816","Total",130,107,48,59,1,14,13,1,8,7,0,1,0,0
"2011","E00011817","E00011817","Total",142,21,10,11,3,110,105,5,7,6,0,1,0,1
"2011","E00011786","E00011786","Total",116,76,29,47,1,4,3,1,34,30,0,4,0,1
"2011","E00011787","E00011787","Total",164,92,45,47,0,8,6,2,63,60,0,3,0,1
"2011","E00011788","E00011788","Total",126,105,53,52,1,6,6,0,14,13,0,1,0,0
"2011","E00011790","E00011790","Total",125,111,66,45,0,1,0,1,13,13,0,0,0,0
"2011","E00011794","E00011794","Total",127,114,59,55,0,2,2,0,9,7,0,2,0,2
"2011","E00011576","E00011576","Total",128,114,52,62,0,4,2,2,10,10,0,0,0,0
"2011","E00011579","E00011579","Total",147,132,54,78,0,3,3,0,9,8,0,1,0,3
"2011","E00011608","E00011608","Total",115,109,54,55,0,0,0,0,5,4,0,1,0,1
"2011","E00011609","E00011609","Total",147,131,53,78,2,3,2,1,8,7,0,1,0,3
"2011","E00011573","E00011573","Total",146,140,71,69,1,1,1,0,3,3,0,0,0,1
"2011","E00011583","E00011583","Total",131,114,59,55,1,2,1,1,12,10,0,2,0,2
"2011","E00011585","E00011585","Total",138,119,75,44,0,11,2,9,7,6,0,1,0,1
"2011","E00011587","E00011587","Total",110,95,34,61,0,0,0,0,12,12,0,0,0,3
"2011","E00011610","E00011610","Total",110,70,35,35,1,5,4,1,33,31,1,1,0,1
"2011","E00011597","E00011597","Total",106,96,43,53,1,2,1,1,7,6,0,1,0,0
"2011","E00011598","E00011598","Total",140,127,57,70,1,1,1,0,11,11,0,0,0,0
"2011","E00011599","E00011599","Total",120,112,47,65,0,2,2,0,6,6,0,0,0,0
"2011","E00011601","E00011601","Total",126,115,45,70,2,1,1,0,8,7,0,1,0,0
"2011","E00166774","E00166774","Total",113,106,52,54,0,2,1,1,5,3,0,2,0,0
"2011","E00166780","E00166780","Total",126,86,19,67,0,22,1,21,16,13,0,3,0,2
"2011","E00011588","E00011588","Total",127,122,56,66,0,0,0,0,5,4,0,1,0,0
"2011","E00011589","E00011589","Total",133,112,45,67,0,1,1,0,20,19,0,1,0,0
"2011","E00011590","E00011590","Total",121,112,60,52,0,0,0,0,9,9,0,0,0,0
"2011","E00011591","E00011591","Total",112,98,39,59,0,6,5,1,7,6,0,1,0,1
"2011","E00011595","E00011595","Total",134,131,63,68,0,0,0,0,3,3,0,0,0,0
"2011","E00011574","E00011574","Total",108,32,11,21,0,71,63,8,5,5,0,0,0,0
"2011","E00011592","E00011592","Total",141,103,42,61,0,25,23,2,12,12,0,0,0,1
"2011","E00011593","E00011593","Total",133,109,63,46,0,11,10,1,11,11,0,0,0,2
"2011","E00011594","E00011594","Total",127,101,40,61,0,8,8,0,18,14,0,4,0,0
"2011","E00011596","E00011596","Total",141,102,56,46,0,30,28,2,7,5,0,2,0,2
"2011","E00011256","E00011256","Total",113,104,47,57,2,2,2,0,5,5,0,0,0,0
"2011","E00011257","E00011257","Total",127,109,38,71,1,3,2,1,14,11,0,3,0,0
"2011","E00011263","E00011263","Total",143,134,83,51,0,0,0,0,8,8,0,0,0,1
"2011","E00011264","E00011264","Total",128,119,64,55,0,3,3,0,5,4,0,1,0,1
"2011","E00011283","E00011283","Total",119,105,45,60,0,5,3,2,9,7,0,2,0,0
"2011","E00011413","E00011413","Total",125,105,36,69,0,3,2,1,14,12,1,1,0,3
"2011","E00011414","E00011414","Total",129,122,61,61,0,3,3,0,4,4,0,0,0,0
"2011","E00011416","E00011416","Total",115,102,48,54,0,5,5,0,6,4,0,2,0,2
"2011","E00011417","E00011417","Total",124,101,54,47,0,15,14,1,6,6,0,0,0,2
"2011","E00011425","E00011425","Total",128,101,63,38,0,25,24,1,2,1,0,1,0,0
"2011","E00011421","E00011421","Total",114,72,28,44,1,31,29,2,8,6,0,2,0,2
"2011","E00011423","E00011423","Total",127,115,64,51,0,7,7,0,5,4,0,0,1,0
"2011","E00011424","E00011424","Total",141,132,88,44,0,0,0,0,9,9,0,0,0,0
"2011","E00011429","E00011429","Total",118,66,23,43,1,35,32,3,15,14,0,1,0,1
"2011","E00011433","E00011433","Total",137,101,41,60,1,31,31,0,3,3,0,0,0,1
"2011","E00011797","E00011797","Total",126,105,53,52,0,3,2,1,18,17,0,1,0,0
"2011","E00011799","E00011799","Total",118,90,53,37,0,4,4,0,24,23,0,1,0,0
"2011","E00011806","E00011806","Total",132,103,38,65,1,4,3,1,23,22,0,1,0,1
"2011","E00011809","E00011809","Total",112,88,44,44,0,2,2,0,22,20,0,2,0,0
"2011","E00011810","E00011810","Total",128,114,56,58,0,5,4,1,8,7,0,1,0,1
"2011","E00011901","E00011901","Total",117,95,43,52,0,2,1,1,20,20,0,0,0,0
"2011","E00011906","E00011906","Total",144,115,84,31,0,2,2,0,26,23,0,3,0,1
"2011","E00011907","E00011907","Total",127,105,57,48,0,10,10,0,12,12,0,0,0,0
"2011","E00011908","E00011908","Total",123,102,56,46,2,0,0,0,19,16,1,2,0,0
"2011","E00011914","E00011914","Total",198,74,17,57,0,8,7,1,116,108,1,6,1,0
"2011","E00011936","E00011936","Total",162,131,54,77,0,3,3,0,28,24,0,4,0,0
"2011","E00011436","E00011436","Total",126,114,58,56,0,2,2,0,10,10,0,0,0,0
"2011","E00011440","E00011440","Total",127,110,52,58,1,2,2,0,13,13,0,0,0,1
"2011","E00011442","E00011442","Total",107,94,50,44,0,4,2,2,8,8,0,0,0,1
"2011","E00011443","E00011443","Total",136,121,63,58,0,3,3,0,12,8,0,4,0,0
"2011","E00011447","E00011447","Total",106,99,60,39,0,3,3,0,3,3,0,0,0,1
"2011","E00011415","E00011415","Total",134,64,26,38,0,6,5,1,61,60,0,1,0,3
"2011","E00011418","E00011418","Total",138,127,64,63,0,1,1,0,10,9,0,1,0,0
"2011","E00011420","E00011420","Total",127,120,65,55,0,1,1,0,5,5,0,0,0,1
"2011","E00011426","E00011426","Total",121,115,76,39,0,1,0,1,4,3,0,1,0,1
"2011","E00011431","E00011431","Total",124,55,11,44,0,0,0,0,67,61,0,5,1,2
"2011","E00011432","E00011432","Total",131,110,68,42,0,0,0,0,18,17,0,1,0,3
"2011","E00011811","E00011811","Total",140,122,64,58,0,3,1,2,12,11,0,1,0,3
"2011","E00011813","E00011813","Total",135,125,75,50,0,0,0,0,9,9,0,0,0,1
"2011","E00011814","E00011814","Total",133,123,60,63,0,2,2,0,7,7,0,0,0,1
"2011","E00011815","E00011815","Total",134,114,56,58,0,10,0,10,7,6,0,0,1,3
"2011","E00011783","E00011783","Total",136,129,69,60,2,0,0,0,3,2,0,1,0,2
"2011","E00011784","E00011784","Total",130,115,67,48,1,1,1,0,12,10,0,2,0,1
"2011","E00011785","E00011785","Total",147,67,18,49,0,31,30,1,44,44,0,0,0,5
"2011","E00011819","E00011819","Total",139,133,68,65,0,0,0,0,4,4,0,0,0,2
"2011","E00011780","E00011780","Total",146,134,58,76,1,4,3,1,5,5,0,0,0,2
"2011","E00011781","E00011781","Total",140,126,65,61,0,1,1,0,13,11,0,2,0,0
"2011","E00011782","E00011782","Total",124,116,58,58,0,0,0,0,8,6,0,2,0,0
"2011","E00011818","E00011818","Total",158,121,44,77,0,30,23,7,6,6,0,0,0,1
"2011","E00011905","E00011905","Total",120,104,36,68,2,3,3,0,9,9,0,0,0,2
"2011","E00011913","E00011913","Total",127,120,57,63,0,3,3,0,3,2,0,1,0,1
"2011","E00011924","E00011924","Total",120,89,49,40,0,8,5,3,21,14,3,1,3,2
"2011","E00011926","E00011926","Total",123,121,79,42,0,0,0,0,1,1,0,0,0,1
"2011","E00011928","E00011928","Total",111,105,53,52,0,2,2,0,3,3,0,0,0,1
"2011","E00011902","E00011902","Total",130,124,59,65,0,0,0,0,5,5,0,0,0,1
"2011","E00011909","E00011909","Total",116,114,68,46,0,0,0,0,1,1,0,0,0,1
"2011","E00011910","E00011910","Total",136,129,64,65,1,2,2,0,4,3,0,1,0,0
"2011","E00011912","E00011912","Total",112,112,67,45,0,0,0,0,0,0,0,0,0,0
"2011","E00011915","E00011915","Total",113,107,68,39,0,0,0,0,4,4,0,0,0,2
"2011","E00011904","E00011904","Total",126,116,72,44,0,2,1,1,7,7,0,0,0,1
"2011","E00011919","E00011919","Total",115,108,52,56,1,0,0,0,5,4,0,0,1,1
"2011","E00011922","E00011922","Total",129,124,65,59,0,1,1,0,3,3,0,0,0,1
"2011","E00011923","E00011923","Total",117,115,62,53,0,0,0,0,2,2,0,0,0,0
"2011","E00011929","E00011929","Total",121,116,68,48,0,0,0,0,4,4,0,0,0,1
"2011","E00011916","E00011916","Total",131,126,78,48,0,1,1,0,2,1,0,1,0,2
"2011","E00011917","E00011917","Total",125,117,74,43,0,1,1,0,7,7,0,0,0,0
"2011","E00011925","E00011925","Total",124,118,79,39,0,1,1,0,5,3,0,2,0,0
"2011","E00011927","E00011927","Total",131,126,82,44,0,1,1,0,3,1,1,1,0,1
"2011","E00011930","E00011930","Total",112,108,69,39,0,1,1,0,1,1,0,0,0,2
"2011","E00011903","E00011903","Total",137,131,66,65,0,1,0,1,3,3,0,0,0,2
"2011","E00011918","E00011918","Total",123,120,60,60,0,0,0,0,3,3,0,0,0,0
"2011","E00011920","E00011920","Total",137,133,68,65,0,2,2,0,2,2,0,0,0,0
"2011","E00011921","E00011921","Total",134,129,79,50,0,1,1,0,4,4,0,0,0,0
"2011","E00011289","E00011289","Total",143,118,60,58,1,2,1,1,19,17,0,2,0,3
"2011","E00011307","E00011307","Total",113,93,42,51,0,9,9,0,10,9,0,1,0,1
"2011","E00011308","E00011308","Total",123,112,57,55,0,1,1,0,9,7,0,2,0,1
"2011","E00011311","E00011311","Total",133,124,56,68,0,5,3,2,4,4,0,0,0,0
"2011","E00011317","E00011317","Total",126,109,51,58,0,2,2,0,15,14,0,1,0,0
"2011","E00011435","E00011435","Total",137,115,53,62,0,1,1,0,20,19,1,0,0,1
"2011","E00011439","E00011439","Total",130,114,72,42,0,6,6,0,10,9,0,1,0,0
"2011","E00011441","E00011441","Total",122,117,79,38,0,1,1,0,3,3,0,0,0,1
"2011","E00011445","E00011445","Total",131,125,78,47,0,2,2,0,3,2,0,1,0,1
"2011","E00011411","E00011411","Total",105,98,52,46,1,2,0,2,4,4,0,0,0,0
"2011","E00011434","E00011434","Total",129,123,65,58,0,0,0,0,6,6,0,0,0,0
"2011","E00011437","E00011437","Total",124,123,75,48,0,0,0,0,1,1,0,0,0,0
"2011","E00011438","E00011438","Total",116,114,62,52,0,2,1,1,0,0,0,0,0,0
"2011","E00011446","E00011446","Total",140,129,62,67,0,1,1,0,8,7,0,1,0,2
"2011","E00011412","E00011412","Total",154,125,69,56,0,8,4,4,20,20,0,0,0,1
"2011","E00011444","E00011444","Total",124,117,61,56,0,0,0,0,6,5,0,1,0,1
"2011","E00011448","E00011448","Total",141,137,60,77,0,3,0,3,1,1,0,0,0,0
"2011","E00011449","E00011449","Total",135,128,57,71,0,1,1,0,5,5,0,0,0,1
"2011","E00011419","E00011419","Total",133,122,59,63,0,5,3,2,6,5,0,1,0,0
"2011","E00011422","E00011422","Total",123,116,81,35,0,0,0,0,5,2,0,2,1,2
"2011","E00011427","E00011427","Total",129,120,51,69,0,2,2,0,6,6,0,0,0,1
"2011","E00011428","E00011428","Total",132,130,85,45,0,0,0,0,2,2,0,0,0,0
"2011","E00011430","E00011430","Total",124,113,62,51,0,5,5,0,6,6,0,0,0,0
"2011","E00011294","E00011294","Total",135,127,62,65,1,4,4,0,2,2,0,0,0,1
"2011","E00011296","E00011296","Total",132,101,55,46,0,8,3,5,21,19,0,2,0,2
"2011","E00011298","E00011298","Total",150,113,57,56,0,8,8,0,29,25,0,4,0,0
"2011","E00011300","E00011300","Total",149,125,64,61,2,9,9,0,11,11,0,0,0,2
"2011","E00011287","E00011287","Total",149,122,63,59,0,2,1,1,23,23,0,0,0,2
"2011","E00011293","E00011293","Total",128,110,56,54,2,2,2,0,14,14,0,0,0,0
"2011","E00011295","E00011295","Total",116,103,52,51,0,3,2,1,6,6,0,0,0,4
"2011","E00011297","E00011297","Total",130,81,41,40,0,6,3,3,43,41,0,1,1,0
"2011","E00011299","E00011299","Total",122,108,59,49,0,5,2,3,9,9,0,0,0,0
"2011","E00011288","E00011288","Total",133,106,55,51,1,13,9,4,11,10,0,1,0,2
"2011","E00011301","E00011301","Total",118,106,60,46,1,6,6,0,4,4,0,0,0,1
"2011","E00011302","E00011302","Total",119,93,26,67,0,20,20,0,5,5,0,0,0,1
"2011","E00011303","E00011303","Total",121,65,22,43,0,48,46,2,6,5,1,0,0,2
"2011","E00011304","E00011304","Total",134,88,43,45,0,30,28,2,14,12,0,2,0,2
"2011","E00011286","E00011286","Total",130,114,66,48,0,6,6,0,9,7,0,2,0,1
"2011","E00011290","E00011290","Total",138,119,58,61,9,2,2,0,8,7,0,1,0,0
"2011","E00011324","E00011324","Total",123,110,52,58,0,8,7,1,5,5,0,0,0,0
"2011","E00011325","E00011325","Total",218,201,79,122,1,3,1,2,12,10,0,1,1,1
"2011","E00011305","E00011305","Total",133,66,28,38,0,54,52,2,12,11,0,1,0,1
"2011","E00011309","E00011309","Total",120,68,30,38,2,39,38,1,11,11,0,0,0,0
"2011","E00011310","E00011310","Total",117,52,20,32,0,52,49,3,13,12,0,1,0,0
"2011","E00011313","E00011313","Total",138,39,12,27,0,85,82,3,14,14,0,0,0,0
"2011","E00011316","E00011316","Total",132,81,42,39,0,44,43,1,7,6,0,0,1,0
"2011","E00011320","E00011320","Total",70,11,7,4,0,57,5,52,2,2,0,0,0,0
"2011","E00011306","E00011306","Total",119,92,41,51,0,20,20,0,4,3,0,1,0,3
"2011","E00011312","E00011312","Total",114,107,75,32,0,2,1,1,3,3,0,0,0,2
"2011","E00011315","E00011315","Total",118,111,68,43,0,0,0,0,7,5,0,2,0,0
"2011","E00011318","E00011318","Total",142,125,83,42,0,4,0,4,13,13,0,0,0,0
"2011","E00011319","E00011319","Total",107,95,53,42,1,8,1,7,3,3,0,0,0,0
"2011","E00011291","E00011291","Total",124,102,55,47,0,13,12,1,8,8,0,0,0,1
"2011","E00011292","E00011292","Total",115,70,37,33,0,34,5,29,8,8,0,0,0,3
"2011","E00011314","E00011314","Total",114,82,44,38,1,24,22,2,6,6,0,0,0,1
"2011","E00011321","E00011321","Total",127,79,40,39,0,38,38,0,9,8,0,1,0,1
"2011","E00011322","E00011322","Total",138,62,28,34,1,61,59,2,13,12,0,1,0,1
"2011","E00011323","E00011323","Total",116,70,31,39,0,36,2,34,9,6,0,3,0,1
"2011","E00011822","E00011822","Total",116,98,50,48,0,8,0,8,10,10,0,0,0,0
"2011","E00011824","E00011824","Total",126,113,49,64,0,10,7,3,1,1,0,0,0,2
"2011","E00011825","E00011825","Total",120,103,54,49,0,3,1,2,13,13,0,0,0,1
"2011","E00011826","E00011826","Total",117,106,60,46,0,4,3,1,7,6,0,1,0,0
"2011","E00011833","E00011833","Total",124,105,47,58,1,1,1,0,17,17,0,0,0,0
"2011","E00011820","E00011820","Total",113,103,46,57,1,3,2,1,6,6,0,0,0,0
"2011","E00011823","E00011823","Total",133,117,73,44,0,9,9,0,7,7,0,0,0,0
"2011","E00011832","E00011832","Total",120,85,40,45,0,18,18,0,16,16,0,0,0,1
"2011","E00011838","E00011838","Total",142,118,53,65,0,8,8,0,16,15,0,1,0,0
"2011","E00011842","E00011842","Total",120,100,49,51,1,6,2,4,10,7,0,2,1,3
"2011","E00011829","E00011829","Total",96,18,5,13,1,72,70,2,5,3,0,2,0,0
"2011","E00011831","E00011831","Total",130,111,48,63,0,3,2,1,16,16,0,0,0,0
"2011","E00011834","E00011834","Total",102,87,35,52,0,4,3,1,9,9,0,0,0,2
"2011","E00011835","E00011835","Total",131,121,56,65,1,3,1,2,5,4,0,1,0,1
"2011","E00011847","E00011847","Total",145,120,55,65,0,7,4,3,17,16,1,0,0,1
"2011","E00011839","E00011839","Total",85,41,17,24,0,36,9,27,8,7,0,0,1,0
"2011","E00011840","E00011840","Total",75,7,4,3,0,64,7,57,3,3,0,0,0,1
"2011","E00011846","E00011846","Total",116,58,21,37,0,40,3,37,18,17,0,0,1,0
"2011","E00011850","E00011850","Total",83,11,4,7,0,71,4,67,1,1,0,0,0,0
"2011","E00011851","E00011851","Total",115,98,48,50,0,8,3,5,7,7,0,0,0,2
"2011","E00011852","E00011852","Total",222,59,24,35,0,135,17,118,26,24,0,1,1,2
"2011","E00011844","E00011844","Total",148,130,62,68,1,6,5,1,9,9,0,0,0,2
"2011","E00011848","E00011848","Total",137,119,67,52,0,5,2,3,13,13,0,0,0,0
"2011","E00011853","E00011853","Total",136,105,56,49,0,17,1,16,14,14,0,0,0,0
"2011","E00011859","E00011859","Total",123,109,58,51,0,4,2,2,10,10,0,0,0,0
"2011","E00011860","E00011860","Total",186,101,35,66,8,39,7,32,35,30,0,5,0,3
"2011","E00011821","E00011821","Total",140,80,32,48,3,24,23,1,32,31,0,0,1,1
"2011","E00011849","E00011849","Total",189,139,41,98,0,32,10,22,16,14,0,1,1,2
"2011","E00011856","E00011856","Total",125,48,13,35,0,64,59,5,12,10,0,2,0,1
"2011","E00011857","E00011857","Total",132,102,38,64,0,25,22,3,4,4,0,0,0,1
"2011","E00011858","E00011858","Total",120,80,31,49,2,17,14,3,17,14,0,3,0,4
"2011","E00011861","E00011861","Total",140,31,16,15,1,102,96,6,5,4,0,1,0,1
"2011","E00011841","E00011841","Total",125,116,68,48,0,4,3,1,5,5,0,0,0,0
"2011","E00011843","E00011843","Total",130,115,63,52,0,6,6,0,8,8,0,0,0,1
"2011","E00011845","E00011845","Total",123,88,45,43,0,15,14,1,20,19,0,1,0,0
"2011","E00011854","E00011854","Total",128,104,49,55,0,11,9,2,12,11,0,1,0,1
"2011","E00011855","E00011855","Total",137,121,66,55,2,3,2,1,10,8,0,2,0,1
"2011","E00011827","E00011827","Total",142,121,60,61,0,2,1,1,18,16,0,2,0,1
"2011","E00011828","E00011828","Total",122,92,40,52,0,20,18,2,8,7,0,1,0,2
"2011","E00011830","E00011830","Total",133,65,28,37,1,61,51,10,6,5,0,1,0,0
"2011","E00011836","E00011836","Total",142,81,41,40,7,42,39,3,11,11,0,0,0,1
"2011","E00011837","E00011837","Total",149,73,29,44,1,64,55,9,11,11,0,0,0,0
"2011","E00011702","E00011702","Total",123,108,69,39,0,1,1,0,13,12,0,1,0,1
"2011","E00011707","E00011707","Total",134,124,69,55,1,2,0,2,6,6,0,0,0,1
"2011","E00011708","E00011708","Total",121,103,51,52,2,2,1,1,13,11,0,2,0,1
"2011","E00011710","E00011710","Total",133,125,57,68,0,1,1,0,7,6,1,0,0,0
"2011","E00011711","E00011711","Total",125,118,68,50,0,1,1,0,6,6,0,0,0,0
"2011","E00011695","E00011695","Total",116,81,45,36,0,7,7,0,27,24,0,3,0,1
"2011","E00011712","E00011712","Total",122,98,51,47,0,5,4,1,17,16,0,0,1,2
"2011","E00011713","E00011713","Total",135,119,66,53,1,1,0,1,14,13,0,1,0,0
"2011","E00011721","E00011721","Total",139,108,68,40,1,5,4,1,25,24,0,1,0,0
"2011","E00011723","E00011723","Total",126,114,63,51,1,6,4,2,5,5,0,0,0,0
"2011","E00011697","E00011697","Total",131,126,85,41,0,2,2,0,3,3,0,0,0,0
"2011","E00011698","E00011698","Total",113,108,71,37,0,0,0,0,4,4,0,0,0,1
"2011","E00011703","E00011703","Total",125,118,62,56,0,0,0,0,7,7,0,0,0,0
"2011","E00011704","E00011704","Total",128,114,69,45,0,4,4,0,9,8,0,1,0,1
"2011","E00011706","E00011706","Total",145,134,92,42,1,1,0,1,9,6,0,1,2,0
"2011","E00011696","E00011696","Total",119,70,30,40,0,39,0,39,8,8,0,0,0,2
"2011","E00011699","E00011699","Total",115,103,60,43,1,4,1,3,6,5,0,1,0,1
"2011","E00011700","E00011700","Total",124,112,63,49,0,1,0,1,10,9,0,1,0,1
"2011","E00011701","E00011701","Total",133,122,60,62,0,2,0,2,9,9,0,0,0,0
"2011","E00011705","E00011705","Total",117,110,70,40,0,1,1,0,3,3,0,0,0,3
"2011","E00011693","E00011693","Total",124,96,39,57,0,21,19,2,7,7,0,0,0,0
"2011","E00011714","E00011714","Total",130,71,23,48,0,41,3,38,18,16,0,0,2,0
"2011","E00011715","E00011715","Total",131,86,14,72,1,6,5,1,38,37,0,1,0,0
"2011","E00011716","E00011716","Total",127,84,38,46,0,10,7,3,30,26,1,3,0,3
"2011","E00011719","E00011719","Total",120,92,46,46,1,6,4,2,20,17,0,2,1,1
"2011","E00011692","E00011692","Total",134,80,27,53,0,14,9,5,39,36,0,3,0,1
"2011","E00011709","E00011709","Total",132,66,26,40,1,37,34,3,27,26,0,1,0,1
"2011","E00011717","E00011717","Total",149,53,13,40,1,49,46,3,46,42,1,2,1,0
"2011","E00011724","E00011724","Total",151,104,49,55,1,8,6,2,38,35,0,3,0,0
"2011","E00011726","E00011726","Total",190,81,27,54,11,51,10,41,45,43,0,2,0,2
"2011","E00011718","E00011718","Total",134,84,21,63,1,41,38,3,8,6,0,2,0,0
"2011","E00011720","E00011720","Total",150,114,44,70,1,9,8,1,25,20,1,4,0,1
"2011","E00011722","E00011722","Total",141,83,34,49,0,11,7,4,47,41,0,6,0,0
"2011","E00011727","E00011727","Total",132,77,33,44,0,44,3,41,8,7,0,1,0,3
"2011","E00011694","E00011694","Total",148,133,84,49,0,2,1,1,13,10,0,3,0,0
"2011","E00011725","E00011725","Total",112,93,38,55,0,2,2,0,16,14,0,2,0,1
"2011","E00011728","E00011728","Total",139,109,46,63,0,7,5,2,22,18,1,2,1,1
"2011","E00011729","E00011729","Total",127,114,56,58,0,1,1,0,12,11,0,1,0,0
"2011","E00012311","E00012311","Total",124,58,24,34,1,55,2,53,7,7,0,0,0,3
"2011","E00012315","E00012315","Total",162,111,66,45,0,34,2,32,16,13,0,0,3,1
"2011","E00012328","E00012328","Total",96,31,22,9,0,61,0,61,4,2,0,0,2,0
"2011","E00012329","E00012329","Total",118,109,67,42,0,3,0,3,4,4,0,0,0,2
"2011","E00012332","E00012332","Total",136,124,74,50,0,1,1,0,9,7,2,0,0,2
"2011","E00012313","E00012313","Total",117,80,38,42,0,13,3,10,21,19,0,0,2,3
"2011","E00012317","E00012317","Total",136,93,52,41,0,7,2,5,36,35,1,0,0,0
"2011","E00012336","E00012336","Total",113,66,34,32,1,7,0,7,38,33,3,2,0,1
"2011","E00012337","E00012337","Total",99,19,7,12,0,64,3,61,16,14,0,0,2,0
"2011","E00012343","E00012343","Total",130,84,43,41,1,20,20,0,23,21,0,1,1,2
"2011","E00012344","E00012344","Total",97,20,12,8,0,72,1,71,4,4,0,0,0,1
"2011","E00012335","E00012335","Total",108,88,42,46,6,1,0,1,12,10,1,1,0,1
"2011","E00012338","E00012338","Total",119,89,51,38,0,14,13,1,13,10,3,0,0,3
"2011","E00012339","E00012339","Total",127,100,59,41,0,3,2,1,23,23,0,0,0,1
"2011","E00012340","E00012340","Total",123,100,65,35,0,3,1,2,20,18,1,1,0,0
"2011","E00012342","E00012342","Total",134,111,77,34,0,2,1,1,19,16,2,1,0,2
"2011","E00012314","E00012314","Total",145,92,42,50,2,17,14,3,32,32,0,0,0,2
"2011","E00012316","E00012316","Total",137,97,58,39,0,10,9,1,23,16,5,0,2,7
"2011","E00012341","E00012341","Total",125,80,41,39,0,14,13,1,29,27,1,0,1,2
"2011","E00012345","E00012345","Total",152,83,58,25,0,22,15,7,44,32,5,3,4,3
"2011","E00012361","E00012361","Total",124,118,77,41,0,0,0,0,6,6,0,0,0,0
"2011","E00012362","E00012362","Total",124,110,52,58,0,3,1,2,10,8,2,0,0,1
"2011","E00012363","E00012363","Total",133,110,50,60,0,3,1,2,18,16,0,1,1,2
"2011","E00012364","E00012364","Total",115,103,53,50,0,2,1,1,9,9,0,0,0,1
"2011","E00012367","E00012367","Total",121,111,75,36,0,2,2,0,8,8,0,0,0,0
"2011","E00012318","E00012318","Total",133,92,58,34,3,5,3,2,30,27,0,3,0,3
"2011","E00012319","E00012319","Total",113,44,27,17,0,3,1,2,65,61,1,3,0,1
"2011","E00012321","E00012321","Total",123,88,62,26,0,3,1,2,31,29,0,2,0,1
"2011","E00012325","E00012325","Total",130,65,33,32,0,20,18,2,41,38,0,2,1,4
"2011","E00012330","E00012330","Total",128,56,33,23,2,47,10,37,21,21,0,0,0,2
"2011","E00012346","E00012346","Total",144,94,57,37,2,2,0,2,44,38,2,2,2,2
"2011","E00012312","E00012312","Total",143,130,89,41,0,2,2,0,11,9,2,0,0,0
"2011","E00012326","E00012326","Total",134,112,56,56,0,8,5,3,13,13,0,0,0,1
"2011","E00012331","E00012331","Total",117,80,39,41,0,10,8,2,26,25,0,1,0,1
"2011","E00012333","E00012333","Total",124,42,21,21,1,39,36,3,42,42,0,0,0,0
"2011","E00012334","E00012334","Total",125,76,27,49,0,31,1,30,17,17,0,0,0,1
"2011","E00012320","E00012320","Total",128,49,21,28,7,36,33,3,36,31,1,4,0,0
"2011","E00012322","E00012322","Total",141,84,55,29,0,15,13,2,39,37,0,2,0,3
"2011","E00012323","E00012323","Total",124,77,46,31,1,1,0,1,41,34,3,3,1,4
"2011","E00012324","E00012324","Total",138,109,57,52,0,2,1,1,26,25,0,1,0,1
"2011","E00012327","E00012327","Total",135,99,42,57,0,3,3,0,32,31,0,1,0,1
"2011","E00012371","E00012371","Total",142,112,51,61,0,2,2,0,23,21,1,1,0,5
"2011","E00012373","E00012373","Total",139,103,45,58,0,2,1,1,33,31,0,2,0,1
"2011","E00012374","E00012374","Total",142,120,62,58,0,0,0,0,18,14,0,3,1,4
"2011","E00012375","E00012375","Total",146,30,11,19,0,1,0,1,112,108,1,1,2,3
"2011","E00012379","E00012379","Total",145,104,62,42,0,27,19,8,14,13,1,0,0,0
"2011","E00012365","E00012365","Total",117,70,28,42,0,28,23,5,18,17,1,0,0,1
"2011","E00012366","E00012366","Total",126,75,23,52,1,42,39,3,8,8,0,0,0,0
"2011","E00012368","E00012368","Total",108,54,18,36,1,37,23,14,16,16,0,0,0,0
"2011","E00012369","E00012369","Total",109,75,45,30,1,20,18,2,11,10,0,1,0,2
"2011","E00012370","E00012370","Total",125,84,38,46,0,16,15,1,25,23,1,1,0,0
"2011","E00012347","E00012347","Total",135,69,30,39,0,32,22,10,33,33,0,0,0,1
"2011","E00012372","E00012372","Total",141,37,22,15,0,45,1,44,58,57,0,0,1,1
"2011","E00012376","E00012376","Total",107,67,43,24,0,12,10,2,24,23,0,1,0,4
"2011","E00012377","E00012377","Total",117,82,41,41,0,5,5,0,28,26,0,2,0,2
"2011","E00012378","E00012378","Total",142,45,22,23,0,28,24,4,67,65,0,0,2,2
"2011","E00012381","E00012381","Total",120,110,56,54,0,6,4,2,2,2,0,0,0,2
"2011","E00012152","E00012152","Total",162,111,53,58,0,26,20,6,23,22,0,1,0,2
"2011","E00012166","E00012166","Total",111,101,49,52,0,2,1,1,8,7,0,1,0,0
"2011","E00012167","E00012167","Total",100,88,34,54,0,1,1,0,8,8,0,0,0,3
"2011","E00012169","E00012169","Total",107,74,23,51,3,23,17,6,7,6,0,1,0,0
"2011","E00012149","E00012149","Total",122,72,24,48,0,33,27,6,14,4,7,2,1,3
"2011","E00012153","E00012153","Total",122,79,42,37,0,9,7,2,31,28,2,0,1,3
"2011","E00012156","E00012156","Total",126,76,37,39,0,20,18,2,29,26,1,2,0,1
"2011","E00012168","E00012168","Total",121,71,45,26,0,41,40,1,8,8,0,0,0,1
"2011","E00012172","E00012172","Total",117,71,27,44,1,36,34,2,8,8,0,0,0,1
"2011","E00012150","E00012150","Total",118,73,42,31,1,34,31,3,9,8,0,1,0,1
"2011","E00012154","E00012154","Total",135,70,30,40,5,51,44,7,9,8,0,0,1,0
"2011","E00012170","E00012170","Total",119,69,27,42,0,49,46,3,1,1,0,0,0,0
"2011","E00012171","E00012171","Total",128,92,40,52,2,28,28,0,5,4,0,1,0,1
"2011","E00012173","E00012173","Total",118,92,48,44,0,17,14,3,4,3,0,1,0,5
"2011","E00012151","E00012151","Total",151,102,39,63,0,24,14,10,25,24,0,0,1,0
"2011","E00012155","E00012155","Total",51,31,19,12,0,5,5,0,11,8,1,0,2,4
"2011","E00012157","E00012157","Total",111,39,10,29,0,58,49,9,14,12,1,1,0,0
"2011","E00012158","E00012158","Total",115,91,38,53,0,2,2,0,21,18,0,3,0,1
"2011","E00012159","E00012159","Total",109,54,27,27,0,51,35,16,4,3,1,0,0,0
"2011","E00012161","E00012161","Total",130,75,21,54,0,41,25,16,13,13,0,0,0,1
"2011","E00012160","E00012160","Total",127,61,22,39,0,58,55,3,8,7,0,1,0,0
"2011","E00012162","E00012162","Total",127,98,53,45,0,20,16,4,7,7,0,0,0,2
"2011","E00012163","E00012163","Total",131,54,28,26,0,61,42,19,15,11,0,3,1,1
"2011","E00012164","E00012164","Total",126,93,43,50,0,24,22,2,7,7,0,0,0,2
"2011","E00012165","E00012165","Total",124,96,34,62,0,9,8,1,18,18,0,0,0,1
"2011","E00012113","E00012113","Total",129,105,63,42,0,3,0,3,19,19,0,0,0,2
"2011","E00012135","E00012135","Total",122,117,75,42,0,1,1,0,3,3,0,0,0,1
"2011","E00012141","E00012141","Total",131,117,66,51,0,0,0,0,13,11,0,1,1,1
"2011","E00012146","E00012146","Total",136,27,7,20,0,97,86,11,11,11,0,0,0,1
"2011","E00176474","E00176474","Total",112,85,23,62,8,6,2,4,12,10,0,2,0,1
"2011","E00176482","E00176482","Total",93,62,17,45,1,29,6,23,1,1,0,0,0,0
"2011","E00176483","E00176483","Total",59,40,21,19,0,12,1,11,7,7,0,0,0,0
"2011","E00012133","E00012133","Total",125,112,58,54,0,4,4,0,9,9,0,0,0,0
"2011","E00012134","E00012134","Total",132,124,52,72,0,1,0,1,7,6,0,1,0,0
"2011","E00012139","E00012139","Total",140,92,40,52,1,37,29,8,9,9,0,0,0,1
"2011","E00012142","E00012142","Total",132,76,35,41,0,36,4,32,19,19,0,0,0,1
"2011","E00012144","E00012144","Total",129,115,57,58,0,2,0,2,12,9,0,2,1,0
"2011","E00012350","E00012350","Total",158,68,20,48,5,66,28,38,16,14,1,1,0,3
"2011","E00012357","E00012357","Total",105,37,11,26,0,61,56,5,6,5,0,1,0,1
"2011","E00012380","E00012380","Total",119,107,56,51,0,6,4,2,5,5,0,0,0,1
"2011","E00012382","E00012382","Total",116,86,40,46,0,21,20,1,8,6,0,1,1,1
"2011","E00012383","E00012383","Total",130,83,24,59,2,39,32,7,5,4,0,0,1,1
"2011","E00012348","E00012348","Total",130,100,49,51,0,2,0,2,25,23,0,2,0,3
"2011","E00012349","E00012349","Total",124,95,48,47,0,11,3,8,18,16,0,2,0,0
"2011","E00012352","E00012352","Total",109,89,52,37,0,2,0,2,17,10,5,0,2,1
"2011","E00012354","E00012354","Total",128,111,58,53,1,1,0,1,15,10,0,5,0,0
"2011","E00012355","E00012355","Total",117,104,58,46,0,3,2,1,9,8,0,0,1,1
"2011","E00012358","E00012358","Total",105,96,60,36,0,0,0,0,8,7,0,1,0,1
"2011","E00012351","E00012351","Total",138,63,26,37,0,54,50,4,20,18,0,2,0,1
"2011","E00012353","E00012353","Total",126,67,28,39,1,36,31,5,21,18,1,1,1,1
"2011","E00012356","E00012356","Total",137,64,26,38,0,59,50,9,13,12,0,1,0,1
"2011","E00012359","E00012359","Total",127,72,20,52,1,38,35,3,16,15,0,1,0,0
"2011","E00012360","E00012360","Total",131,104,41,63,1,15,12,3,10,8,0,2,0,1
"2011","E00012610","E00012610","Total",125,78,26,52,0,30,28,2,17,14,0,3,0,0
"2011","E00012624","E00012624","Total",123,102,45,57,0,17,14,3,4,2,1,0,1,0
"2011","E00012627","E00012627","Total",98,15,5,10,10,70,6,64,3,3,0,0,0,0
"2011","E00012628","E00012628","Total",116,92,24,68,1,4,1,3,19,17,0,2,0,0
"2011","E00012630","E00012630","Total",127,113,49,64,0,10,8,2,2,2,0,0,0,2
"2011","E00012604","E00012604","Total",121,69,29,40,0,38,36,2,14,14,0,0,0,0
"2011","E00012632","E00012632","Total",122,104,49,55,0,13,12,1,5,5,0,0,0,0
"2011","E00012633","E00012633","Total",125,78,25,53,0,39,38,1,7,7,0,0,0,1
"2011","E00012634","E00012634","Total",117,82,47,35,0,15,1,14,19,17,0,2,0,1
"2011","E00012635","E00012635","Total",122,112,55,57,1,0,0,0,7,7,0,0,0,2
"2011","E00012607","E00012607","Total",150,110,47,63,4,9,6,3,23,20,1,1,1,4
"2011","E00012608","E00012608","Total",117,92,39,53,0,16,13,3,7,5,1,1,0,2
"2011","E00012609","E00012609","Total",118,78,34,44,6,27,24,3,7,6,0,1,0,0
"2011","E00012621","E00012621","Total",122,64,27,37,2,47,46,1,8,8,0,0,0,1
"2011","E00012622","E00012622","Total",112,97,42,55,0,3,1,2,12,12,0,0,0,0
"2011","E00012623","E00012623","Total",127,112,69,43,0,7,5,2,4,3,0,1,0,4
"2011","E00012611","E00012611","Total",124,119,71,48,1,0,0,0,4,4,0,0,0,0
"2011","E00012625","E00012625","Total",133,122,70,52,0,1,1,0,8,7,0,1,0,2
"2011","E00012626","E00012626","Total",122,115,64,51,2,2,2,0,3,3,0,0,0,0
"2011","E00012629","E00012629","Total",125,92,37,55,0,27,24,3,6,6,0,0,0,0
"2011","E00012631","E00012631","Total",115,50,26,24,0,46,1,45,17,16,0,0,1,2
"2011","E00012046","E00012046","Total",134,112,41,71,0,17,16,1,5,5,0,0,0,0
"2011","E00012067","E00012067","Total",117,99,41,58,0,12,11,1,6,6,0,0,0,0
"2011","E00012069","E00012069","Total",127,86,36,50,1,32,23,9,7,7,0,0,0,1
"2011","E00012071","E00012071","Total",140,128,72,56,0,2,2,0,7,7,0,0,0,3
"2011","E00012073","E00012073","Total",140,97,36,61,2,28,25,3,12,10,0,2,0,1
"2011","E00012066","E00012066","Total",111,99,50,49,0,3,2,1,9,9,0,0,0,0
"2011","E00012068","E00012068","Total",110,106,48,58,0,1,1,0,2,2,0,0,0,1
"2011","E00012070","E00012070","Total",133,65,27,38,2,6,4,2,59,53,0,6,0,1
"2011","E00012072","E00012072","Total",126,116,48,68,0,1,1,0,9,8,0,1,0,0
"2011","E00012076","E00012076","Total",131,122,59,63,0,1,1,0,8,7,0,0,1,0
"2011","E00012114","E00012114","Total",119,113,69,44,0,2,0,2,4,4,0,0,0,0
"2011","E00012116","E00012116","Total",118,112,67,45,0,0,0,0,6,6,0,0,0,0
"2011","E00012119","E00012119","Total",125,114,53,61,0,2,2,0,8,7,0,1,0,1
"2011","E00012130","E00012130","Total",127,118,71,47,0,0,0,0,8,7,0,1,0,1
"2011","E00012115","E00012115","Total",120,114,65,49,0,1,1,0,5,4,0,1,0,0
"2011","E00012120","E00012120","Total",111,105,60,45,0,1,0,1,5,4,0,1,0,0
"2011","E00012121","E00012121","Total",147,121,66,55,0,6,6,0,20,19,0,1,0,0
"2011","E00012126","E00012126","Total",133,51,26,25,0,4,2,2,71,63,1,2,5,7
"2011","E00012148","E00012148","Total",124,92,74,18,1,0,0,0,30,27,2,0,1,1
"2011","E00012132","E00012132","Total",126,116,78,38,0,0,0,0,9,9,0,0,0,1
"2011","E00012136","E00012136","Total",126,110,75,35,0,0,0,0,14,12,0,2,0,2
"2011","E00012137","E00012137","Total",116,67,36,31,0,44,40,4,5,4,0,1,0,0
"2011","E00012138","E00012138","Total",123,115,83,32,0,1,1,0,7,7,0,0,0,0
"2011","E00012143","E00012143","Total",117,115,70,45,0,0,0,0,2,2,0,0,0,0
"2011","E00012117","E00012117","Total",131,128,77,51,0,0,0,0,3,2,0,1,0,0
"2011","E00012122","E00012122","Total",123,115,65,50,0,3,1,2,5,5,0,0,0,0
"2011","E00012140","E00012140","Total",129,119,56,63,0,2,0,2,7,7,0,0,0,1
"2011","E00012145","E00012145","Total",141,126,76,50,0,10,0,10,5,4,0,0,1,0
"2011","E00012124","E00012124","Total",131,115,51,64,0,1,0,1,14,14,0,0,0,1
"2011","E00012127","E00012127","Total",109,77,40,37,0,23,0,23,6,6,0,0,0,3
"2011","E00012129","E00012129","Total",132,129,76,53,0,1,0,1,2,2,0,0,0,0
"2011","E00012147","E00012147","Total",132,125,72,53,1,0,0,0,6,4,1,1,0,0
"2011","E00012118","E00012118","Total",130,125,78,47,0,0,0,0,5,3,1,1,0,0
"2011","E00012123","E00012123","Total",139,128,63,65,0,2,2,0,7,7,0,0,0,2
"2011","E00012128","E00012128","Total",127,119,59,60,0,1,0,1,7,6,1,0,0,0
"2011","E00012131","E00012131","Total",139,124,67,57,1,7,5,2,7,7,0,0,0,0
"2011","E00012280","E00012280","Total",112,100,54,46,0,0,0,0,12,12,0,0,0,0
"2011","E00012281","E00012281","Total",139,40,21,19,0,64,0,64,34,30,0,0,4,1
"2011","E00012282","E00012282","Total",209,53,19,34,24,16,1,15,111,105,0,5,1,5
"2011","E00012285","E00012285","Total",120,106,63,43,0,1,1,0,12,7,4,1,0,1
"2011","E00012286","E00012286","Total",122,113,64,49,0,1,1,0,8,7,0,1,0,0
"2011","E00012605","E00012605","Total",186,140,89,51,0,0,0,0,41,37,0,4,0,5
"2011","E00012612","E00012612","Total",232,109,56,53,6,24,2,22,86,83,0,3,0,7
"2011","E00012636","E00012636","Total",139,100,55,45,0,21,0,21,16,16,0,0,0,2
"2011","E00012637","E00012637","Total",105,36,14,22,0,3,0,3,65,64,0,0,1,1
"2011","E00012638","E00012638","Total",166,97,56,41,0,9,1,8,58,55,1,2,0,2
"2011","E00012053","E00012053","Total",118,105,44,61,0,5,3,2,8,7,0,1,0,0
"2011","E00012056","E00012056","Total",104,85,35,50,0,14,9,5,5,5,0,0,0,0
"2011","E00012057","E00012057","Total",114,89,34,55,0,11,9,2,12,12,0,0,0,2
"2011","E00012060","E00012060","Total",130,117,42,75,0,2,1,1,11,9,0,2,0,0
"2011","E00012061","E00012061","Total",127,117,46,71,2,1,1,0,6,6,0,0,0,1
"2011","E00012044","E00012044","Total",132,114,69,45,1,1,1,0,14,12,1,1,0,2
"2011","E00012045","E00012045","Total",133,110,55,55,0,4,4,0,19,17,0,2,0,0
"2011","E00012063","E00012063","Total",114,82,27,55,1,2,1,1,28,28,0,0,0,1
"2011","E00012064","E00012064","Total",130,119,71,48,0,2,1,1,8,8,0,0,0,1
"2011","E00012065","E00012065","Total",129,119,72,47,0,0,0,0,10,9,0,1,0,0
"2011","E00012049","E00012049","Total",118,26,12,14,0,83,3,80,8,8,0,0,0,1
"2011","E00012074","E00012074","Total",128,71,26,45,0,35,35,0,20,20,0,0,0,2
"2011","E00012075","E00012075","Total",137,122,49,73,0,4,3,1,10,7,1,2,0,1
"2011","E00012077","E00012077","Total",137,111,42,69,1,1,1,0,20,19,0,1,0,4
"2011","E00012078","E00012078","Total",142,124,59,65,0,7,6,1,11,10,0,1,0,0
"2011","E00012047","E00012047","Total",135,123,76,47,0,4,2,2,6,6,0,0,0,2
"2011","E00012048","E00012048","Total",132,121,57,64,0,1,1,0,9,9,0,0,0,1
"2011","E00012050","E00012050","Total",119,98,48,50,0,9,9,0,12,12,0,0,0,0
"2011","E00012052","E00012052","Total",139,91,40,51,0,25,21,4,22,20,0,2,0,1
"2011","E00012054","E00012054","Total",111,94,35,59,0,1,0,1,14,14,0,0,0,2
"2011","E00012278","E00012278","Total",123,117,74,43,0,2,1,1,1,1,0,0,0,3
"2011","E00012279","E00012279","Total",125,97,30,67,1,10,8,2,17,15,1,0,1,0
"2011","E00012283","E00012283","Total",127,113,44,69,0,1,1,0,13,12,0,1,0,0
"2011","E00012284","E00012284","Total",126,110,46,64,1,3,2,1,10,9,0,1,0,2
"2011","E00012288","E00012288","Total",133,117,32,85,0,4,4,0,12,11,0,1,0,0
"2011","E00012277","E00012277","Total",135,121,55,66,0,0,0,0,13,11,1,1,0,1
"2011","E00012297","E00012297","Total",122,63,18,45,1,15,7,8,42,41,0,0,1,1
"2011","E00012300","E00012300","Total",133,119,55,64,0,1,1,0,12,11,1,0,0,1
"2011","E00012305","E00012305","Total",123,87,27,60,1,5,3,2,29,28,0,1,0,1
"2011","E00012307","E00012307","Total",120,59,16,43,2,12,12,0,47,42,0,3,2,0
"2011","E00012287","E00012287","Total",137,104,87,17,0,7,5,2,22,21,0,1,0,4
"2011","E00012291","E00012291","Total",110,105,44,61,0,0,0,0,5,2,1,1,1,0
"2011","E00012294","E00012294","Total",125,117,66,51,1,0,0,0,7,6,1,0,0,0
"2011","E00012299","E00012299","Total",130,113,46,67,0,2,0,2,13,11,2,0,0,2
"2011","E00012306","E00012306","Total",137,121,76,45,1,2,1,1,10,6,1,2,1,3
"2011","E00012420","E00012420","Total",114,85,25,60,2,7,5,2,20,19,0,0,1,0
"2011","E00012423","E00012423","Total",133,92,33,59,1,23,21,2,17,16,1,0,0,0
"2011","E00012425","E00012425","Total",130,111,38,73,1,1,1,0,16,15,0,1,0,1
"2011","E00012449","E00012449","Total",130,83,26,57,0,26,26,0,19,15,1,3,0,2
"2011","E00012454","E00012454","Total",130,103,37,66,0,10,9,1,17,16,0,0,1,0
"2011","E00012613","E00012613","Total",107,87,60,27,4,0,0,0,15,14,0,1,0,1
"2011","E00012614","E00012614","Total",123,42,12,30,0,9,1,8,72,10,39,0,23,0
"2011","E00012615","E00012615","Total",118,94,49,45,1,0,0,0,22,21,0,1,0,1
"2011","E00012617","E00012617","Total",126,44,11,33,1,3,1,2,78,49,13,0,16,0
"2011","E00012619","E00012619","Total",135,84,29,55,1,3,2,1,46,46,0,0,0,1
"2011","E00012606","E00012606","Total",150,108,47,61,0,2,2,0,38,37,0,0,1,2
"2011","E00012616","E00012616","Total",148,99,41,58,1,0,0,0,47,44,0,3,0,1
"2011","E00012618","E00012618","Total",152,131,73,58,0,1,1,0,19,16,0,2,1,1
"2011","E00012620","E00012620","Total",129,64,30,34,0,8,4,4,57,15,24,1,17,0
"2011","E00012051","E00012051","Total",122,106,41,65,2,2,2,0,9,8,0,1,0,3
"2011","E00012055","E00012055","Total",118,113,49,64,0,1,1,0,4,4,0,0,0,0
"2011","E00012058","E00012058","Total",126,115,37,78,1,1,1,0,8,8,0,0,0,1
"2011","E00012059","E00012059","Total",140,130,60,70,0,2,1,1,7,6,0,1,0,1
"2011","E00012062","E00012062","Total",137,120,42,78,3,3,2,1,11,10,0,1,0,0
"2011","E00012276","E00012276","Total",124,109,43,66,0,3,2,1,11,9,0,2,0,1
"2011","E00012301","E00012301","Total",119,109,50,59,1,3,2,1,6,6,0,0,0,0
"2011","E00012308","E00012308","Total",129,113,39,74,0,4,1,3,12,10,0,2,0,0
"2011","E00012309","E00012309","Total",127,116,46,70,0,1,0,1,10,9,0,1,0,0
"2011","E00012310","E00012310","Total",134,127,60,67,0,0,0,0,6,6,0,0,0,1
"2011","E00012289","E00012289","Total",123,101,32,69,3,5,3,2,13,11,1,1,0,1
"2011","E00012292","E00012292","Total",130,101,42,59,0,1,1,0,26,24,0,1,1,2
"2011","E00012293","E00012293","Total",122,113,48,65,1,1,1,0,6,5,0,0,1,1
"2011","E00012302","E00012302","Total",125,114,45,69,0,3,1,2,7,7,0,0,0,1
"2011","E00012304","E00012304","Total",133,117,56,61,1,4,1,3,9,9,0,0,0,2
"2011","E00012290","E00012290","Total",127,102,58,44,0,2,2,0,23,18,0,5,0,0
"2011","E00012295","E00012295","Total",125,109,46,63,1,2,1,1,13,11,0,2,0,0
"2011","E00012296","E00012296","Total",121,104,44,60,0,2,0,2,14,14,0,0,0,1
"2011","E00012298","E00012298","Total",132,122,52,70,0,3,2,1,5,4,0,1,0,2
"2011","E00012303","E00012303","Total",126,114,52,62,0,5,1,4,6,5,0,0,1,1
"2011","E00012428","E00012428","Total",177,138,42,96,4,8,2,6,25,24,0,1,0,2
"2011","E00012431","E00012431","Total",151,103,58,45,2,17,12,5,29,23,2,3,1,0
"2011","E00012450","E00012450","Total",142,131,49,82,1,2,1,1,6,5,0,1,0,2
"2011","E00176478","E00176478","Total",48,18,2,16,2,17,2,15,11,10,0,0,1,0
"2011","E00176479","E00176479","Total",106,15,3,12,0,3,0,3,87,15,45,0,27,1
"2011","E00176480","E00176480","Total",71,25,6,19,8,21,1,20,17,15,0,2,0,0
"2011","E00012247","E00012247","Total",136,129,74,55,0,0,0,0,7,6,1,0,0,0
"2011","E00012251","E00012251","Total",133,112,58,54,0,5,2,3,13,11,1,0,1,3
"2011","E00012253","E00012253","Total",142,132,74,58,0,1,1,0,9,8,1,0,0,0
"2011","E00012257","E00012257","Total",132,121,70,51,1,2,2,0,8,6,0,2,0,0
"2011","E00012245","E00012245","Total",114,108,58,50,0,1,0,1,5,4,1,0,0,0
"2011","E00012246","E00012246","Total",122,112,65,47,0,1,1,0,9,9,0,0,0,0
"2011","E00012248","E00012248","Total",123,116,67,49,0,0,0,0,7,6,1,0,0,0
"2011","E00012249","E00012249","Total",129,121,60,61,1,0,0,0,7,6,1,0,0,0
"2011","E00012250","E00012250","Total",134,125,85,40,0,0,0,0,9,9,0,0,0,0
"2011","E00012254","E00012254","Total",101,26,11,15,0,42,34,8,31,28,0,3,0,2
"2011","E00012256","E00012256","Total",125,103,64,39,2,3,2,1,16,15,0,1,0,1
"2011","E00012258","E00012258","Total",127,110,56,54,0,0,0,0,15,14,0,1,0,2
"2011","E00012260","E00012260","Total",124,102,61,41,0,2,2,0,16,15,0,1,0,4
"2011","E00012266","E00012266","Total",120,111,66,45,0,4,1,3,4,4,0,0,0,1
"2011","E00012255","E00012255","Total",139,121,52,69,0,2,1,1,14,11,0,3,0,2
"2011","E00012259","E00012259","Total",133,128,74,54,1,1,1,0,3,3,0,0,0,0
"2011","E00012262","E00012262","Total",105,50,21,29,0,5,5,0,50,15,19,0,16,0
"2011","E00012263","E00012263","Total",129,118,57,61,1,1,1,0,7,7,0,0,0,2
"2011","E00012264","E00012264","Total",116,106,51,55,0,6,6,0,2,2,0,0,0,2
"2011","E00012265","E00012265","Total",146,106,52,54,0,26,23,3,14,12,0,2,0,0
"2011","E00012269","E00012269","Total",122,104,46,58,0,7,6,1,10,8,0,2,0,1
"2011","E00012271","E00012271","Total",126,101,34,67,1,15,15,0,8,8,0,0,0,1
"2011","E00012272","E00012272","Total",113,105,49,56,0,1,1,0,6,6,0,0,0,1
"2011","E00012252","E00012252","Total",122,82,39,43,2,19,14,5,19,19,0,0,0,0
"2011","E00012261","E00012261","Total",144,135,74,61,0,1,0,1,8,7,0,1,0,0
"2011","E00012267","E00012267","Total",142,127,58,69,0,3,2,1,12,12,0,0,0,0
"2011","E00012268","E00012268","Total",108,104,68,36,0,0,0,0,3,3,0,0,0,1
"2011","E00012270","E00012270","Total",131,118,73,45,1,1,0,1,11,11,0,0,0,0
"2011","E00012273","E00012273","Total",132,130,75,55,0,0,0,0,2,2,0,0,0,0
"2011","E00012274","E00012274","Total",128,118,56,62,0,2,1,1,7,6,0,1,0,1
"2011","E00012275","E00012275","Total",137,102,41,61,0,21,1,20,13,10,1,2,0,1
"2011","E00012494","E00012494","Total",119,110,62,48,0,2,2,0,6,5,0,0,1,1
"2011","E00012504","E00012504","Total",117,100,55,45,0,3,2,1,13,13,0,0,0,1
"2011","E00012508","E00012508","Total",133,110,60,50,0,2,0,2,20,19,0,1,0,1
"2011","E00012512","E00012512","Total",146,136,78,58,0,2,0,2,7,6,0,0,1,1
"2011","E00012514","E00012514","Total",132,92,46,46,0,4,2,2,36,35,0,1,0,0
"2011","E00012505","E00012505","Total",148,128,63,65,0,1,1,0,19,17,2,0,0,0
"2011","E00012511","E00012511","Total",140,132,76,56,0,0,0,0,7,7,0,0,0,1
"2011","E00012513","E00012513","Total",120,40,35,5,0,65,4,61,12,10,0,0,2,3
"2011","E00012517","E00012517","Total",136,125,71,54,0,2,1,1,7,6,0,1,0,2
"2011","E00012491","E00012491","Total",107,71,22,49,1,4,4,0,28,16,8,0,4,3
"2011","E00012518","E00012518","Total",131,122,72,50,1,2,1,1,6,6,0,0,0,0
"2011","E00012519","E00012519","Total",135,113,55,58,0,3,1,2,15,14,1,0,0,4
"2011","E00012524","E00012524","Total",117,105,60,45,0,0,0,0,11,11,0,0,0,1
"2011","E00012211","E00012211","Total",140,118,42,76,1,5,1,4,16,15,0,1,0,0
"2011","E00012234","E00012234","Total",133,112,39,73,0,1,0,1,20,19,0,1,0,0
"2011","E00012238","E00012238","Total",108,92,32,60,3,2,2,0,9,9,0,0,0,2
"2011","E00012243","E00012243","Total",122,104,39,65,2,1,1,0,14,14,0,0,0,1
"2011","E00012213","E00012213","Total",124,99,46,53,1,17,14,3,5,5,0,0,0,2
"2011","E00012241","E00012241","Total",106,82,34,48,0,3,1,2,20,17,0,3,0,1
"2011","E00012242","E00012242","Total",131,116,54,62,0,1,1,0,13,13,0,0,0,1
"2011","E00012244","E00012244","Total",132,103,41,62,1,11,10,1,15,15,0,0,0,2
"2011","E00012235","E00012235","Total",120,68,27,41,0,21,2,19,29,29,0,0,0,2
"2011","E00012236","E00012236","Total",129,118,43,75,0,4,4,0,6,6,0,0,0,1
"2011","E00012239","E00012239","Total",128,106,43,63,2,5,4,1,12,12,0,0,0,3
"2011","E00012240","E00012240","Total",123,113,47,66,0,1,1,0,9,9,0,0,0,0
"2011","E00012209","E00012209","Total",119,98,45,53,1,7,7,0,13,12,0,1,0,0
"2011","E00012215","E00012215","Total",110,97,43,54,1,1,0,1,9,9,0,0,0,2
"2011","E00012217","E00012217","Total",130,104,39,65,0,5,5,0,19,16,0,1,2,2
"2011","E00012218","E00012218","Total",122,92,35,57,0,8,6,2,22,22,0,0,0,0
"2011","E00012219","E00012219","Total",118,72,28,44,3,23,22,1,20,20,0,0,0,0
"2011","E00012210","E00012210","Total",139,77,34,43,0,52,49,3,9,8,1,0,0,1
"2011","E00012212","E00012212","Total",140,76,28,48,1,41,35,6,22,18,1,3,0,0
"2011","E00012214","E00012214","Total",117,100,29,71,0,9,6,3,7,7,0,0,0,1
"2011","E00012216","E00012216","Total",129,68,35,33,1,42,36,6,17,16,0,1,0,1
"2011","E00012237","E00012237","Total",136,100,40,60,0,18,12,6,18,18,0,0,0,0
"2011","E00012012","E00012012","Total",152,81,33,48,1,5,3,2,64,61,1,2,0,1
"2011","E00012042","E00012042","Total",131,59,27,32,1,38,34,4,33,31,0,2,0,0
"2011","E00012043","E00012043","Total",133,65,39,26,0,4,1,3,61,60,0,1,0,3
"2011","E00176456","E00176456","Total",67,52,27,25,0,1,1,0,12,10,0,2,0,2
"2011","E00176459","E00176459","Total",44,34,23,11,0,3,1,2,6,6,0,0,0,1
"2011","E00012506","E00012506","Total",135,99,60,39,0,3,2,1,31,27,1,3,0,2
"2011","E00012507","E00012507","Total",135,92,44,48,1,16,14,2,25,24,1,0,0,1
"2011","E00012509","E00012509","Total",160,62,32,30,1,54,51,3,42,38,0,2,2,1
"2011","E00012516","E00012516","Total",168,98,40,58,2,2,0,2,65,61,1,3,0,1
"2011","E00176455","E00176455","Total",133,87,40,47,7,9,4,5,30,29,0,1,0,0
"2011","E00176481","E00176481","Total",154,80,55,25,4,17,3,14,52,51,0,1,0,1
"2011","E00012515","E00012515","Total",161,79,33,46,1,60,37,23,18,17,1,0,0,3
"2011","E00012520","E00012520","Total",119,49,23,26,0,60,5,55,9,3,4,1,1,1
"2011","E00012521","E00012521","Total",165,53,29,24,0,56,33,23,50,49,0,1,0,6
"2011","E00012522","E00012522","Total",146,65,16,49,1,10,5,5,70,34,26,0,10,0
"2011","E00012523","E00012523","Total",127,90,42,48,0,3,0,3,32,29,2,1,0,2
"2011","E00012492","E00012492","Total",89,31,19,12,0,4,1,3,52,8,29,0,15,2
"2011","E00012493","E00012493","Total",86,9,2,7,0,10,1,9,66,2,36,0,28,1
"2011","E00012500","E00012500","Total",76,49,20,29,0,13,9,4,13,10,1,1,1,1
"2011","E00012526","E00012526","Total",107,62,37,25,0,31,28,3,13,9,0,1,3,1
"2011","E00012548","E00012548","Total",113,41,19,22,0,47,41,6,25,24,0,1,0,0
"2011","E00012551","E00012551","Total",97,28,13,15,0,35,33,2,32,31,0,1,0,2
"2011","E00012552","E00012552","Total",131,78,42,36,1,10,3,7,41,38,0,1,2,1
"2011","E00012557","E00012557","Total",131,77,31,46,2,21,16,5,31,30,0,0,1,0
"2011","E00012558","E00012558","Total",115,49,22,27,0,48,38,10,14,14,0,0,0,4
"2011","E00012527","E00012527","Total",121,69,20,49,14,18,13,5,17,15,0,1,1,3
"2011","E00012528","E00012528","Total",141,50,18,32,0,41,15,26,48,48,0,0,0,2
"2011","E00012550","E00012550","Total",116,48,20,28,2,33,26,7,33,30,1,0,2,0
"2011","E00012556","E00012556","Total",113,50,23,27,0,40,38,2,21,19,0,1,1,2
"2011","E00012559","E00012559","Total",112,71,29,42,2,11,6,5,25,23,1,1,0,3
"2011","E00012542","E00012542","Total",132,35,16,19,0,29,18,11,64,64,0,0,0,4
"2011","E00012543","E00012543","Total",133,72,27,45,2,8,7,1,48,47,0,1,0,3
"2011","E00012544","E00012544","Total",147,27,9,18,0,80,39,41,37,34,0,3,0,3
"2011","E00012545","E00012545","Total",116,45,13,32,0,46,43,3,22,21,0,1,0,3
"2011","E00012546","E00012546","Total",119,32,12,20,0,72,69,3,14,12,0,2,0,1
"2011","E00176476","E00176476","Total",141,12,6,6,1,111,104,7,16,15,0,1,0,1
"2011","E00176477","E00176477","Total",121,23,6,17,25,26,13,13,46,45,0,1,0,1
"2011","E00012547","E00012547","Total",146,106,48,58,2,5,1,4,33,28,2,2,1,0
"2011","E00012553","E00012553","Total",115,77,38,39,1,3,2,1,33,33,0,0,0,1
"2011","E00012554","E00012554","Total",156,67,21,46,1,46,39,7,40,40,0,0,0,2
"2011","E00012555","E00012555","Total",132,70,20,50,2,10,8,2,50,50,0,0,0,0
"2011","E00012529","E00012529","Total",152,84,36,48,2,16,7,9,47,42,0,5,0,3
"2011","E00012531","E00012531","Total",90,35,16,19,0,34,24,10,20,20,0,0,0,1
"2011","E00012532","E00012532","Total",146,64,26,38,2,33,23,10,46,44,0,0,2,1
"2011","E00012549","E00012549","Total",153,87,36,51,1,10,7,3,55,49,0,5,1,0
"2011","E00012560","E00012560","Total",141,107,58,49,0,7,4,3,27,25,0,2,0,0
"2011","E00012561","E00012561","Total",115,62,29,33,0,23,21,2,30,28,1,0,1,0
"2011","E00012562","E00012562","Total",118,93,48,45,0,17,15,2,7,6,0,0,1,1
"2011","E00012564","E00012564","Total",70,35,15,20,0,6,3,3,27,25,0,2,0,2
"2011","E00012565","E00012565","Total",66,17,8,9,0,19,12,7,28,27,0,0,1,2
"2011","E00012013","E00012013","Total",111,79,35,44,0,15,3,12,16,15,0,1,0,1
"2011","E00012015","E00012015","Total",114,74,31,43,1,13,8,5,25,21,1,3,0,1
"2011","E00012017","E00012017","Total",143,103,40,63,1,5,2,3,34,33,0,1,0,0
"2011","E00012018","E00012018","Total",139,87,39,48,2,6,4,2,41,39,0,2,0,3
"2011","E00012019","E00012019","Total",131,115,66,49,0,4,3,1,12,9,1,2,0,0
"2011","E00012021","E00012021","Total",136,97,47,50,2,11,9,2,19,16,1,1,1,7
"2011","E00012026","E00012026","Total",129,109,54,55,0,0,0,0,19,17,1,1,0,1
"2011","E00012027","E00012027","Total",124,115,65,50,0,1,1,0,8,8,0,0,0,0
"2011","E00176460","E00176460","Total",113,69,32,37,0,25,1,24,18,18,0,0,0,1
"2011","E00176461","E00176461","Total",96,42,11,31,0,2,0,2,51,51,0,0,0,1
"2011","E00176462","E00176462","Total",113,47,12,35,0,44,2,42,22,21,0,1,0,0
"2011","E00176475","E00176475","Total",111,35,7,28,1,13,0,13,62,61,0,0,1,0
"2011","E00012220","E00012220","Total",110,68,22,46,0,5,0,5,37,37,0,0,0,0
"2011","E00012221","E00012221","Total",134,48,17,31,2,40,11,29,43,41,0,0,2,1
"2011","E00012222","E00012222","Total",127,78,33,45,2,21,14,7,23,20,1,2,0,3
"2011","E00012224","E00012224","Total",120,78,33,45,2,30,26,4,8,7,1,0,0,2
"2011","E00012225","E00012225","Total",130,102,50,52,3,9,5,4,15,14,0,0,1,1
"2011","E00012495","E00012495","Total",112,90,41,49,0,3,1,2,19,19,0,0,0,0
"2011","E00012496","E00012496","Total",132,121,70,51,2,1,0,1,5,5,0,0,0,3
"2011","E00012498","E00012498","Total",130,118,57,61,0,1,1,0,11,11,0,0,0,0
"2011","E00012525","E00012525","Total",128,118,49,69,0,2,2,0,8,8,0,0,0,0
"2011","E00012497","E00012497","Total",123,102,37,65,1,3,3,0,16,16,0,0,0,1
"2011","E00012499","E00012499","Total",134,47,14,33,1,74,21,53,9,9,0,0,0,3
"2011","E00012501","E00012501","Total",106,92,40,52,2,4,1,3,8,8,0,0,0,0
"2011","E00012502","E00012502","Total",132,44,14,30,0,69,49,20,15,15,0,0,0,4
"2011","E00012503","E00012503","Total",118,80,34,46,2,11,8,3,21,19,0,1,1,4
"2011","E00012082","E00012082","Total",123,90,37,53,0,4,2,2,27,27,0,0,0,2
"2011","E00012083","E00012083","Total",113,70,19,51,3,5,5,0,34,34,0,0,0,1
"2011","E00012085","E00012085","Total",134,111,50,61,4,2,0,2,16,16,0,0,0,1
"2011","E00012088","E00012088","Total",124,96,40,56,2,4,1,3,16,14,1,0,1,6
"2011","E00012084","E00012084","Total",160,99,40,59,10,23,2,21,24,19,1,3,1,4
"2011","E00012091","E00012091","Total",143,105,47,58,3,16,0,16,18,17,0,0,1,1
"2011","E00012092","E00012092","Total",145,134,76,58,0,7,3,4,3,2,1,0,0,1
"2011","E00012093","E00012093","Total",120,109,50,59,0,0,0,0,9,9,0,0,0,2
"2011","E00012080","E00012080","Total",131,97,25,72,4,6,2,4,22,22,0,0,0,2
"2011","E00012086","E00012086","Total",122,95,40,55,0,2,0,2,23,21,0,1,1,2
"2011","E00012087","E00012087","Total",132,88,31,57,2,5,3,2,36,35,0,1,0,1
"2011","E00012109","E00012109","Total",141,114,50,64,6,2,2,0,19,19,0,0,0,0
"2011","E00012081","E00012081","Total",127,104,40,64,3,4,2,2,15,14,0,1,0,1
"2011","E00012103","E00012103","Total",103,38,9,29,3,1,0,1,60,56,1,3,0,1
"2011","E00012110","E00012110","Total",122,57,26,31,1,47,35,12,16,16,0,0,0,1
"2011","E00012111","E00012111","Total",116,96,34,62,0,3,3,0,15,14,0,1,0,2
"2011","E00012112","E00012112","Total",145,43,10,33,4,80,67,13,18,17,0,1,0,0
"2011","E00012095","E00012095","Total",125,104,47,57,0,3,3,0,18,17,0,1,0,0
"2011","E00012096","E00012096","Total",120,107,34,73,1,1,1,0,11,9,1,1,0,0
"2011","E00012097","E00012097","Total",120,104,38,66,1,1,1,0,14,13,0,1,0,0
"2011","E00012099","E00012099","Total",149,85,49,36,26,16,1,15,20,16,0,2,2,2
"2011","E00012101","E00012101","Total",118,97,51,46,3,2,0,2,16,16,0,0,0,0
"2011","E00012105","E00012105","Total",114,86,43,43,1,17,12,5,10,9,0,1,0,0
"2011","E00012107","E00012107","Total",134,114,42,72,0,3,3,0,17,17,0,0,0,0
"2011","E00012108","E00012108","Total",130,106,48,58,4,7,4,3,13,13,0,0,0,0
"2011","E00012020","E00012020","Total",133,90,41,49,6,8,7,1,29,29,0,0,0,0
"2011","E00012024","E00012024","Total",133,69,28,41,2,34,25,9,26,26,0,0,0,2
"2011","E00012025","E00012025","Total",106,43,17,26,1,44,37,7,17,17,0,0,0,1
"2011","E00012031","E00012031","Total",145,55,17,38,2,61,34,27,27,26,0,1,0,0
"2011","E00012032","E00012032","Total",112,23,7,16,2,68,58,10,19,19,0,0,0,0
"2011","E00012011","E00012011","Total",164,64,26,38,0,50,34,16,47,47,0,0,0,3
"2011","E00012028","E00012028","Total",106,66,33,33,1,8,4,4,30,28,0,1,1,1
"2011","E00012029","E00012029","Total",122,44,15,29,2,64,55,9,11,10,0,1,0,1
"2011","E00012034","E00012034","Total",174,90,32,58,1,58,44,14,25,24,0,1,0,0
"2011","E00012035","E00012035","Total",106,62,37,25,1,25,20,5,17,15,0,2,0,1
"2011","E00012090","E00012090","Total",111,68,31,37,2,24,23,1,15,15,0,0,0,2
"2011","E00012102","E00012102","Total",129,68,21,47,1,37,32,5,23,22,1,0,0,0
"2011","E00012104","E00012104","Total",119,75,21,54,8,18,9,9,17,17,0,0,0,1
"2011","E00012106","E00012106","Total",139,70,23,47,1,56,45,11,10,10,0,0,0,2
"2011","E00012229","E00012229","Total",123,48,9,39,3,62,56,6,9,9,0,0,0,1
"2011","E00012230","E00012230","Total",114,95,49,46,0,6,4,2,11,10,1,0,0,2
"2011","E00012231","E00012231","Total",138,88,44,44,6,20,18,2,23,21,0,2,0,1
"2011","E00012232","E00012232","Total",151,80,26,54,4,19,12,7,45,42,0,3,0,3
"2011","E00012233","E00012233","Total",126,85,39,46,9,1,0,1,31,30,1,0,0,0
"2011","E00012223","E00012223","Total",145,62,19,43,0,74,41,33,9,9,0,0,0,0
"2011","E00012226","E00012226","Total",120,27,11,16,3,75,35,40,15,15,0,0,0,0
"2011","E00012227","E00012227","Total",121,95,42,53,0,4,0,4,22,22,0,0,0,0
"2011","E00012228","E00012228","Total",131,53,16,37,0,28,21,7,49,48,0,1,0,1
"2011","E00011961","E00011961","Total",128,70,32,38,3,50,41,9,5,4,0,1,0,0
"2011","E00011962","E00011962","Total",131,46,13,33,0,67,56,11,14,12,0,1,1,4
"2011","E00011963","E00011963","Total",125,37,13,24,2,72,63,9,14,14,0,0,0,0
"2011","E00011966","E00011966","Total",131,23,4,19,10,75,71,4,22,21,0,1,0,1
"2011","E00011972","E00011972","Total",103,41,16,25,0,50,41,9,11,11,0,0,0,1
"2011","E00011964","E00011964","Total",136,90,39,51,1,8,4,4,37,35,0,1,1,0
"2011","E00011965","E00011965","Total",138,69,24,45,1,55,45,10,13,13,0,0,0,0
"2011","E00011967","E00011967","Total",153,87,26,61,2,30,14,16,32,28,0,4,0,2
"2011","E00011968","E00011968","Total",150,82,37,45,4,43,32,11,20,20,0,0,0,1
"2011","E00011969","E00011969","Total",128,77,13,64,3,9,3,6,37,35,0,2,0,2
"2011","E00012640","E00012640","Total",149,71,26,45,3,46,37,9,28,24,1,2,1,1
"2011","E00012654","E00012654","Total",112,52,14,38,1,33,21,12,26,25,0,0,1,0
"2011","E00012656","E00012656","Total",104,51,12,39,2,40,31,9,11,11,0,0,0,0
"2011","E00012662","E00012662","Total",130,87,25,62,5,17,3,14,19,18,0,1,0,2
"2011","E00012664","E00012664","Total",126,88,25,63,4,1,0,1,33,33,0,0,0,0
"2011","E00012659","E00012659","Total",131,58,16,42,0,51,45,6,20,19,0,0,1,2
"2011","E00012661","E00012661","Total",137,29,8,21,1,83,77,6,19,18,0,1,0,5
"2011","E00012663","E00012663","Total",137,64,24,40,1,27,18,9,42,40,1,1,0,3
"2011","E00012665","E00012665","Total",131,69,23,46,1,23,20,3,33,32,0,0,1,5
"2011","E00012669","E00012669","Total",129,67,20,47,2,25,23,2,32,32,0,0,0,3
"2011","E00012639","E00012639","Total",131,86,34,52,0,15,4,11,28,28,0,0,0,2
"2011","E00012657","E00012657","Total",122,73,30,43,2,36,29,7,9,9,0,0,0,2
"2011","E00012666","E00012666","Total",130,81,28,53,8,20,3,17,21,19,0,1,1,0
"2011","E00012667","E00012667","Total",126,45,14,31,3,60,40,20,15,13,0,1,1,3
"2011","E00012670","E00012670","Total",116,35,5,30,0,52,41,11,22,21,0,1,0,7
"2011","E00011946","E00011946","Total",123,92,42,50,0,4,3,1,22,22,0,0,0,5
"2011","E00011951","E00011951","Total",128,92,45,47,1,6,2,4,29,26,0,1,2,0
"2011","E00011970","E00011970","Total",122,86,45,41,1,6,4,2,26,23,0,3,0,3
"2011","E00011973","E00011973","Total",135,72,34,38,2,36,24,12,23,22,0,1,0,2
"2011","E00011941","E00011941","Total",141,106,52,54,3,6,5,1,25,24,0,0,1,1
"2011","E00011943","E00011943","Total",155,88,32,56,17,16,2,14,30,28,0,1,1,4
"2011","E00011949","E00011949","Total",128,92,32,60,0,7,3,4,27,26,0,1,0,2
"2011","E00011944","E00011944","Total",123,83,37,46,0,17,6,11,22,18,0,3,1,1
"2011","E00011945","E00011945","Total",153,83,27,56,1,33,18,15,35,28,1,3,3,1
"2011","E00011950","E00011950","Total",113,14,5,9,3,11,2,9,78,73,2,0,3,7
"2011","E00011971","E00011971","Total",125,90,40,50,1,5,2,3,29,28,0,1,0,0
"2011","E00011942","E00011942","Total",132,80,32,48,2,9,9,0,41,36,1,3,1,0
"2011","E00011947","E00011947","Total",119,70,24,46,2,10,8,2,36,34,0,0,2,1
"2011","E00011948","E00011948","Total",119,86,45,41,1,3,1,2,28,23,0,4,1,1
"2011","E00011956","E00011956","Total",123,96,39,57,0,5,2,3,21,20,0,1,0,1
"2011","E00011952","E00011952","Total",112,84,33,51,1,2,2,0,23,22,0,1,0,2
"2011","E00011953","E00011953","Total",131,98,44,54,1,9,5,4,21,20,0,1,0,2
"2011","E00011955","E00011955","Total",114,85,35,50,1,2,2,0,26,24,0,2,0,0
"2011","E00011958","E00011958","Total",117,87,37,50,0,4,3,1,25,24,0,1,0,1
"2011","E00012079","E00012079","Total",123,90,56,34,0,2,0,2,28,27,1,0,0,3
"2011","E00012089","E00012089","Total",125,96,30,66,2,4,3,1,19,17,0,2,0,4
"2011","E00012094","E00012094","Total",119,88,30,58,1,5,4,1,24,23,0,1,0,1
"2011","E00012098","E00012098","Total",128,83,21,62,0,6,1,5,39,38,0,1,0,0
"2011","E00012100","E00012100","Total",136,100,33,67,1,7,2,5,26,24,0,2,0,2
"2011","E00012016","E00012016","Total",150,96,47,49,1,27,23,4,22,21,0,1,0,4
"2011","E00012023","E00012023","Total",116,66,31,35,1,16,9,7,29,29,0,0,0,4
"2011","E00012030","E00012030","Total",112,55,21,34,2,37,32,5,17,17,0,0,0,1
"2011","E00012033","E00012033","Total",128,58,24,34,1,52,44,8,17,15,1,1,0,0
"2011","E00012036","E00012036","Total",126,52,24,28,2,49,43,6,23,22,0,1,0,0
"2011","E00012037","E00012037","Total",123,76,36,40,0,32,29,3,15,15,0,0,0,0
"2011","E00012038","E00012038","Total",128,62,26,36,0,49,40,9,17,16,0,1,0,0
"2011","E00012039","E00012039","Total",124,65,25,40,0,39,33,6,20,19,0,1,0,0
"2011","E00012040","E00012040","Total",111,47,15,32,0,41,38,3,22,22,0,0,0,1
"2011","E00012041","E00012041","Total",108,53,21,32,2,42,40,2,10,10,0,0,0,1
"2011","E00012533","E00012533","Total",144,107,44,63,1,4,3,1,30,29,0,0,1,2
"2011","E00012534","E00012534","Total",129,104,50,54,1,10,9,1,14,14,0,0,0,0
"2011","E00012535","E00012535","Total",114,80,39,41,0,3,0,3,30,29,0,1,0,1
"2011","E00012563","E00012563","Total",103,79,39,40,2,4,4,0,18,16,0,2,0,0
"2011","E00012530","E00012530","Total",136,53,14,39,2,9,3,6,71,70,1,0,0,1
"2011","E00012536","E00012536","Total",90,63,33,30,0,7,5,2,20,16,0,3,1,0
"2011","E00012537","E00012537","Total",129,70,27,43,2,41,37,4,15,14,0,1,0,1
"2011","E00012538","E00012538","Total",121,69,32,37,1,42,40,2,9,8,0,1,0,0
"2011","E00012539","E00012539","Total",116,39,2,37,16,8,2,6,53,53,0,0,0,0
"2011","E00012540","E00012540","Total",127,54,36,18,6,57,47,10,9,9,0,0,0,1
"2011","E00012677","E00012677","Total",109,52,12,40,2,8,0,8,46,44,0,2,0,1
"2011","E00012679","E00012679","Total",104,45,9,36,7,6,3,3,45,44,0,0,1,1
"2011","E00012684","E00012684","Total",134,68,14,54,1,9,0,9,56,56,0,0,0,0
"2011","E00012685","E00012685","Total",114,58,23,35,1,27,14,13,26,25,0,0,1,2
"2011","E00012709","E00012709","Total",111,32,8,24,1,6,4,2,71,70,0,1,0,1
"2011","E00012710","E00012710","Total",115,44,16,28,2,58,50,8,11,10,0,1,0,0
"2011","E00012711","E00012711","Total",108,41,10,31,1,49,35,14,17,16,0,1,0,0
"2011","E00012688","E00012688","Total",136,36,11,25,5,29,6,23,64,61,2,1,0,2
"2011","E00012692","E00012692","Total",128,45,14,31,2,18,11,7,63,61,0,2,0,0
"2011","E00012695","E00012695","Total",129,30,4,26,5,30,18,12,64,59,1,3,1,0
"2011","E00012698","E00012698","Total",124,85,19,66,2,13,3,10,24,24,0,0,0,0
"2011","E00012701","E00012701","Total",205,53,12,41,25,54,22,32,71,68,0,1,2,2
"2011","E00176463","E00176463","Total",117,61,9,52,0,26,4,22,30,30,0,0,0,0
"2011","E00176464","E00176464","Total",109,50,12,38,26,3,1,2,29,27,0,2,0,1
"2011","E00176465","E00176465","Total",125,52,9,43,9,31,2,29,32,31,1,0,0,1
"2011","E00012641","E00012641","Total",144,121,50,71,0,10,2,8,13,13,0,0,0,0
"2011","E00012660","E00012660","Total",132,68,16,52,20,8,0,8,35,33,0,2,0,1
"2011","E00012668","E00012668","Total",134,90,26,64,15,4,0,4,25,23,0,2,0,0
"2011","E00012671","E00012671","Total",132,93,31,62,3,9,1,8,26,25,0,1,0,1
"2011","E00176457","E00176457","Total",120,95,39,56,0,10,3,7,15,13,0,2,0,0
"2011","E00176458","E00176458","Total",123,78,13,65,3,17,1,16,23,23,0,0,0,2
"2011","E00012644","E00012644","Total",98,64,22,42,1,7,3,4,26,25,0,1,0,0
"2011","E00012646","E00012646","Total",113,82,44,38,2,4,2,2,23,21,0,2,0,2
"2011","E00012658","E00012658","Total",123,106,43,63,0,1,0,1,16,15,0,1,0,0
"2011","E00012673","E00012673","Total",115,83,27,56,1,10,1,9,21,21,0,0,0,0
"2011","E00012674","E00012674","Total",106,61,16,45,1,2,0,2,37,36,0,0,1,5
"2011","E00012643","E00012643","Total",123,6,2,4,0,101,2,99,16,16,0,0,0,0
"2011","E00012650","E00012650","Total",116,76,39,37,1,9,3,6,27,25,0,1,1,3
"2011","E00012672","E00012672","Total",126,10,3,7,1,105,4,101,8,8,0,0,0,2
"2011","E00012675","E00012675","Total",118,4,2,2,2,104,6,98,7,7,0,0,0,1
"2011","E00012642","E00012642","Total",125,81,30,51,1,7,3,4,33,30,0,3,0,3
"2011","E00012645","E00012645","Total",102,64,24,40,1,5,0,5,31,29,0,0,2,1
"2011","E00012648","E00012648","Total",106,84,27,57,0,2,2,0,19,18,0,1,0,1
"2011","E00012649","E00012649","Total",116,79,41,38,1,2,1,1,34,31,1,2,0,0
"2011","E00012647","E00012647","Total",132,79,30,49,1,14,4,10,34,32,0,2,0,4
"2011","E00012651","E00012651","Total",117,84,42,42,1,6,1,5,25,24,0,0,1,1
"2011","E00012652","E00012652","Total",115,39,8,31,13,34,2,32,24,24,0,0,0,5
"2011","E00012653","E00012653","Total",128,59,25,34,0,19,8,11,30,27,0,2,1,20
"2011","E00011984","E00011984","Total",129,89,27,62,0,9,5,4,29,27,0,2,0,2
"2011","E00011989","E00011989","Total",117,69,23,46,0,14,11,3,34,33,0,1,0,0
"2011","E00011990","E00011990","Total",110,55,13,42,1,38,33,5,14,13,0,0,1,2
"2011","E00011992","E00011992","Total",137,96,37,59,0,18,14,4,22,22,0,0,0,1
"2011","E00012000","E00012000","Total",106,34,13,21,1,57,28,29,12,12,0,0,0,2
"2011","E00011985","E00011985","Total",135,81,31,50,0,17,12,5,32,32,0,0,0,5
"2011","E00011986","E00011986","Total",119,48,20,28,2,37,32,5,30,28,1,1,0,2
"2011","E00011987","E00011987","Total",111,61,18,43,2,21,17,4,24,23,0,1,0,3
"2011","E00011991","E00011991","Total",118,69,26,43,0,31,20,11,15,15,0,0,0,3
"2011","E00011995","E00011995","Total",126,51,18,33,8,16,8,8,50,48,0,1,1,1
"2011","E00011988","E00011988","Total",116,54,25,29,1,37,35,2,23,21,0,1,1,1
"2011","E00011993","E00011993","Total",132,85,36,49,4,21,17,4,21,21,0,0,0,1
"2011","E00011997","E00011997","Total",122,59,13,46,1,45,32,13,15,13,0,2,0,2
"2011","E00011998","E00011998","Total",121,52,20,32,0,47,31,16,22,21,0,1,0,0
"2011","E00011994","E00011994","Total",127,77,26,51,0,30,21,9,19,19,0,0,0,1
"2011","E00011996","E00011996","Total",128,74,18,56,2,34,24,10,18,18,0,0,0,0
"2011","E00012002","E00012002","Total",159,54,17,37,16,71,25,46,17,17,0,0,0,1
"2011","E00012003","E00012003","Total",129,77,29,48,2,20,14,6,27,26,1,0,0,3
"2011","E00011975","E00011975","Total",143,62,26,36,1,67,63,4,10,8,1,1,0,3
"2011","E00011999","E00011999","Total",141,83,26,57,0,31,23,8,26,26,0,0,0,1
"2011","E00012001","E00012001","Total",123,60,17,43,3,18,14,4,41,40,0,0,1,1
"2011","E00012004","E00012004","Total",131,39,17,22,0,79,66,13,12,11,0,1,0,1
"2011","E00012006","E00012006","Total",137,69,14,55,0,48,39,9,20,19,0,1,0,0
"2011","E00012696","E00012696","Total",118,49,16,33,2,56,42,14,10,10,0,0,0,1
"2011","E00012697","E00012697","Total",141,94,36,58,1,17,12,5,27,25,0,1,1,2
"2011","E00012699","E00012699","Total",134,55,19,36,0,61,49,12,15,12,0,0,3,3
"2011","E00012700","E00012700","Total",132,73,32,41,5,42,30,12,11,11,0,0,0,1
"2011","E00012703","E00012703","Total",132,12,4,8,1,110,101,9,6,6,0,0,0,3
"2011","E00012680","E00012680","Total",120,78,33,45,0,27,26,1,15,14,0,1,0,0
"2011","E00012681","E00012681","Total",117,88,35,53,0,6,5,1,21,19,0,2,0,2
"2011","E00012683","E00012683","Total",177,81,35,46,0,71,24,47,25,22,0,2,1,0
"2011","E00012705","E00012705","Total",125,94,41,53,2,10,5,5,17,15,0,2,0,2
"2011","E00012708","E00012708","Total",133,113,49,64,0,4,4,0,14,12,0,2,0,2
"2011","E00012682","E00012682","Total",132,70,29,41,3,20,12,8,35,33,0,2,0,4
"2011","E00012704","E00012704","Total",140,79,35,44,2,40,36,4,19,19,0,0,0,0
"2011","E00012706","E00012706","Total",130,70,28,42,1,48,41,7,10,10,0,0,0,1
"2011","E00012707","E00012707","Total",116,72,22,50,2,16,10,6,26,26,0,0,0,0
"2011","E00012712","E00012712","Total",123,64,26,38,3,48,44,4,7,7,0,0,0,1
"2011","E00012687","E00012687","Total",117,59,16,43,1,44,28,16,12,10,0,0,2,1
"2011","E00012690","E00012690","Total",117,36,9,27,2,62,51,11,16,16,0,0,0,1
"2011","E00012691","E00012691","Total",160,118,45,73,1,9,7,2,31,26,1,3,1,1
"2011","E00012693","E00012693","Total",132,74,19,55,0,44,37,7,14,14,0,0,0,0
"2011","E00012676","E00012676","Total",121,37,16,21,0,52,47,5,31,31,0,0,0,1
"2011","E00012678","E00012678","Total",129,64,27,37,0,48,36,12,17,17,0,0,0,0
"2011","E00012686","E00012686","Total",122,54,21,33,1,45,36,9,20,20,0,0,0,2
"2011","E00012689","E00012689","Total",109,31,7,24,13,46,4,42,19,18,0,1,0,0
"2011","E00012694","E00012694","Total",122,45,16,29,0,62,49,13,14,12,0,1,1,1
"2011","E00011954","E00011954","Total",137,84,34,50,7,9,4,5,35,34,0,0,1,2
"2011","E00011957","E00011957","Total",137,96,43,53,1,8,3,5,31,29,0,2,0,1
"2011","E00011959","E00011959","Total",138,51,16,35,0,66,23,43,20,19,0,1,0,1
"2011","E00011960","E00011960","Total",151,29,22,7,1,94,74,20,23,21,2,0,0,4
"2011","E00012459","E00012459","Total",161,45,13,32,8,83,58,25,20,19,0,0,1,5
"2011","E00012460","E00012460","Total",117,95,49,46,0,8,5,3,12,12,0,0,0,2
"2011","E00012462","E00012462","Total",109,77,40,37,0,5,3,2,26,26,0,0,0,1
"2011","E00012465","E00012465","Total",119,70,31,39,1,16,6,10,30,28,0,1,1,2
"2011","E00012458","E00012458","Total",123,68,27,41,0,34,31,3,19,17,0,1,1,2
"2011","E00012463","E00012463","Total",118,65,20,45,2,39,31,8,11,10,0,1,0,1
"2011","E00012487","E00012487","Total",130,82,27,55,1,29,20,9,17,16,0,1,0,1
"2011","E00012490","E00012490","Total",120,37,8,29,2,65,59,6,15,15,0,0,0,1
"2011","E00012455","E00012455","Total",173,82,14,68,35,13,7,6,40,39,0,1,0,3
"2011","E00012467","E00012467","Total",137,43,14,29,1,53,40,13,40,40,0,0,0,0
"2011","E00012468","E00012468","Total",135,16,2,14,0,97,10,87,20,18,0,2,0,2
"2011","E00012469","E00012469","Total",134,22,9,13,0,82,77,5,29,28,0,1,0,1
"2011","E00012489","E00012489","Total",103,45,16,29,2,46,17,29,10,10,0,0,0,0
"2011","E00012481","E00012481","Total",136,82,25,57,1,18,8,10,34,33,0,1,0,1
"2011","E00012482","E00012482","Total",129,44,11,33,1,56,45,11,21,21,0,0,0,7
"2011","E00012483","E00012483","Total",127,34,11,23,2,68,61,7,23,23,0,0,0,0
"2011","E00012485","E00012485","Total",136,40,8,32,0,79,64,15,17,17,0,0,0,0
"2011","E00012486","E00012486","Total",120,22,9,13,0,89,85,4,8,8,0,0,0,1
"2011","E00011979","E00011979","Total",119,79,34,45,2,11,8,3,26,24,0,2,0,1
"2011","E00012005","E00012005","Total",134,72,31,41,2,38,32,6,21,17,1,3,0,1
"2011","E00012007","E00012007","Total",135,57,18,39,3,47,16,31,26,25,0,0,1,2
"2011","E00012008","E00012008","Total",125,78,28,50,1,6,2,4,40,36,1,1,2,0
"2011","E00012009","E00012009","Total",121,57,22,35,0,47,40,7,16,16,0,0,0,1
"2011","E00011976","E00011976","Total",130,48,17,31,2,51,7,44,24,23,1,0,0,5
"2011","E00011977","E00011977","Total",118,90,34,56,1,8,1,7,16,16,0,0,0,3
"2011","E00011978","E00011978","Total",137,80,43,37,1,12,9,3,44,41,1,1,1,0
"2011","E00011980","E00011980","Total",168,76,34,42,2,25,6,19,62,60,0,1,1,3
"2011","E00012010","E00012010","Total",127,71,26,45,2,38,25,13,15,15,0,0,0,1
"2011","E00012456","E00012456","Total",115,54,20,34,1,38,33,5,20,18,0,1,1,2
"2011","E00012457","E00012457","Total",129,56,22,34,0,46,38,8,25,25,0,0,0,2
"2011","E00012466","E00012466","Total",104,46,17,29,1,19,10,9,37,32,0,3,2,1
"2011","E00012470","E00012470","Total",149,79,25,54,1,30,3,27,37,35,0,2,0,2
"2011","E00012461","E00012461","Total",123,45,9,36,2,20,5,15,56,53,0,3,0,0
"2011","E00012464","E00012464","Total",124,67,21,46,10,35,28,7,11,10,0,1,0,1
"2011","E00012480","E00012480","Total",139,98,38,60,2,7,7,0,31,30,0,1,0,1
"2011","E00012484","E00012484","Total",205,108,42,66,4,41,13,28,49,48,0,1,0,3
"2011","E00012488","E00012488","Total",135,78,26,52,1,23,16,7,33,32,0,1,0,0
"2011","E00012471","E00012471","Total",102,64,16,48,2,4,2,2,29,29,0,0,0,3
"2011","E00012475","E00012475","Total",165,32,6,26,0,18,13,5,113,104,4,5,0,2
"2011","E00012476","E00012476","Total",120,37,18,19,1,54,31,23,25,24,1,0,0,3
"2011","E00012478","E00012478","Total",126,44,17,27,1,48,43,5,29,26,0,3,0,4
"2011","E00012479","E00012479","Total",130,7,2,5,2,109,100,9,12,12,0,0,0,0
"2011","E00012472","E00012472","Total",105,75,25,50,1,6,1,5,23,18,1,4,0,0
"2011","E00012473","E00012473","Total",134,86,25,61,2,9,1,8,34,34,0,0,0,3
"2011","E00012474","E00012474","Total",111,82,37,45,0,4,3,1,23,23,0,0,0,2
"2011","E00012477","E00012477","Total",115,80,29,51,1,9,2,7,23,21,0,2,0,2
"2011","E00012388","E00012388","Total",220,76,14,62,9,99,44,55,33,32,0,1,0,3
"2011","E00012389","E00012389","Total",125,69,35,34,0,43,29,14,12,12,0,0,0,1
"2011","E00012394","E00012394","Total",119,90,38,52,1,7,4,3,20,18,0,2,0,1
"2011","E00012395","E00012395","Total",113,71,27,44,2,22,19,3,17,14,0,3,0,1
"2011","E00012399","E00012399","Total",122,86,27,59,1,16,14,2,19,17,0,2,0,0
"2011","E00012390","E00012390","Total",110,82,37,45,1,8,1,7,19,17,0,2,0,0
"2011","E00012391","E00012391","Total",119,74,23,51,2,21,14,7,22,21,0,1,0,0
"2011","E00012392","E00012392","Total",121,6,3,3,0,108,28,80,7,7,0,0,0,0
"2011","E00012393","E00012393","Total",134,93,45,48,2,5,2,3,32,31,0,0,1,2
"2011","E00012397","E00012397","Total",130,95,36,59,0,8,4,4,26,25,0,1,0,1
"2011","E00012567","E00012567","Total",128,67,26,41,1,44,30,14,14,13,0,1,0,2
"2011","E00012601","E00012601","Total",153,26,6,20,11,106,16,90,10,10,0,0,0,0
"2011","E00012602","E00012602","Total",134,87,30,57,2,30,20,10,14,14,0,0,0,1
"2011","E00176469","E00176469","Total",107,22,8,14,26,28,13,15,31,28,0,0,3,0
"2011","E00176471","E00176471","Total",113,56,24,32,4,40,24,16,12,12,0,0,0,1
"2011","E00012572","E00012572","Total",127,49,14,35,2,58,50,8,15,13,1,1,0,3
"2011","E00012573","E00012573","Total",150,101,52,49,0,30,20,10,17,16,0,1,0,2
"2011","E00012575","E00012575","Total",140,86,25,61,2,38,30,8,14,14,0,0,0,0
"2011","E00012603","E00012603","Total",146,80,31,49,5,48,37,11,13,12,0,1,0,0
"2011","E00012585","E00012585","Total",126,41,7,34,4,32,6,26,49,48,0,0,1,0
"2011","E00012591","E00012591","Total",133,45,23,22,1,79,26,53,6,5,0,1,0,2
"2011","E00012593","E00012593","Total",116,63,30,33,0,40,27,13,12,9,0,3,0,1
"2011","E00012597","E00012597","Total",142,65,21,44,8,34,11,23,34,33,0,1,0,1
"2011","E00176468","E00176468","Total",110,63,25,38,1,26,18,8,20,19,0,1,0,0
"2011","E00176470","E00176470","Total",259,49,13,36,33,83,16,67,92,91,1,0,0,2
"2011","E00012174","E00012174","Total",106,50,22,28,1,37,28,9,17,17,0,0,0,1
"2011","E00012203","E00012203","Total",139,97,45,52,1,11,9,2,29,28,0,1,0,1
"2011","E00012204","E00012204","Total",111,21,7,14,1,76,67,9,9,9,0,0,0,4
"2011","E00012207","E00012207","Total",126,37,12,25,2,63,46,17,21,20,1,0,0,3
"2011","E00012208","E00012208","Total",106,15,5,10,0,78,65,13,11,10,0,0,1,2
"2011","E00012568","E00012568","Total",126,72,32,40,3,30,23,7,17,17,0,0,0,4
"2011","E00012569","E00012569","Total",133,96,42,54,1,7,1,6,28,28,0,0,0,1
"2011","E00012574","E00012574","Total",113,96,44,52,0,5,5,0,12,11,0,1,0,0
"2011","E00012592","E00012592","Total",136,83,32,51,14,11,1,10,27,25,0,2,0,1
"2011","E00012599","E00012599","Total",139,112,71,41,2,5,3,2,18,17,0,1,0,2
"2011","E00012589","E00012589","Total",136,79,32,47,1,7,3,4,47,45,1,0,1,2
"2011","E00012590","E00012590","Total",157,87,29,58,14,16,3,13,40,39,0,1,0,0
"2011","E00012594","E00012594","Total",110,65,26,39,0,17,0,17,26,26,0,0,0,2
"2011","E00012595","E00012595","Total",138,51,18,33,1,27,12,15,57,54,1,1,1,2
"2011","E00176472","E00176472","Total",111,65,35,30,1,27,2,25,16,15,0,0,1,2
"2011","E00176473","E00176473","Total",119,27,4,23,0,51,10,41,41,40,0,1,0,0
"2011","E00012576","E00012576","Total",121,36,11,25,2,68,57,11,14,13,0,1,0,1
"2011","E00012577","E00012577","Total",130,42,18,24,2,71,59,12,13,13,0,0,0,2
"2011","E00012578","E00012578","Total",131,64,30,34,0,51,35,16,14,13,0,1,0,2
"2011","E00012579","E00012579","Total",126,49,24,25,1,50,38,12,26,25,0,1,0,0
"2011","E00012580","E00012580","Total",111,41,12,29,2,52,41,11,14,11,1,2,0,2
"2011","E00012582","E00012582","Total",112,101,50,51,0,4,2,2,6,6,0,0,0,1
"2011","E00012583","E00012583","Total",162,35,18,17,8,94,12,82,22,18,0,1,3,3
"2011","E00012584","E00012584","Total",131,121,58,63,0,2,0,2,8,7,0,0,1,0
"2011","E00012587","E00012587","Total",119,106,60,46,0,4,3,1,6,4,0,2,0,3
"2011","E00012596","E00012596","Total",120,77,29,48,1,4,2,2,38,34,0,4,0,0
"2011","E00011974","E00011974","Total",137,63,27,36,0,26,5,21,45,43,0,2,0,3
"2011","E00011982","E00011982","Total",129,81,26,55,1,7,3,4,38,38,0,0,0,2
"2011","E00011983","E00011983","Total",159,120,67,53,0,8,5,3,30,26,0,4,0,1
"2011","E00176466","E00176466","Total",139,44,16,28,27,28,2,26,40,40,0,0,0,0
"2011","E00176467","E00176467","Total",161,4,1,3,55,89,15,74,12,11,0,1,0,1
"2011","E00012396","E00012396","Total",129,86,28,58,1,13,2,11,29,29,0,0,0,0
"2011","E00012398","E00012398","Total",129,91,41,50,0,16,1,15,22,20,1,0,1,0
"2011","E00012401","E00012401","Total",132,105,41,64,0,9,4,5,18,18,0,0,0,0
"2011","E00012404","E00012404","Total",143,99,46,53,1,13,1,12,30,29,1,0,0,0
"2011","E00012386","E00012386","Total",140,89,41,48,1,8,3,5,39,38,0,0,1,3
"2011","E00012400","E00012400","Total",143,74,31,43,2,24,16,8,41,38,0,1,2,2
"2011","E00012402","E00012402","Total",128,86,31,55,2,6,3,3,34,30,0,4,0,0
"2011","E00012406","E00012406","Total",126,69,34,35,1,11,3,8,45,44,0,1,0,0
"2011","E00012403","E00012403","Total",128,79,28,51,1,7,0,7,40,39,0,1,0,1
"2011","E00012407","E00012407","Total",116,78,26,52,0,3,0,3,33,32,0,1,0,2
"2011","E00012410","E00012410","Total",132,87,37,50,1,7,5,2,37,36,0,0,1,0
"2011","E00012411","E00012411","Total",162,103,44,59,4,29,5,24,25,23,0,2,0,1
"2011","E00012415","E00012415","Total",118,78,27,51,5,4,1,3,30,30,0,0,0,1
"2011","E00012405","E00012405","Total",132,92,40,52,1,1,0,1,37,34,1,1,1,1
"2011","E00012408","E00012408","Total",118,85,27,58,1,8,3,5,22,22,0,0,0,2
"2011","E00012414","E00012414","Total",120,57,18,39,2,32,2,30,28,26,0,1,1,1
"2011","E00012416","E00012416","Total",118,90,41,49,0,7,2,5,19,17,0,2,0,2
"2011","E00012179","E00012179","Total",93,20,7,13,0,5,3,2,66,64,0,2,0,2
"2011","E00012184","E00012184","Total",128,103,50,53,0,4,0,4,15,14,1,0,0,6
"2011","E00012185","E00012185","Total",128,84,41,43,1,22,19,3,21,19,1,1,0,0
"2011","E00012188","E00012188","Total",144,91,43,48,2,7,3,4,40,37,0,2,1,4
"2011","E00012202","E00012202","Total",132,62,33,29,0,4,2,2,63,59,2,1,1,3
"2011","E00012175","E00012175","Total",125,58,28,30,0,14,9,5,51,46,2,1,2,2
"2011","E00012181","E00012181","Total",134,55,32,23,1,25,4,21,52,48,3,1,0,1
"2011","E00012183","E00012183","Total",115,45,15,30,0,21,4,17,48,44,2,0,2,1
"2011","E00012205","E00012205","Total",107,90,63,27,1,9,6,3,7,7,0,0,0,0
"2011","E00012206","E00012206","Total",111,90,46,44,1,4,2,2,16,16,0,0,0,0
"2011","E00012177","E00012177","Total",120,54,8,46,2,9,4,5,53,51,1,1,0,2
"2011","E00012190","E00012190","Total",144,59,11,48,1,4,1,3,79,79,0,0,0,1
"2011","E00012191","E00012191","Total",120,66,35,31,2,7,4,3,43,42,0,0,1,2
"2011","E00012194","E00012194","Total",119,34,7,27,1,23,4,19,59,56,1,2,0,2
"2011","E00012198","E00012198","Total",120,39,14,25,0,47,41,6,34,32,0,1,1,0
"2011","E00012566","E00012566","Total",130,46,28,18,1,61,11,50,18,18,0,0,0,4
"2011","E00012570","E00012570","Total",129,92,49,43,1,12,0,12,23,22,0,1,0,1
"2011","E00012571","E00012571","Total",129,77,29,48,0,15,6,9,37,36,0,0,1,0
"2011","E00012581","E00012581","Total",96,68,62,6,0,3,1,2,25,25,0,0,0,0
"2011","E00012600","E00012600","Total",138,75,30,45,0,10,3,7,51,49,0,2,0,2
"2011","E00012193","E00012193","Total",141,72,19,53,1,9,4,5,59,58,0,1,0,0
"2011","E00012196","E00012196","Total",138,70,24,46,0,2,1,1,65,61,0,3,1,1
"2011","E00012200","E00012200","Total",143,84,34,50,0,2,1,1,53,49,0,4,0,4
"2011","E00012201","E00012201","Total",125,87,43,44,1,6,4,2,30,27,0,3,0,1
"2011","E00012176","E00012176","Total",98,28,12,16,0,66,11,55,3,3,0,0,0,1
"2011","E00012178","E00012178","Total",119,76,42,34,0,12,11,1,30,27,0,2,1,1
"2011","E00012180","E00012180","Total",118,49,19,30,0,23,17,6,42,41,1,0,0,4
"2011","E00012182","E00012182","Total",135,83,39,44,0,0,0,0,52,51,0,1,0,0
"2011","E00012186","E00012186","Total",146,86,29,57,0,5,4,1,53,53,0,0,0,2
"2011","E00012189","E00012189","Total",149,68,31,37,2,5,3,2,69,68,0,0,1,5
"2011","E00012187","E00012187","Total",143,80,16,64,5,8,5,3,49,48,0,0,1,1
"2011","E00012192","E00012192","Total",130,74,30,44,2,17,13,4,37,37,0,0,0,0
"2011","E00012195","E00012195","Total",125,58,24,34,0,11,5,6,53,51,0,1,1,3
"2011","E00012197","E00012197","Total",139,59,21,38,0,11,3,8,68,68,0,0,0,1
"2011","E00012199","E00012199","Total",173,64,19,45,0,10,6,4,98,89,6,3,0,1
"2011","E00012387","E00012387","Total",134,45,17,28,0,65,54,11,22,21,0,1,0,2
"2011","E00012409","E00012409","Total",126,83,33,50,0,7,6,1,34,33,0,1,0,2
"2011","E00012413","E00012413","Total",117,85,35,50,2,6,5,1,23,21,0,0,2,1
"2011","E00012417","E00012417","Total",142,49,20,29,0,81,66,15,9,7,0,1,1,3
"2011","E00012384","E00012384","Total",111,12,4,8,1,90,69,21,8,8,0,0,0,0
"2011","E00012385","E00012385","Total",133,33,8,25,1,73,66,7,25,24,0,0,1,1
"2011","E00012412","E00012412","Total",109,50,23,27,0,48,41,7,9,9,0,0,0,2
"2011","E00012418","E00012418","Total",129,84,35,49,1,16,5,11,27,27,0,0,0,1
"2011","E00012419","E00012419","Total",119,52,19,33,5,29,22,7,31,30,0,0,1,2
"2011","E00012422","E00012422","Total",155,87,16,71,0,6,5,1,62,60,0,2,0,0
"2011","E00012424","E00012424","Total",127,49,20,29,3,59,57,2,12,9,0,3,0,4
"2011","E00012434","E00012434","Total",119,57,14,43,0,8,6,2,53,51,0,2,0,1
"2011","E00012448","E00012448","Total",132,109,39,70,2,3,2,1,17,15,0,1,1,1
"2011","E00012451","E00012451","Total",112,93,41,52,2,1,1,0,16,16,0,0,0,0
"2011","E00012452","E00012452","Total",122,92,33,59,0,14,13,1,16,16,0,0,0,0
"2011","E00012427","E00012427","Total",115,65,35,30,0,7,3,4,42,42,0,0,0,1
"2011","E00012429","E00012429","Total",112,24,5,19,0,37,34,3,48,44,1,3,0,3
"2011","E00012432","E00012432","Total",128,85,36,49,3,6,3,3,33,32,0,1,0,1
"2011","E00012433","E00012433","Total",129,76,38,38,0,27,25,2,26,23,0,3,0,0
"2011","E00012435","E00012435","Total",140,93,52,41,0,5,4,1,41,40,0,1,0,1
"2011","E00012437","E00012437","Total",135,94,48,46,1,9,7,2,30,22,1,5,2,1
"2011","E00012421","E00012421","Total",130,116,61,55,0,2,2,0,10,9,0,1,0,2
"2011","E00012426","E00012426","Total",127,107,60,47,0,0,0,0,20,20,0,0,0,0
"2011","E00012446","E00012446","Total",127,94,39,55,0,24,11,13,9,8,0,1,0,0
"2011","E00012453","E00012453","Total",132,113,53,60,0,6,5,1,11,11,0,0,0,2
"2011","E00012436","E00012436","Total",150,95,34,61,0,14,12,2,41,40,0,1,0,0
"2011","E00012438","E00012438","Total",135,91,45,46,0,13,10,3,29,28,0,1,0,2
"2011","E00012439","E00012439","Total",121,93,39,54,1,12,10,2,14,12,0,2,0,1
"2011","E00012440","E00012440","Total",154,112,45,67,1,13,10,3,28,26,1,1,0,0
"2011","E00012441","E00012441","Total",118,92,49,43,0,11,10,1,15,14,0,1,0,0
"2011","E00012443","E00012443","Total",122,94,35,59,1,16,13,3,11,11,0,0,0,0
"2011","E00012444","E00012444","Total",113,96,40,56,0,5,5,0,10,9,0,1,0,2
"2011","E00012445","E00012445","Total",126,89,32,57,2,28,26,2,6,4,0,2,0,1
"2011","E00012447","E00012447","Total",118,98,40,58,0,8,6,2,11,10,0,1,0,1
"2011","E00165802","E00165802","Total",122,109,47,62,2,2,0,2,9,8,0,1,0,0
"2011","E00012783","E00012783","Total",136,98,41,57,0,5,4,1,33,30,1,2,0,0
"2011","E00012784","E00012784","Total",119,85,33,52,0,2,1,1,29,29,0,0,0,3
"2011","E00012785","E00012785","Total",128,52,19,33,0,26,14,12,49,47,0,2,0,1
"2011","E00012788","E00012788","Total",115,54,31,23,1,34,30,4,23,23,0,0,0,3
"2011","E00012814","E00012814","Total",133,93,50,43,0,2,1,1,38,35,1,2,0,0
"2011","E00012816","E00012816","Total",161,86,34,52,0,33,9,24,42,40,1,1,0,0
"2011","E00012808","E00012808","Total",113,57,29,28,0,16,11,5,37,37,0,0,0,3
"2011","E00012809","E00012809","Total",134,66,26,40,0,11,11,0,55,55,0,0,0,2
"2011","E00012811","E00012811","Total",193,92,41,51,0,19,8,11,79,73,2,4,0,3
"2011","E00012813","E00012813","Total",144,47,20,27,0,44,28,16,51,48,0,3,0,2
"2011","E00012817","E00012817","Total",148,64,23,41,0,40,2,38,44,42,0,1,1,0
"2011","E00012797","E00012797","Total",124,102,58,44,0,2,2,0,19,18,0,1,0,1
"2011","E00012798","E00012798","Total",124,86,57,29,0,6,2,4,31,31,0,0,0,1
"2011","E00012801","E00012801","Total",142,83,46,37,1,32,5,27,25,24,0,1,0,1
"2011","E00012803","E00012803","Total",147,81,47,34,0,6,2,4,55,54,0,1,0,5
"2011","E00012806","E00012806","Total",142,61,26,35,1,26,1,25,50,48,0,2,0,4
"2011","E00012799","E00012799","Total",122,88,50,38,0,2,1,1,31,29,0,2,0,1
"2011","E00012800","E00012800","Total",136,81,37,44,0,3,3,0,50,50,0,0,0,2
"2011","E00012802","E00012802","Total",141,72,44,28,0,29,6,23,39,37,0,0,2,1
"2011","E00012804","E00012804","Total",146,62,27,35,1,11,6,5,69,69,0,0,0,3
"2011","E00012805","E00012805","Total",100,77,35,42,0,2,1,1,21,20,0,1,0,0
"2011","E00012807","E00012807","Total",139,74,36,38,1,2,1,1,60,58,0,1,1,2
"2011","E00012810","E00012810","Total",142,82,48,34,2,2,0,2,55,52,0,3,0,1
"2011","E00012812","E00012812","Total",147,82,43,39,0,0,0,0,62,58,0,4,0,3
"2011","E00012815","E00012815","Total",121,101,45,56,0,4,3,1,15,14,0,1,0,1
"2011","E00012818","E00012818","Total",139,69,39,30,0,39,36,3,28,27,1,0,0,3
"2011","E00012761","E00012761","Total",134,47,22,25,1,64,63,1,20,20,0,0,0,2
"2011","E00012774","E00012774","Total",129,99,55,44,0,12,9,3,17,14,1,1,1,1
"2011","E00012775","E00012775","Total",116,39,13,26,0,60,56,4,14,13,0,1,0,3
"2011","E00012780","E00012780","Total",139,44,17,27,0,79,78,1,15,14,0,0,1,1
"2011","E00012750","E00012750","Total",129,78,19,59,2,32,32,0,13,12,0,0,1,4
"2011","E00012753","E00012753","Total",139,50,16,34,2,71,57,14,11,11,0,0,0,5
"2011","E00012754","E00012754","Total",114,72,28,44,0,29,26,3,12,12,0,0,0,1
"2011","E00012776","E00012776","Total",128,22,7,15,0,82,68,14,24,23,0,0,1,0
"2011","E00012781","E00012781","Total",123,76,21,55,1,19,16,3,26,25,0,1,0,1
"2011","E00012782","E00012782","Total",103,19,4,15,1,67,64,3,15,14,0,1,0,1
"2011","E00012758","E00012758","Total",163,53,28,25,4,44,4,40,62,60,1,1,0,0
"2011","E00012762","E00012762","Total",126,7,2,5,4,106,81,25,9,8,0,0,1,0
"2011","E00012764","E00012764","Total",170,18,3,15,10,118,76,42,22,20,0,1,1,2
"2011","E00012765","E00012765","Total",175,4,1,3,2,158,153,5,9,5,0,3,1,2
"2011","E00168185","E00168185","Total",118,31,10,21,0,52,46,6,32,32,0,0,0,3
"2011","E00168194","E00168194","Total",149,40,20,20,1,82,78,4,25,25,0,0,0,1
"2011","E00168858","E00168858","Total",126,29,3,26,9,55,16,39,33,31,0,2,0,0
"2011","E00012747","E00012747","Total",155,42,17,25,2,86,82,4,25,23,0,1,1,0
"2011","E00012749","E00012749","Total",155,38,15,23,1,98,94,4,16,16,0,0,0,2
"2011","E00012768","E00012768","Total",121,15,7,8,1,97,93,4,6,5,0,0,1,2
"2011","E00012771","E00012771","Total",137,18,2,16,2,106,102,4,8,6,1,1,0,3
"2011","E00168184","E00168184","Total",184,95,27,68,6,13,3,10,69,67,0,2,0,1
"2011","E00168186","E00168186","Total",99,14,6,8,9,65,21,44,10,9,0,0,1,1
"2011","E00168193","E00168193","Total",98,6,0,6,0,81,74,7,10,10,0,0,0,1
"2011","E00168856","E00168856","Total",232,9,2,7,114,97,15,82,10,10,0,0,0,2
"2011","E00013327","E00013327","Total",142,13,2,11,0,100,65,35,28,28,0,0,0,1
"2011","E00168187","E00168187","Total",122,39,12,27,7,12,8,4,63,63,0,0,0,1
"2011","E00168188","E00168188","Total",126,55,23,32,18,6,3,3,46,42,1,3,0,1
"2011","E00168190","E00168190","Total",122,29,10,19,2,52,21,31,38,38,0,0,0,1
"2011","E00168877","E00168877","Total",137,51,14,37,0,12,2,10,73,69,0,4,0,1
"2011","E00013324","E00013324","Total",120,36,11,25,0,61,60,1,23,22,0,0,1,0
"2011","E00013333","E00013333","Total",132,82,51,31,2,3,3,0,43,41,0,2,0,2
"2011","E00013334","E00013334","Total",131,87,49,38,0,7,6,1,34,33,0,1,0,3
"2011","E00013335","E00013335","Total",107,21,5,16,0,73,70,3,11,11,0,0,0,2
"2011","E00168189","E00168189","Total",111,52,31,21,1,21,10,11,37,36,0,1,0,0
"2011","E00168191","E00168191","Total",58,30,18,12,0,2,0,2,26,26,0,0,0,0
"2011","E00013032","E00013032","Total",127,12,4,8,0,105,13,92,7,6,0,0,1,3
"2011","E00013033","E00013033","Total",133,68,29,39,1,29,16,13,34,32,1,1,0,1
"2011","E00013034","E00013034","Total",168,67,33,34,12,35,16,19,52,51,0,1,0,2
"2011","E00013035","E00013035","Total",128,63,34,29,8,14,2,12,41,40,0,1,0,2
"2011","E00013040","E00013040","Total",120,46,20,26,1,13,8,5,57,57,0,0,0,3
"2011","E00013074","E00013074","Total",129,76,32,44,1,16,11,5,36,35,0,1,0,0
"2011","E00013079","E00013079","Total",118,92,39,53,0,2,1,1,22,21,0,0,1,2
"2011","E00013081","E00013081","Total",124,100,36,64,0,5,5,0,19,16,0,3,0,0
"2011","E00013082","E00013082","Total",121,95,40,55,0,2,1,1,22,22,0,0,0,2
"2011","E00013055","E00013055","Total",133,70,28,42,0,24,19,5,38,36,1,0,1,1
"2011","E00013056","E00013056","Total",122,77,28,49,0,14,12,2,29,28,1,0,0,2
"2011","E00013080","E00013080","Total",103,94,48,46,0,3,2,1,5,5,0,0,0,1
"2011","E00013083","E00013083","Total",132,88,45,43,2,9,3,6,33,30,0,2,1,0
"2011","E00013057","E00013057","Total",132,9,1,8,1,103,102,1,15,14,0,0,1,4
"2011","E00013058","E00013058","Total",138,16,3,13,1,105,100,5,11,10,0,1,0,5
"2011","E00013059","E00013059","Total",140,95,44,51,0,20,18,2,24,21,0,3,0,1
"2011","E00013060","E00013060","Total",113,62,28,34,2,4,3,1,44,38,0,5,1,1
"2011","E00013084","E00013084","Total",86,28,4,24,0,45,43,2,13,12,0,0,1,0
"2011","E00013075","E00013075","Total",114,51,4,47,0,1,0,1,61,57,0,4,0,1
"2011","E00013076","E00013076","Total",140,94,37,57,3,12,9,3,30,30,0,0,0,1
"2011","E00013077","E00013077","Total",152,105,45,60,3,16,15,1,24,23,0,1,0,4
"2011","E00013078","E00013078","Total",103,63,23,40,0,16,14,2,23,22,0,1,0,1
"2011","E00013089","E00013089","Total",113,34,19,15,0,64,30,34,14,13,1,0,0,1
"2011","E00013090","E00013090","Total",137,52,21,31,0,57,54,3,26,24,0,1,1,2
"2011","E00013091","E00013091","Total",129,25,12,13,0,93,89,4,8,8,0,0,0,3
"2011","E00013101","E00013101","Total",128,48,17,31,2,57,52,5,19,19,0,0,0,2
"2011","E00013112","E00013112","Total",116,24,11,13,0,78,70,8,14,14,0,0,0,0
"2011","E00013096","E00013096","Total",153,32,7,25,0,88,85,3,28,26,0,2,0,5
"2011","E00013097","E00013097","Total",128,32,8,24,0,74,64,10,18,16,0,2,0,4
"2011","E00013098","E00013098","Total",111,55,21,34,0,41,39,2,11,9,0,2,0,4
"2011","E00013102","E00013102","Total",154,26,8,18,0,119,112,7,6,6,0,0,0,3
"2011","E00013109","E00013109","Total",132,57,27,30,2,43,42,1,27,26,0,0,1,3
"2011","E00013110","E00013110","Total",134,41,19,22,0,62,56,6,25,25,0,0,0,6
"2011","E00013111","E00013111","Total",155,101,50,51,0,8,7,1,42,41,0,1,0,4
"2011","E00013114","E00013114","Total",142,7,3,4,0,114,105,9,15,14,0,1,0,6
"2011","E00013086","E00013086","Total",110,42,19,23,1,39,30,9,25,22,0,3,0,3
"2011","E00013087","E00013087","Total",94,38,16,22,2,37,12,25,15,11,0,4,0,2
"2011","E00013092","E00013092","Total",131,72,28,44,0,40,38,2,19,17,0,2,0,0
"2011","E00013113","E00013113","Total",149,42,16,26,0,88,84,4,17,17,0,0,0,2
"2011","E00013115","E00013115","Total",98,54,25,29,0,32,3,29,11,11,0,0,0,1
"2011","E00012756","E00012756","Total",148,50,15,35,8,20,8,12,68,65,0,3,0,2
"2011","E00012759","E00012759","Total",111,72,36,36,0,17,8,9,19,16,1,1,1,3
"2011","E00012777","E00012777","Total",120,61,35,26,0,5,2,3,53,50,0,1,2,1
"2011","E00012778","E00012778","Total",118,97,47,50,0,2,2,0,19,17,0,1,1,0
"2011","E00012779","E00012779","Total",138,122,80,42,0,1,1,0,12,11,0,1,0,3
"2011","E00012755","E00012755","Total",112,80,28,52,1,13,2,11,18,17,0,1,0,0
"2011","E00012757","E00012757","Total",144,57,23,34,0,29,16,13,57,57,0,0,0,1
"2011","E00012763","E00012763","Total",116,65,19,46,2,40,28,12,7,4,0,2,1,2
"2011","E00012766","E00012766","Total",125,56,20,36,4,46,42,4,16,15,0,0,1,3
"2011","E00166023","E00166023","Total",215,21,5,16,82,69,6,63,40,40,0,0,0,3
"2011","E00166024","E00166024","Total",128,79,36,43,0,26,10,16,21,21,0,0,0,2
"2011","E00168192","E00168192","Total",92,48,18,30,0,18,11,7,25,22,0,3,0,1
"2011","E00168198","E00168198","Total",88,14,8,6,0,64,26,38,10,10,0,0,0,0
"2011","E00012746","E00012746","Total",137,59,17,42,0,51,47,4,26,26,0,0,0,1
"2011","E00012767","E00012767","Total",148,84,29,55,2,18,13,5,44,43,0,1,0,0
"2011","E00012769","E00012769","Total",157,87,29,58,0,10,3,7,57,57,0,0,0,3
"2011","E00012770","E00012770","Total",119,72,28,44,1,22,11,11,22,21,0,1,0,2
"2011","E00012772","E00012772","Total",140,99,35,64,0,12,8,4,28,24,0,2,2,1
"2011","E00012773","E00012773","Total",136,78,36,42,3,9,6,3,44,41,0,3,0,2
"2011","E00013321","E00013321","Total",150,94,31,63,0,22,21,1,33,31,0,1,1,1
"2011","E00013322","E00013322","Total",148,59,26,33,1,78,69,9,9,9,0,0,0,1
"2011","E00013323","E00013323","Total",153,56,34,22,2,63,51,12,26,25,0,1,0,6
"2011","E00013332","E00013332","Total",130,42,19,23,26,40,31,9,20,20,0,0,0,2
"2011","E00166039","E00166039","Total",131,25,7,18,18,13,11,2,69,66,1,2,0,6
"2011","E00168195","E00168195","Total",129,40,11,29,2,8,7,1,78,74,1,3,0,1
"2011","E00168878","E00168878","Total",128,62,19,43,2,3,1,2,59,56,0,2,1,2
"2011","E00168880","E00168880","Total",127,50,22,28,0,43,18,25,29,27,1,1,0,5
"2011","E00013314","E00013314","Total",137,49,16,33,1,61,59,2,24,20,0,3,1,2
"2011","E00013328","E00013328","Total",131,60,19,41,5,56,55,1,6,6,0,0,0,4
"2011","E00013330","E00013330","Total",145,35,12,23,1,100,95,5,8,8,0,0,0,1
"2011","E00013331","E00013331","Total",129,54,19,35,1,63,63,0,9,8,0,1,0,2
"2011","E00013336","E00013336","Total",139,25,7,18,0,85,67,18,23,21,0,1,1,6
"2011","E00012786","E00012786","Total",125,88,60,28,0,3,2,1,30,26,1,2,1,4
"2011","E00012787","E00012787","Total",113,79,35,44,1,0,0,0,31,31,0,0,0,2
"2011","E00012789","E00012789","Total",129,96,43,53,3,6,2,4,24,24,0,0,0,0
"2011","E00012790","E00012790","Total",126,68,31,37,2,5,3,2,50,49,0,1,0,1
"2011","E00012791","E00012791","Total",118,66,23,43,0,13,1,12,38,35,0,3,0,1
"2011","E00012792","E00012792","Total",202,37,14,23,5,134,82,52,22,21,0,1,0,4
"2011","E00012793","E00012793","Total",131,25,12,13,0,92,71,21,12,10,0,1,1,2
"2011","E00012794","E00012794","Total",127,39,7,32,0,57,46,11,27,25,0,2,0,4
"2011","E00012795","E00012795","Total",126,58,16,42,0,44,37,7,22,21,0,1,0,2
"2011","E00012796","E00012796","Total",124,68,26,42,1,43,40,3,11,10,0,1,0,1
"2011","E00012823","E00012823","Total",152,78,41,37,0,24,7,17,48,46,1,1,0,2
"2011","E00012831","E00012831","Total",117,85,40,45,0,3,2,1,27,26,0,1,0,2
"2011","E00012836","E00012836","Total",130,78,38,40,1,30,28,2,19,19,0,0,0,2
"2011","E00012837","E00012837","Total",143,86,35,51,0,13,11,2,43,43,0,0,0,1
"2011","E00012838","E00012838","Total",118,95,34,61,0,4,3,1,18,18,0,0,0,1
"2011","E00012820","E00012820","Total",104,34,10,24,0,37,37,0,27,26,0,1,0,6
"2011","E00012842","E00012842","Total",129,108,67,41,0,5,2,3,16,16,0,0,0,0
"2011","E00012844","E00012844","Total",123,91,44,47,0,9,9,0,21,21,0,0,0,2
"2011","E00012847","E00012847","Total",129,93,45,48,0,2,1,1,34,29,2,3,0,0
"2011","E00012850","E00012850","Total",127,74,34,40,1,41,17,24,9,7,0,1,1,2
"2011","E00013354","E00013354","Total",127,84,45,39,0,12,6,6,30,29,0,1,0,1
"2011","E00013359","E00013359","Total",134,70,41,29,0,44,32,12,16,16,0,0,0,4
"2011","E00013366","E00013366","Total",137,98,59,39,0,8,3,5,28,28,0,0,0,3
"2011","E00013367","E00013367","Total",132,37,15,22,1,70,63,7,22,22,0,0,0,2
"2011","E00013372","E00013372","Total",122,95,53,42,0,5,2,3,21,20,0,0,1,1
"2011","E00013373","E00013373","Total",144,19,4,15,1,109,103,6,13,12,0,1,0,2
"2011","E00013362","E00013362","Total",120,96,56,40,0,5,4,1,16,14,0,2,0,3
"2011","E00013365","E00013365","Total",101,36,17,19,0,48,38,10,17,17,0,0,0,0
"2011","E00013368","E00013368","Total",121,94,44,50,0,4,3,1,21,21,0,0,0,2
"2011","E00013369","E00013369","Total",166,83,31,52,0,29,22,7,51,48,0,2,1,3
"2011","E00013370","E00013370","Total",104,66,38,28,1,7,7,0,27,26,0,1,0,3
"2011","E00012826","E00012826","Total",131,50,18,32,1,51,14,37,29,29,0,0,0,0
"2011","E00012839","E00012839","Total",128,67,30,37,0,2,1,1,59,57,0,2,0,0
"2011","E00012840","E00012840","Total",116,30,13,17,0,71,67,4,12,11,0,0,1,3
"2011","E00012841","E00012841","Total",117,93,45,48,1,7,2,5,15,15,0,0,0,1
"2011","E00012843","E00012843","Total",124,45,21,24,0,71,59,12,7,7,0,0,0,1
"2011","E00012846","E00012846","Total",140,66,26,40,0,50,17,33,23,23,0,0,0,1
"2011","E00012821","E00012821","Total",141,56,18,38,0,57,57,0,20,20,0,0,0,8
"2011","E00012822","E00012822","Total",171,132,75,57,0,19,17,2,18,17,0,1,0,2
"2011","E00012849","E00012849","Total",127,63,22,41,1,12,8,4,46,46,0,0,0,5
"2011","E00012851","E00012851","Total",124,78,32,46,0,23,20,3,23,21,0,2,0,0
"2011","E00012852","E00012852","Total",120,102,55,47,1,3,1,2,13,12,0,1,0,1
"2011","E00012853","E00012853","Total",140,109,70,39,0,2,1,1,27,26,0,0,1,2
"2011","E00012824","E00012824","Total",126,34,14,20,1,60,55,5,31,29,0,2,0,0
"2011","E00012825","E00012825","Total",129,52,26,26,1,14,9,5,57,54,0,3,0,5
"2011","E00012854","E00012854","Total",134,16,2,14,0,90,19,71,27,27,0,0,0,1
"2011","E00012855","E00012855","Total",144,92,35,57,0,9,5,4,43,40,0,3,0,0
"2011","E00012856","E00012856","Total",142,17,8,9,0,31,13,18,94,92,0,2,0,0
"2011","E00012827","E00012827","Total",144,81,21,60,1,8,1,7,54,51,0,3,0,0
"2011","E00012828","E00012828","Total",151,86,27,59,0,24,21,3,39,37,0,1,1,2
"2011","E00012829","E00012829","Total",126,70,39,31,0,14,12,2,38,38,0,0,0,4
"2011","E00012830","E00012830","Total",143,60,15,45,0,2,1,1,80,76,1,3,0,1
"2011","E00012834","E00012834","Total",158,89,39,50,0,20,16,4,49,48,0,1,0,0
"2011","E00012857","E00012857","Total",140,80,27,53,0,24,16,8,36,36,0,0,0,0
"2011","E00012819","E00012819","Total",111,37,17,20,0,47,46,1,22,19,2,1,0,5
"2011","E00012832","E00012832","Total",124,91,29,62,0,19,17,2,14,14,0,0,0,0
"2011","E00012833","E00012833","Total",118,65,27,38,0,30,28,2,23,17,0,5,1,0
"2011","E00012835","E00012835","Total",130,88,38,50,1,2,2,0,38,37,0,1,0,1
"2011","E00012845","E00012845","Total",126,104,61,43,1,2,1,1,19,18,0,1,0,0
"2011","E00012848","E00012848","Total",110,79,31,48,0,14,6,8,17,17,0,0,0,0
"2011","E00013279","E00013279","Total",130,116,60,56,2,2,2,0,8,8,0,0,0,2
"2011","E00013288","E00013288","Total",124,105,62,43,0,3,0,3,14,14,0,0,0,2
"2011","E00013296","E00013296","Total",124,102,45,57,0,8,4,4,13,12,0,1,0,1
"2011","E00166021","E00166021","Total",365,103,15,88,60,83,3,80,116,112,0,3,1,3
"2011","E00166026","E00166026","Total",134,116,50,66,1,4,3,1,13,13,0,0,0,0
"2011","E00013303","E00013303","Total",149,103,51,52,0,4,1,3,35,28,2,1,4,7
"2011","E00013304","E00013304","Total",134,88,43,45,1,0,0,0,43,43,0,0,0,2
"2011","E00013305","E00013305","Total",138,69,31,38,1,4,2,2,61,59,2,0,0,3
"2011","E00013306","E00013306","Total",122,99,46,53,0,1,0,1,22,22,0,0,0,0
"2011","E00013307","E00013307","Total",126,66,28,38,1,1,0,1,57,56,0,1,0,1
"2011","E00013278","E00013278","Total",147,127,67,60,0,5,4,1,13,12,0,1,0,2
"2011","E00013281","E00013281","Total",131,71,28,43,2,9,0,9,49,47,0,2,0,0
"2011","E00013283","E00013283","Total",120,62,28,34,0,8,5,3,48,48,0,0,0,2
"2011","E00013287","E00013287","Total",122,73,32,41,0,8,4,4,40,40,0,0,0,1
"2011","E00013308","E00013308","Total",123,94,55,39,0,1,0,1,27,25,2,0,0,1
"2011","E00013285","E00013285","Total",138,90,54,36,0,13,4,9,35,31,1,3,0,0
"2011","E00013286","E00013286","Total",138,89,38,51,1,6,2,4,36,34,0,2,0,6
"2011","E00013292","E00013292","Total",125,72,43,29,0,8,2,6,42,41,0,1,0,3
"2011","E00013293","E00013293","Total",145,73,16,57,0,20,9,11,49,49,0,0,0,3
"2011","E00013297","E00013297","Total",182,99,46,53,8,7,2,5,68,63,1,4,0,0
"2011","E00013036","E00013036","Total",122,78,42,36,1,10,1,9,29,26,0,3,0,4
"2011","E00013038","E00013038","Total",130,54,25,29,0,54,50,4,13,13,0,0,0,9
"2011","E00013039","E00013039","Total",131,94,46,48,0,6,4,2,31,27,2,2,0,0
"2011","E00013043","E00013043","Total",116,76,33,43,1,9,6,3,30,29,0,1,0,0
"2011","E00013047","E00013047","Total",125,93,46,47,0,9,7,2,22,20,0,0,2,1
"2011","E00013024","E00013024","Total",127,55,21,34,1,30,3,27,39,37,0,1,1,2
"2011","E00013026","E00013026","Total",139,96,49,47,1,14,1,13,26,25,0,1,0,2
"2011","E00013044","E00013044","Total",127,96,39,57,1,7,0,7,23,21,0,2,0,0
"2011","E00013051","E00013051","Total",133,54,15,39,2,36,11,25,40,38,1,1,0,1
"2011","E00013088","E00013088","Total",190,72,26,46,14,66,39,27,34,32,0,1,1,4
"2011","E00013093","E00013093","Total",118,105,50,55,0,5,0,5,8,8,0,0,0,0
"2011","E00013094","E00013094","Total",132,113,49,64,0,3,2,1,14,13,1,0,0,2
"2011","E00013095","E00013095","Total",129,76,35,41,1,26,25,1,25,25,0,0,0,1
"2011","E00013099","E00013099","Total",119,79,36,43,0,5,4,1,34,34,0,0,0,1
"2011","E00013106","E00013106","Total",126,63,34,29,2,37,35,2,22,22,0,0,0,2
"2011","E00013107","E00013107","Total",138,112,58,54,2,1,0,1,22,21,0,1,0,1
"2011","E00013108","E00013108","Total",141,66,30,36,1,1,0,1,69,64,0,2,3,4
"2011","E00013085","E00013085","Total",132,69,30,39,1,41,37,4,19,15,2,1,1,2
"2011","E00013100","E00013100","Total",121,81,34,47,0,11,11,0,29,27,0,1,1,0
"2011","E00013103","E00013103","Total",133,82,39,43,1,16,14,2,33,32,1,0,0,1
"2011","E00013104","E00013104","Total",115,88,40,48,1,3,1,2,20,16,0,4,0,3
"2011","E00013105","E00013105","Total",108,78,28,50,2,3,0,3,25,25,0,0,0,0
"2011","E00013037","E00013037","Total",119,96,40,56,1,0,0,0,21,20,0,1,0,1
"2011","E00013041","E00013041","Total",130,103,40,63,0,6,3,3,20,19,0,1,0,1
"2011","E00013042","E00013042","Total",144,109,48,61,2,8,7,1,23,23,0,0,0,2
"2011","E00013048","E00013048","Total",119,98,52,46,0,3,2,1,17,17,0,0,0,1
"2011","E00013025","E00013025","Total",140,85,35,50,2,28,22,6,25,23,0,2,0,0
"2011","E00013028","E00013028","Total",135,66,25,41,4,40,29,11,24,23,0,1,0,1
"2011","E00013045","E00013045","Total",152,101,37,64,0,6,5,1,44,42,0,2,0,1
"2011","E00013052","E00013052","Total",167,58,15,43,3,71,5,66,33,31,0,2,0,2
"2011","E00013027","E00013027","Total",124,44,23,21,1,38,7,31,39,34,0,4,1,2
"2011","E00013046","E00013046","Total",106,26,15,11,0,70,4,66,10,10,0,0,0,0
"2011","E00013049","E00013049","Total",130,79,37,42,0,4,2,2,46,43,1,2,0,1
"2011","E00013050","E00013050","Total",124,84,27,57,0,20,16,4,19,19,0,0,0,1
"2011","E00013061","E00013061","Total",143,71,33,38,2,8,1,7,59,56,2,1,0,3
"2011","E00013062","E00013062","Total",127,95,51,44,0,6,4,2,25,20,2,3,0,1
"2011","E00013064","E00013064","Total",102,63,33,30,0,7,5,2,30,29,0,1,0,2
"2011","E00013065","E00013065","Total",132,85,35,50,0,10,5,5,36,35,0,1,0,1
"2011","E00013068","E00013068","Total",116,76,35,41,1,5,2,3,32,32,0,0,0,2
"2011","E00013054","E00013054","Total",135,57,27,30,0,45,4,41,32,32,0,0,0,1
"2011","E00013063","E00013063","Total",122,98,40,58,0,3,1,2,21,19,0,2,0,0
"2011","E00013066","E00013066","Total",127,73,25,48,0,11,7,4,42,42,0,0,0,1
"2011","E00013071","E00013071","Total",191,75,35,40,10,38,8,30,66,64,0,1,1,2
"2011","E00013073","E00013073","Total",140,46,24,22,3,65,7,58,24,24,0,0,0,2
"2011","E00013067","E00013067","Total",141,83,48,35,0,3,0,3,52,50,0,2,0,3
"2011","E00013069","E00013069","Total",126,45,26,19,1,13,10,3,66,62,3,1,0,1
"2011","E00013070","E00013070","Total",154,112,60,52,1,1,1,0,37,34,0,2,1,3
"2011","E00013072","E00013072","Total",148,71,23,48,1,17,2,15,59,59,0,0,0,0
"2011","E00013118","E00013118","Total",122,73,50,23,0,2,2,0,47,45,0,2,0,0
"2011","E00013119","E00013119","Total",124,56,34,22,1,3,3,0,60,57,0,2,1,4
"2011","E00013121","E00013121","Total",130,94,49,45,0,1,1,0,32,32,0,0,0,3
"2011","E00013123","E00013123","Total",121,86,50,36,0,0,0,0,34,33,0,1,0,1
"2011","E00013120","E00013120","Total",134,68,42,26,1,1,1,0,63,60,0,2,1,1
"2011","E00013127","E00013127","Total",156,76,49,27,0,4,4,0,76,74,0,2,0,0
"2011","E00013131","E00013131","Total",138,97,52,45,1,2,1,1,38,36,0,2,0,0
"2011","E00013133","E00013133","Total",120,58,24,34,0,8,5,3,54,49,1,3,1,0
"2011","E00013282","E00013282","Total",132,92,47,45,0,1,1,0,37,36,0,1,0,2
"2011","E00013290","E00013290","Total",134,66,33,33,1,6,5,1,60,57,0,3,0,1
"2011","E00013294","E00013294","Total",105,61,36,25,0,2,0,2,42,40,0,2,0,0
"2011","E00013295","E00013295","Total",160,81,48,33,0,2,2,0,75,69,1,5,0,2
"2011","E00013298","E00013298","Total",137,116,57,59,0,0,0,0,20,18,0,2,0,1
"2011","E00013284","E00013284","Total",139,107,52,55,0,0,0,0,31,30,0,1,0,1
"2011","E00013289","E00013289","Total",135,81,39,42,0,3,0,3,51,49,0,1,1,0
"2011","E00013309","E00013309","Total",136,120,62,58,2,0,0,0,14,14,0,0,0,0
"2011","E00013310","E00013310","Total",149,101,57,44,0,1,0,1,45,45,0,0,0,2
"2011","E00012880","E00012880","Total",117,65,29,36,2,8,2,6,41,41,0,0,0,1
"2011","E00012881","E00012881","Total",141,106,59,47,0,4,2,2,30,27,0,2,1,1
"2011","E00012883","E00012883","Total",126,55,25,30,0,23,7,16,44,41,0,1,2,4
"2011","E00012888","E00012888","Total",128,87,48,39,1,6,6,0,33,31,0,1,1,1
"2011","E00012879","E00012879","Total",121,58,21,37,3,19,17,2,38,35,0,2,1,3
"2011","E00012884","E00012884","Total",122,49,29,20,0,14,7,7,59,57,1,1,0,0
"2011","E00012885","E00012885","Total",126,71,27,44,2,3,2,1,47,45,0,1,1,3
"2011","E00012886","E00012886","Total",124,87,44,43,0,6,4,2,28,27,0,0,1,3
"2011","E00012865","E00012865","Total",117,42,15,27,1,42,41,1,26,23,0,1,2,6
"2011","E00012868","E00012868","Total",130,54,20,34,0,54,52,2,20,20,0,0,0,2
"2011","E00012882","E00012882","Total",128,85,40,45,1,6,3,3,35,34,1,0,0,1
"2011","E00012887","E00012887","Total",134,76,37,39,0,17,15,2,38,37,0,1,0,3
"2011","E00012858","E00012858","Total",120,86,56,30,0,2,2,0,32,29,0,2,1,0
"2011","E00012860","E00012860","Total",106,67,31,36,0,6,2,4,33,31,0,2,0,0
"2011","E00012862","E00012862","Total",108,73,38,35,0,3,2,1,32,31,0,1,0,0
"2011","E00012864","E00012864","Total",123,81,32,49,1,1,1,0,38,36,0,2,0,2
"2011","E00012869","E00012869","Total",177,18,7,11,1,121,117,4,30,29,0,0,1,7
"2011","E00012874","E00012874","Total",117,50,14,36,2,45,40,5,19,16,1,1,1,1
"2011","E00012876","E00012876","Total",145,68,25,43,0,56,53,3,19,19,0,0,0,2
"2011","E00012877","E00012877","Total",162,99,53,46,0,13,12,1,49,48,0,0,1,1
"2011","E00012878","E00012878","Total",76,1,0,1,0,15,7,8,59,20,22,2,15,1
"2011","E00013246","E00013246","Total",156,97,26,71,1,2,0,2,54,54,0,0,0,2
"2011","E00013264","E00013264","Total",116,60,15,45,0,5,2,3,49,48,0,1,0,2
"2011","E00013266","E00013266","Total",133,53,13,40,5,33,21,12,36,33,0,1,2,6
"2011","E00013267","E00013267","Total",168,83,29,54,3,29,16,13,51,46,1,4,0,2
"2011","E00013268","E00013268","Total",101,43,14,29,1,45,43,2,11,11,0,0,0,1
"2011","E00013276","E00013276","Total",209,108,32,76,0,40,19,21,58,54,0,4,0,3
"2011","E00013242","E00013242","Total",147,94,30,64,2,7,3,4,44,41,0,2,1,0
"2011","E00013269","E00013269","Total",154,52,9,43,2,72,38,34,23,23,0,0,0,5
"2011","E00013270","E00013270","Total",159,57,12,45,10,75,45,30,16,14,0,2,0,1
"2011","E00013271","E00013271","Total",120,37,5,32,0,74,67,7,7,7,0,0,0,2
"2011","E00013273","E00013273","Total",131,45,23,22,2,72,70,2,10,10,0,0,0,2
"2011","E00013312","E00013312","Total",140,68,20,48,1,25,7,18,46,43,1,1,1,0
"2011","E00013316","E00013316","Total",121,35,17,18,1,68,3,65,16,13,0,2,1,1
"2011","E00013342","E00013342","Total",98,6,3,3,1,90,8,82,1,1,0,0,0,0
"2011","E00013343","E00013343","Total",122,80,44,36,2,9,4,5,31,27,1,3,0,0
"2011","E00168196","E00168196","Total",136,34,10,24,1,59,6,53,41,41,0,0,0,1
"2011","E00168197","E00168197","Total",124,67,12,55,1,5,2,3,49,49,0,0,0,2
"2011","E00013311","E00013311","Total",172,51,15,36,5,90,85,5,22,19,2,1,0,4
"2011","E00013337","E00013337","Total",129,57,30,27,2,54,52,2,16,15,0,1,0,0
"2011","E00013338","E00013338","Total",126,93,33,60,6,4,1,3,23,19,0,4,0,0
"2011","E00013341","E00013341","Total",116,84,36,48,0,3,0,3,28,25,0,3,0,1
"2011","E00166027","E00166027","Total",329,181,29,152,53,62,6,56,32,28,0,4,0,1
"2011","E00168881","E00168881","Total",55,23,11,12,7,21,4,17,3,3,0,0,0,1
"2011","E00013313","E00013313","Total",143,111,32,79,0,5,3,2,26,23,0,2,1,1
"2011","E00013315","E00013315","Total",130,93,31,62,1,3,2,1,31,31,0,0,0,2
"2011","E00013317","E00013317","Total",118,69,35,34,1,26,2,24,22,20,0,2,0,0
"2011","E00013318","E00013318","Total",127,84,34,50,0,23,20,3,19,18,0,0,1,1
"2011","E00013320","E00013320","Total",124,85,22,63,1,6,0,6,31,30,0,1,0,1
"2011","E00168867","E00168867","Total",132,43,11,32,2,31,4,27,55,54,0,0,1,1
"2011","E00168869","E00168869","Total",124,23,6,17,40,15,2,13,46,45,0,0,1,0
"2011","E00168883","E00168883","Total",139,107,36,71,2,5,3,2,25,23,0,1,1,0
"2011","E00013128","E00013128","Total",127,40,18,22,8,20,4,16,58,53,1,2,2,1
"2011","E00013130","E00013130","Total",175,57,18,39,2,18,2,16,96,93,0,2,1,2
"2011","E00013135","E00013135","Total",131,44,17,27,0,13,7,6,71,69,1,1,0,3
"2011","E00013137","E00013137","Total",167,38,17,21,1,17,8,9,106,103,0,2,1,5
"2011","E00013141","E00013141","Total",135,50,30,20,1,56,51,5,23,20,0,2,1,5
"2011","E00013122","E00013122","Total",117,87,57,30,1,3,1,2,25,25,0,0,0,1
"2011","E00013125","E00013125","Total",147,105,51,54,2,9,6,3,29,29,0,0,0,2
"2011","E00013132","E00013132","Total",157,81,41,40,1,25,10,15,49,46,0,0,3,1
"2011","E00013142","E00013142","Total",140,34,7,27,0,95,92,3,10,9,0,1,0,1
"2011","E00168859","E00168859","Total",81,57,44,13,2,12,10,2,9,8,0,0,1,1
"2011","E00168864","E00168864","Total",191,28,12,16,99,42,11,31,21,20,1,0,0,1
"2011","E00168895","E00168895","Total",77,8,3,5,0,65,60,5,2,1,1,0,0,2
"2011","E00013116","E00013116","Total",136,80,25,55,1,6,3,3,49,45,0,1,3,0
"2011","E00013140","E00013140","Total",132,41,14,27,0,27,24,3,64,59,0,3,2,0
"2011","E00013144","E00013144","Total",134,57,29,28,3,30,19,11,43,43,0,0,0,1
"2011","E00013146","E00013146","Total",136,18,3,15,0,103,13,90,14,11,0,2,1,1
"2011","E00013147","E00013147","Total",115,70,32,38,2,4,1,3,39,38,0,1,0,0
"2011","E00013148","E00013148","Total",113,58,23,35,3,29,6,23,22,21,0,1,0,1
"2011","E00013208","E00013208","Total",139,84,35,49,0,3,1,2,51,49,0,2,0,1
"2011","E00013209","E00013209","Total",125,108,51,57,0,3,1,2,13,13,0,0,0,1
"2011","E00013210","E00013210","Total",125,95,47,48,1,7,1,6,22,22,0,0,0,0
"2011","E00013212","E00013212","Total",112,97,45,52,0,3,2,1,12,12,0,0,0,0
"2011","E00013280","E00013280","Total",113,90,50,40,0,5,0,5,17,17,0,0,0,1
"2011","E00013299","E00013299","Total",151,66,20,46,1,21,14,7,62,57,0,4,1,1
"2011","E00013300","E00013300","Total",132,50,19,31,0,48,7,41,31,30,0,1,0,3
"2011","E00013301","E00013301","Total",130,50,24,26,0,31,17,14,47,44,0,3,0,2
"2011","E00013302","E00013302","Total",126,64,23,41,8,16,8,8,37,36,0,1,0,1
"2011","E00012861","E00012861","Total",118,47,17,30,1,18,14,4,52,50,0,2,0,0
"2011","E00012863","E00012863","Total",130,83,44,39,1,14,13,1,29,28,0,0,1,3
"2011","E00012866","E00012866","Total",117,47,26,21,3,39,37,2,27,26,0,1,0,1
"2011","E00012867","E00012867","Total",113,48,29,19,2,24,1,23,36,35,0,0,1,3
"2011","E00012872","E00012872","Total",127,54,26,28,1,42,12,30,29,28,0,0,1,1
"2011","E00012859","E00012859","Total",142,23,5,18,0,104,27,77,13,10,0,0,3,2
"2011","E00012870","E00012870","Total",134,9,5,4,2,109,12,97,8,7,0,0,1,6
"2011","E00012871","E00012871","Total",119,10,2,8,0,98,10,88,6,6,0,0,0,5
"2011","E00012873","E00012873","Total",149,9,6,3,1,130,12,118,7,7,0,0,0,2
"2011","E00012875","E00012875","Total",133,13,8,5,2,103,21,82,12,11,1,0,0,3
"2011","E00013215","E00013215","Total",123,61,39,22,0,17,3,14,44,44,0,0,0,1
"2011","E00013223","E00013223","Total",138,52,16,36,0,34,30,4,47,46,0,0,1,5
"2011","E00013234","E00013234","Total",129,67,32,35,5,6,3,3,49,49,0,0,0,2
"2011","E00013238","E00013238","Total",132,74,31,43,4,18,0,18,34,32,0,2,0,2
"2011","E00013220","E00013220","Total",136,90,48,42,0,2,1,1,43,41,0,1,1,1
"2011","E00013231","E00013231","Total",142,68,38,30,0,7,3,4,61,59,0,0,2,6
"2011","E00013232","E00013232","Total",111,74,48,26,0,7,6,1,30,28,0,2,0,0
"2011","E00013237","E00013237","Total",129,88,57,31,0,3,2,1,35,30,0,4,1,3
"2011","E00013214","E00013214","Total",116,42,10,32,3,53,48,5,18,17,0,1,0,0
"2011","E00013225","E00013225","Total",133,53,25,28,0,38,30,8,39,38,0,1,0,3
"2011","E00013226","E00013226","Total",139,91,48,43,1,10,4,6,35,35,0,0,0,2
"2011","E00013227","E00013227","Total",136,28,14,14,2,90,82,8,12,10,0,2,0,4
"2011","E00013029","E00013029","Total",123,62,30,32,10,24,12,12,25,23,2,0,0,2
"2011","E00013030","E00013030","Total",113,52,20,32,0,13,1,12,47,45,0,2,0,1
"2011","E00013031","E00013031","Total",123,64,31,33,4,19,16,3,36,34,0,1,1,0
"2011","E00013053","E00013053","Total",121,61,19,42,3,39,39,0,18,17,0,1,0,0
"2011","E00013164","E00013164","Total",125,35,9,26,1,45,41,4,43,41,0,2,0,1
"2011","E00013170","E00013170","Total",123,23,7,16,0,83,80,3,13,11,0,2,0,4
"2011","E00013172","E00013172","Total",138,75,29,46,1,13,10,3,48,47,0,1,0,1
"2011","E00013174","E00013174","Total",134,17,6,11,0,94,88,6,22,21,0,1,0,1
"2011","E00013176","E00013176","Total",192,77,33,44,0,23,12,11,89,87,0,0,2,3
"2011","E00013233","E00013233","Total",101,71,38,33,0,1,1,0,27,23,0,2,2,2
"2011","E00013235","E00013235","Total",157,119,67,52,1,5,1,4,31,30,0,1,0,1
"2011","E00013236","E00013236","Total",134,83,51,32,2,4,3,1,45,43,0,0,2,0
"2011","E00166036","E00166036","Total",121,21,14,7,0,18,9,9,82,82,0,0,0,0
"2011","E00166037","E00166037","Total",68,21,12,9,0,4,3,1,41,41,0,0,0,2
"2011","E00168861","E00168861","Total",46,14,6,8,0,2,1,1,30,30,0,0,0,0
"2011","E00013217","E00013217","Total",139,58,28,30,1,43,37,6,33,28,0,4,1,4
"2011","E00013221","E00013221","Total",133,35,9,26,1,82,75,7,13,11,0,0,2,2
"2011","E00013222","E00013222","Total",151,91,51,40,3,11,7,4,44,40,0,0,4,2
"2011","E00013239","E00013239","Total",97,41,15,26,1,10,6,4,45,41,1,1,2,0
"2011","E00013241","E00013241","Total",231,39,14,25,38,127,65,62,26,24,0,0,2,1
"2011","E00013216","E00013216","Total",156,60,22,38,6,21,4,17,69,67,0,0,2,0
"2011","E00013218","E00013218","Total",127,75,25,50,0,6,4,2,42,41,0,0,1,4
"2011","E00013219","E00013219","Total",184,53,17,36,19,44,30,14,65,64,0,1,0,3
"2011","E00013228","E00013228","Total",129,27,9,18,11,44,18,26,45,43,0,0,2,2
"2011","E00013124","E00013124","Total",125,74,49,25,3,2,0,2,44,42,0,1,1,2
"2011","E00013126","E00013126","Total",117,23,9,14,0,73,70,3,20,18,1,1,0,1
"2011","E00013129","E00013129","Total",122,61,37,24,2,10,4,6,43,43,0,0,0,6
"2011","E00013134","E00013134","Total",118,31,18,13,0,56,7,49,30,29,0,1,0,1
"2011","E00013136","E00013136","Total",155,60,34,26,0,16,12,4,79,79,0,0,0,0
"2011","E00013151","E00013151","Total",134,50,25,25,0,22,17,5,58,51,2,4,1,4
"2011","E00013171","E00013171","Total",218,80,28,52,18,51,4,47,68,65,1,2,0,1
"2011","E00013179","E00013179","Total",138,69,25,44,2,9,6,3,57,55,0,2,0,1
"2011","E00013181","E00013181","Total",143,69,30,39,1,3,2,1,66,66,0,0,0,4
"2011","E00168850","E00168850","Total",138,74,34,40,0,32,5,27,30,29,0,1,0,2
"2011","E00168852","E00168852","Total",129,38,16,22,0,6,3,3,85,81,0,3,1,0
"2011","E00013159","E00013159","Total",136,76,27,49,0,10,5,5,49,48,0,0,1,1
"2011","E00013168","E00013168","Total",128,72,32,40,1,15,4,11,40,39,0,1,0,0
"2011","E00013175","E00013175","Total",161,34,7,27,1,31,14,17,93,88,1,1,3,2
"2011","E00013178","E00013178","Total",148,58,22,36,0,33,28,5,57,56,0,0,1,0
"2011","E00013182","E00013182","Total",119,39,17,22,0,20,16,4,56,54,0,2,0,4
"2011","E00013197","E00013197","Total",143,84,46,38,3,9,1,8,46,42,1,3,0,1
"2011","E00013200","E00013200","Total",115,102,39,63,0,2,1,1,11,8,0,2,1,0
"2011","E00013202","E00013202","Total",137,72,26,46,2,5,2,3,58,54,0,4,0,0
"2011","E00013203","E00013203","Total",125,116,36,80,1,2,1,1,5,5,0,0,0,1
"2011","E00013206","E00013206","Total",130,106,48,58,1,7,5,2,16,15,0,1,0,0
"2011","E00013138","E00013138","Total",141,15,2,13,0,5,2,3,121,117,1,1,2,0
"2011","E00168872","E00168872","Total",184,30,8,22,70,43,4,39,41,40,0,0,1,0
"2011","E00168875","E00168875","Total",318,40,12,28,4,14,5,9,260,257,1,1,1,0
"2011","E00013117","E00013117","Total",173,58,24,34,31,24,14,10,58,57,0,1,0,2
"2011","E00013145","E00013145","Total",188,45,16,29,31,26,9,17,84,80,1,0,3,2
"2011","E00013149","E00013149","Total",132,22,4,18,1,15,15,0,92,91,0,1,0,2
"2011","E00168886","E00168886","Total",155,44,20,24,1,30,19,11,76,75,0,1,0,4
"2011","E00013188","E00013188","Total",121,97,44,53,0,0,0,0,24,22,0,2,0,0
"2011","E00013189","E00013189","Total",145,112,56,56,1,3,3,0,29,28,0,1,0,0
"2011","E00013191","E00013191","Total",143,97,40,57,0,4,2,2,39,37,0,2,0,3
"2011","E00013192","E00013192","Total",133,110,48,62,1,6,1,5,15,13,0,1,1,1
"2011","E00013183","E00013183","Total",136,94,33,61,12,7,3,4,22,20,0,2,0,1
"2011","E00013190","E00013190","Total",140,104,37,67,1,4,2,2,31,29,0,2,0,0
"2011","E00013194","E00013194","Total",106,78,32,46,1,1,1,0,25,23,0,2,0,1
"2011","E00013199","E00013199","Total",140,103,45,58,2,3,1,2,28,28,0,0,0,4
"2011","E00013201","E00013201","Total",124,105,46,59,0,8,3,5,11,11,0,0,0,0
"2011","E00013184","E00013184","Total",119,96,40,56,0,4,3,1,16,16,0,0,0,3
"2011","E00013193","E00013193","Total",115,71,35,36,0,1,0,1,39,37,0,0,2,4
"2011","E00013195","E00013195","Total",116,95,43,52,0,1,0,1,20,18,0,2,0,0
"2011","E00013196","E00013196","Total",135,86,43,43,1,8,7,1,39,38,0,0,1,1
"2011","E00013198","E00013198","Total",137,95,42,53,0,3,2,1,39,38,0,0,1,0
"2011","E00013185","E00013185","Total",130,106,54,52,4,3,2,1,17,16,0,0,1,0
"2011","E00013204","E00013204","Total",105,75,31,44,0,21,18,3,8,7,0,1,0,1
"2011","E00013205","E00013205","Total",127,95,50,45,0,13,10,3,18,18,0,0,0,1
"2011","E00013207","E00013207","Total",117,101,49,52,0,1,1,0,15,14,0,1,0,0
"2011","E00013186","E00013186","Total",142,80,27,53,2,28,11,17,29,27,0,0,2,3
"2011","E00013187","E00013187","Total",148,109,52,57,1,12,12,0,24,23,1,0,0,2
"2011","E00013211","E00013211","Total",91,33,12,21,8,25,3,22,23,21,0,1,1,2
"2011","E00013213","E00013213","Total",123,109,48,61,0,3,2,1,11,10,1,0,0,0
"2011","E00013263","E00013263","Total",129,91,36,55,0,18,18,0,14,14,0,0,0,6
"2011","E00013265","E00013265","Total",113,46,17,29,0,36,31,5,28,28,0,0,0,3
"2011","E00013272","E00013272","Total",115,28,9,19,2,49,35,14,33,33,0,0,0,3
"2011","E00013274","E00013274","Total",164,78,20,58,0,50,40,10,32,32,0,0,0,4
"2011","E00013275","E00013275","Total",130,61,27,34,2,42,27,15,22,19,2,0,1,3
"2011","E00013243","E00013243","Total",118,85,35,50,1,4,3,1,25,24,0,1,0,3
"2011","E00013244","E00013244","Total",133,87,37,50,0,29,27,2,14,12,1,0,1,3
"2011","E00013248","E00013248","Total",132,67,11,56,0,18,6,12,47,44,0,3,0,0
"2011","E00013251","E00013251","Total",137,83,26,57,3,11,3,8,36,35,0,1,0,4
"2011","E00013277","E00013277","Total",188,139,60,79,0,12,7,5,32,31,1,0,0,5
"2011","E00013245","E00013245","Total",130,115,47,68,0,2,2,0,13,12,0,1,0,0
"2011","E00013247","E00013247","Total",135,107,46,61,1,5,5,0,20,17,0,1,2,2
"2011","E00013249","E00013249","Total",125,95,40,55,2,15,15,0,13,12,0,1,0,0
"2011","E00013250","E00013250","Total",125,51,18,33,0,67,61,6,6,6,0,0,0,1
"2011","E00013252","E00013252","Total",121,69,24,45,0,48,40,8,2,2,0,0,0,2
"2011","E00013254","E00013254","Total",138,50,5,45,0,7,6,1,80,80,0,0,0,1
"2011","E00013256","E00013256","Total",119,25,8,17,1,80,79,1,10,7,0,3,0,3
"2011","E00013260","E00013260","Total",138,2,1,1,0,129,121,8,7,6,0,0,1,0
"2011","E00013261","E00013261","Total",137,62,14,48,0,2,2,0,73,67,0,5,1,0
"2011","E00013262","E00013262","Total",151,36,13,23,18,84,64,20,10,9,0,0,1,3
"2011","E00013253","E00013253","Total",124,19,7,12,1,87,87,0,12,11,0,0,1,5
"2011","E00013255","E00013255","Total",108,16,2,14,0,78,75,3,12,12,0,0,0,2
"2011","E00013257","E00013257","Total",124,6,2,4,0,116,108,8,1,1,0,0,0,1
"2011","E00013258","E00013258","Total",107,1,0,1,0,100,98,2,4,3,0,1,0,2
"2011","E00013259","E00013259","Total",158,22,8,14,2,125,123,2,6,6,0,0,0,3
"2011","E00013150","E00013150","Total",126,72,9,63,2,6,3,3,45,44,0,0,1,1
"2011","E00013153","E00013153","Total",135,74,35,39,2,32,25,7,23,23,0,0,0,4
"2011","E00013155","E00013155","Total",111,26,9,17,8,62,14,48,13,13,0,0,0,2
"2011","E00013160","E00013160","Total",133,60,8,52,16,26,8,18,29,28,0,1,0,2
"2011","E00013161","E00013161","Total",126,67,28,39,1,21,12,9,36,35,0,1,0,1
"2011","E00013177","E00013177","Total",122,31,11,20,9,64,59,5,17,15,0,2,0,1
"2011","E00013152","E00013152","Total",130,86,37,49,0,17,16,1,25,24,0,1,0,2
"2011","E00013162","E00013162","Total",142,51,10,41,6,43,10,33,41,39,1,1,0,1
"2011","E00013180","E00013180","Total",142,96,50,46,0,4,3,1,40,39,0,1,0,2
"2011","E00168199","E00168199","Total",134,57,3,54,11,15,10,5,50,46,0,4,0,1
"2011","E00168853","E00168853","Total",120,36,5,31,12,40,8,32,32,31,0,1,0,0
"2011","E00168855","E00168855","Total",124,30,11,19,2,55,6,49,35,33,0,2,0,2
"2011","E00013154","E00013154","Total",165,82,36,46,1,24,10,14,55,54,0,1,0,3
"2011","E00013157","E00013157","Total",118,81,46,35,0,10,6,4,25,23,0,1,1,2
"2011","E00013158","E00013158","Total",113,63,30,33,1,17,0,17,32,32,0,0,0,0
"2011","E00013163","E00013163","Total",154,74,31,43,8,13,7,6,59,57,0,2,0,0
"2011","E00013156","E00013156","Total",131,78,39,39,1,8,2,6,44,41,0,3,0,0
"2011","E00013166","E00013166","Total",122,71,36,35,0,18,16,2,29,28,0,1,0,4
"2011","E00013167","E00013167","Total",132,79,27,52,0,11,4,7,38,37,0,0,1,4
"2011","E00013169","E00013169","Total",131,96,47,49,1,5,3,2,28,27,0,1,0,1
"2011","E00013224","E00013224","Total",139,98,52,46,1,3,1,2,35,32,0,1,2,2
"2011","E00013229","E00013229","Total",125,63,19,44,2,32,29,3,27,24,0,3,0,1
"2011","E00013230","E00013230","Total",143,96,47,49,0,5,3,2,42,40,0,1,1,0
"2011","E00012726","E00012726","Total",135,99,36,63,3,13,5,8,19,17,0,2,0,1
"2011","E00012727","E00012727","Total",126,83,31,52,3,16,12,4,23,21,0,1,1,1
"2011","E00012728","E00012728","Total",148,116,54,62,0,8,7,1,23,21,0,2,0,1
"2011","E00012729","E00012729","Total",131,96,46,50,1,5,1,4,27,26,0,1,0,2
"2011","E00012731","E00012731","Total",141,100,29,71,0,5,4,1,35,33,0,2,0,1
"2011","E00012713","E00012713","Total",117,91,34,57,1,7,3,4,18,15,1,2,0,0
"2011","E00012714","E00012714","Total",152,116,46,70,0,14,6,8,20,19,0,1,0,2
"2011","E00012715","E00012715","Total",136,99,37,62,1,10,8,2,25,24,0,1,0,1
"2011","E00012730","E00012730","Total",114,59,16,43,1,20,18,2,32,31,0,1,0,2
"2011","E00012734","E00012734","Total",120,57,23,34,2,41,36,5,16,15,0,1,0,4
"2011","E00012889","E00012889","Total",118,94,44,50,1,5,3,2,16,13,0,3,0,2
"2011","E00012898","E00012898","Total",142,93,28,65,0,12,9,3,36,34,1,1,0,1
"2011","E00012900","E00012900","Total",122,100,43,57,2,7,6,1,12,10,2,0,0,1
"2011","E00012901","E00012901","Total",194,39,15,24,1,121,98,23,29,28,1,0,0,4
"2011","E00012919","E00012919","Total",150,96,37,59,1,5,3,2,46,43,0,1,2,2
"2011","E00012891","E00012891","Total",166,66,17,49,1,14,10,4,83,78,0,3,2,2
"2011","E00012903","E00012903","Total",103,42,16,26,1,33,32,1,25,23,0,1,1,2
"2011","E00012904","E00012904","Total",116,58,28,30,0,48,46,2,8,6,0,0,2,2
"2011","E00012906","E00012906","Total",125,100,32,68,0,4,3,1,21,19,0,2,0,0
"2011","E00012909","E00012909","Total",140,39,14,25,0,89,85,4,9,9,0,0,0,3
"2011","E00012912","E00012912","Total",139,73,38,35,0,41,39,2,21,19,0,2,0,4
"2011","E00012892","E00012892","Total",141,65,16,49,0,66,64,2,9,7,0,1,1,1
"2011","E00012910","E00012910","Total",172,79,24,55,17,53,29,24,22,21,0,1,0,1
"2011","E00012911","E00012911","Total",130,54,15,39,1,58,53,5,14,13,0,1,0,3
"2011","E00012914","E00012914","Total",132,74,28,46,0,38,37,1,16,16,0,0,0,4
"2011","E00012916","E00012916","Total",137,96,38,58,2,24,23,1,13,12,0,1,0,2
"2011","E00012732","E00012732","Total",191,86,22,64,15,23,4,19,61,56,0,4,1,6
"2011","E00012736","E00012736","Total",133,69,35,34,2,38,33,5,22,21,0,1,0,2
"2011","E00012739","E00012739","Total",152,121,64,57,0,19,18,1,12,12,0,0,0,0
"2011","E00012744","E00012744","Total",120,29,11,18,4,63,55,8,20,16,0,1,3,4
"2011","E00012745","E00012745","Total",147,54,20,34,20,49,44,5,19,18,0,1,0,5
"2011","E00012733","E00012733","Total",129,28,8,20,34,54,20,34,11,10,0,1,0,2
"2011","E00012735","E00012735","Total",128,103,44,59,0,8,7,1,15,14,0,0,1,2
"2011","E00012738","E00012738","Total",136,77,36,41,4,37,20,17,16,15,0,1,0,2
"2011","E00012740","E00012740","Total",127,11,4,7,7,66,1,65,43,39,0,0,4,0
"2011","E00168873","E00168873","Total",134,30,5,25,35,60,2,58,9,6,0,3,0,0
"2011","E00168894","E00168894","Total",119,45,20,25,17,41,6,35,15,15,0,0,0,1
"2011","E00012720","E00012720","Total",163,31,8,23,1,114,84,30,15,14,0,1,0,2
"2011","E00012721","E00012721","Total",137,87,27,60,10,29,27,2,10,9,0,1,0,1
"2011","E00012742","E00012742","Total",153,108,54,54,1,24,21,3,20,16,0,4,0,0
"2011","E00166034","E00166034","Total",126,14,1,13,58,40,16,24,13,11,0,1,1,1
"2011","E00168182","E00168182","Total",112,52,12,40,8,30,22,8,22,21,0,1,0,0
"2011","E00168863","E00168863","Total",166,14,4,10,9,5,0,5,137,137,0,0,0,1
"2011","E00012716","E00012716","Total",130,80,25,55,1,30,27,3,19,17,0,1,1,0
"2011","E00012719","E00012719","Total",105,87,34,53,1,8,6,2,9,8,0,1,0,0
"2011","E00012722","E00012722","Total",137,82,29,53,2,43,39,4,9,9,0,0,0,1
"2011","E00012741","E00012741","Total",109,86,35,51,2,7,6,1,14,14,0,0,0,0
"2011","E00012743","E00012743","Total",134,35,10,25,2,86,75,11,10,8,1,1,0,1
"2011","E00012717","E00012717","Total",127,38,5,33,31,47,7,40,11,9,0,1,1,0
"2011","E00012723","E00012723","Total",141,11,3,8,0,120,111,9,7,7,0,0,0,3
"2011","E00012724","E00012724","Total",146,31,3,28,54,45,9,36,14,12,0,1,1,2
"2011","E00012725","E00012725","Total",137,15,3,12,29,84,19,65,6,6,0,0,0,3
"2011","E00012890","E00012890","Total",135,82,37,45,0,40,37,3,12,11,1,0,0,1
"2011","E00012894","E00012894","Total",118,70,24,46,2,30,27,3,13,12,0,0,1,3
"2011","E00012896","E00012896","Total",116,68,24,44,0,42,35,7,3,3,0,0,0,3
"2011","E00012897","E00012897","Total",134,86,34,52,2,30,22,8,15,14,0,1,0,1
"2011","E00012918","E00012918","Total",123,80,31,49,2,27,25,2,12,12,0,0,0,2
"2011","E00012899","E00012899","Total",146,107,52,55,1,11,9,2,25,24,0,1,0,2
"2011","E00012902","E00012902","Total",186,75,40,35,0,76,75,1,31,27,0,3,1,4
"2011","E00012908","E00012908","Total",130,92,45,47,1,3,3,0,33,32,0,1,0,1
"2011","E00012913","E00012913","Total",130,105,49,56,2,5,2,3,17,15,0,2,0,1
"2011","E00012915","E00012915","Total",133,105,40,65,3,4,4,0,21,20,0,1,0,0
"2011","E00012893","E00012893","Total",121,91,41,50,0,7,5,2,20,17,1,1,1,3
"2011","E00012895","E00012895","Total",124,89,36,53,1,5,4,1,28,27,0,1,0,1
"2011","E00012905","E00012905","Total",124,88,33,55,2,7,2,5,26,24,0,2,0,1
"2011","E00012907","E00012907","Total",138,91,39,52,3,24,20,4,19,18,0,1,0,1
"2011","E00012917","E00012917","Total",135,96,46,50,0,14,9,5,22,22,0,0,0,3
"2011","E00013007","E00013007","Total",134,92,42,50,1,31,23,8,9,9,0,0,0,1
"2011","E00013009","E00013009","Total",132,110,50,60,0,1,0,1,21,21,0,0,0,0
"2011","E00013010","E00013010","Total",108,83,31,52,1,2,1,1,20,20,0,0,0,2
"2011","E00013013","E00013013","Total",126,35,14,21,0,82,4,78,8,7,1,0,0,1
"2011","E00013015","E00013015","Total",136,115,43,72,1,8,5,3,10,9,0,1,0,2
"2011","E00013008","E00013008","Total",106,79,30,49,2,12,11,1,12,10,0,0,2,1
"2011","E00013011","E00013011","Total",155,44,34,10,2,92,82,10,11,10,0,1,0,6
"2011","E00013012","E00013012","Total",192,76,31,45,28,73,26,47,14,12,0,2,0,1
"2011","E00013014","E00013014","Total",126,99,34,65,1,3,3,0,23,21,0,2,0,0
"2011","E00013017","E00013017","Total",120,50,27,23,0,27,7,20,42,41,0,1,0,1
"2011","E00012990","E00012990","Total",134,103,53,50,4,11,8,3,14,14,0,0,0,2
"2011","E00013016","E00013016","Total",124,70,24,46,1,33,32,1,18,17,0,0,1,2
"2011","E00013019","E00013019","Total",110,70,16,54,3,25,23,2,12,11,0,1,0,0
"2011","E00013020","E00013020","Total",102,77,30,47,1,15,12,3,8,7,0,1,0,1
"2011","E00013022","E00013022","Total",139,98,26,72,1,11,9,2,26,24,0,2,0,3
"2011","E00012939","E00012939","Total",182,89,23,66,12,50,24,26,30,27,0,1,2,1
"2011","E00012943","E00012943","Total",143,74,27,47,4,32,29,3,32,32,0,0,0,1
"2011","E00012949","E00012949","Total",79,11,2,9,1,59,51,8,7,7,0,0,0,1
"2011","E00012953","E00012953","Total",114,74,24,50,3,23,16,7,12,12,0,0,0,2
"2011","E00012954","E00012954","Total",131,66,18,48,2,35,31,4,26,25,0,1,0,2
"2011","E00012934","E00012934","Total",104,27,5,22,0,70,63,7,6,6,0,0,0,1
"2011","E00012936","E00012936","Total",115,6,0,6,11,96,10,86,1,1,0,0,0,1
"2011","E00012940","E00012940","Total",120,95,35,60,0,11,6,5,14,13,0,0,1,0
"2011","E00012942","E00012942","Total",116,88,32,56,0,7,1,6,21,19,0,2,0,0
"2011","E00012945","E00012945","Total",114,108,30,78,2,1,0,1,3,3,0,0,0,0
"2011","E00012946","E00012946","Total",126,60,17,43,1,50,43,7,14,14,0,0,0,1
"2011","E00012948","E00012948","Total",128,99,46,53,3,7,4,3,19,15,0,4,0,0
"2011","E00012951","E00012951","Total",126,50,18,32,3,57,54,3,13,13,0,0,0,3
"2011","E00012952","E00012952","Total",140,71,17,54,0,54,47,7,13,12,0,0,1,2
"2011","E00012929","E00012929","Total",125,64,19,45,1,29,26,3,30,28,0,2,0,1
"2011","E00012930","E00012930","Total",186,52,20,32,4,112,36,76,16,15,1,0,0,2
"2011","E00012931","E00012931","Total",122,56,8,48,6,44,16,28,15,14,0,1,0,1
"2011","E00166040","E00166040","Total",94,61,11,50,1,9,4,5,23,23,0,0,0,0
"2011","E00168889","E00168889","Total",139,85,9,76,9,8,2,6,37,36,0,1,0,0
"2011","E00012932","E00012932","Total",94,23,6,17,0,53,48,5,16,15,0,1,0,2
"2011","E00012933","E00012933","Total",116,30,10,20,1,74,68,6,8,8,0,0,0,3
"2011","E00166032","E00166032","Total",119,7,2,5,0,109,90,19,1,1,0,0,0,2
"2011","E00166042","E00166042","Total",115,14,1,13,3,77,3,74,21,20,0,0,1,0
"2011","E00168884","E00168884","Total",105,3,1,2,0,95,83,12,3,2,0,0,1,4
"2011","E00168892","E00168892","Total",114,18,6,12,0,83,57,26,12,11,0,1,0,1
"2011","E00166044","E00166044","Total",227,73,5,68,32,8,1,7,114,113,0,0,1,0
"2011","E00168183","E00168183","Total",94,12,1,11,0,4,3,1,78,76,0,1,1,0
"2011","E00168866","E00168866","Total",142,12,2,10,24,10,4,6,96,95,0,0,1,0
"2011","E00168870","E00168870","Total",91,8,4,4,27,54,5,49,1,0,0,1,0,1
"2011","E00168887","E00168887","Total",129,32,4,28,9,49,1,48,37,34,0,0,3,2
"2011","E00168891","E00168891","Total",90,8,1,7,74,3,1,2,5,5,0,0,0,0
"2011","E00012965","E00012965","Total",165,21,1,20,0,130,55,75,11,8,0,2,1,3
"2011","E00012966","E00012966","Total",149,9,2,7,1,135,12,123,4,2,0,0,2,0
"2011","E00012967","E00012967","Total",147,39,12,27,1,96,31,65,10,10,0,0,0,1
"2011","E00012971","E00012971","Total",127,47,11,36,1,65,17,48,12,10,0,2,0,2
"2011","E00012968","E00012968","Total",119,48,21,27,1,54,18,36,14,13,0,0,1,2
"2011","E00012972","E00012972","Total",156,42,11,31,2,97,17,80,12,11,0,1,0,3
"2011","E00012975","E00012975","Total",122,83,39,44,2,18,5,13,12,10,0,1,1,7
"2011","E00012976","E00012976","Total",130,76,28,48,0,37,13,24,16,12,0,4,0,1
"2011","E00012980","E00012980","Total",112,52,19,33,1,27,26,1,31,29,0,2,0,1
"2011","E00012984","E00012984","Total",114,75,27,48,0,8,2,6,30,30,0,0,0,1
"2011","E00012974","E00012974","Total",128,67,27,40,1,48,30,18,10,10,0,0,0,2
"2011","E00012977","E00012977","Total",117,21,5,16,0,87,83,4,6,6,0,0,0,3
"2011","E00012981","E00012981","Total",152,43,14,29,1,98,83,15,8,8,0,0,0,2
"2011","E00012982","E00012982","Total",127,30,8,22,1,82,76,6,13,13,0,0,0,1
"2011","E00012983","E00012983","Total",147,18,3,15,0,119,118,1,6,5,0,1,0,4
"2011","E00012963","E00012963","Total",141,91,40,51,1,12,8,4,36,36,0,0,0,1
"2011","E00012964","E00012964","Total",131,85,35,50,2,28,12,16,15,15,0,0,0,1
"2011","E00012969","E00012969","Total",128,80,35,45,4,26,7,19,17,17,0,0,0,1
"2011","E00012970","E00012970","Total",142,70,29,41,0,45,18,27,25,22,0,3,0,2
"2011","E00012973","E00012973","Total",134,84,28,56,1,12,5,7,35,35,0,0,0,2
"2011","E00012992","E00012992","Total",113,5,1,4,25,76,48,28,7,7,0,0,0,0
"2011","E00012993","E00012993","Total",128,30,10,20,0,83,79,4,12,11,0,1,0,3
"2011","E00013003","E00013003","Total",121,16,6,10,0,99,96,3,4,3,0,1,0,2
"2011","E00013021","E00013021","Total",115,22,3,19,0,82,79,3,5,4,0,1,0,6
"2011","E00013023","E00013023","Total",129,100,34,66,1,13,7,6,12,9,0,3,0,3
"2011","E00012937","E00012937","Total",128,63,14,49,4,43,3,40,18,17,0,1,0,0
"2011","E00012941","E00012941","Total",148,56,9,47,1,10,7,3,79,76,0,3,0,2
"2011","E00012944","E00012944","Total",133,74,13,61,1,6,6,0,51,51,0,0,0,1
"2011","E00012947","E00012947","Total",128,49,5,44,1,4,3,1,74,72,0,2,0,0
"2011","E00166045","E00166045","Total",137,81,9,72,2,7,2,5,45,42,0,1,2,2
"2011","E00168181","E00168181","Total",98,12,2,10,25,51,3,48,10,10,0,0,0,0
"2011","E00012920","E00012920","Total",141,110,36,74,1,16,16,0,13,13,0,0,0,1
"2011","E00012923","E00012923","Total",132,101,28,73,0,5,5,0,26,25,1,0,0,0
"2011","E00166029","E00166029","Total",125,49,12,37,12,16,2,14,45,43,0,2,0,3
"2011","E00166031","E00166031","Total",121,57,6,51,32,3,2,1,28,26,0,1,1,1
"2011","E00168180","E00168180","Total",118,56,12,44,3,17,14,3,41,37,2,2,0,1
"2011","E00012925","E00012925","Total",140,109,27,82,3,14,13,1,14,10,0,4,0,0
"2011","E00012926","E00012926","Total",146,124,45,79,2,6,5,1,12,10,0,2,0,2
"2011","E00012927","E00012927","Total",155,134,41,93,1,6,5,1,14,14,0,0,0,0
"2011","E00012928","E00012928","Total",123,109,47,62,1,3,3,0,10,8,0,1,1,0
"2011","E00012994","E00012994","Total",146,108,59,49,4,8,6,2,25,24,0,1,0,1
"2011","E00012995","E00012995","Total",145,105,35,70,3,8,2,6,28,28,0,0,0,1
"2011","E00012999","E00012999","Total",136,100,38,62,2,5,2,3,29,27,0,2,0,0
"2011","E00013001","E00013001","Total",137,78,23,55,2,7,0,7,47,43,0,4,0,3
"2011","E00013018","E00013018","Total",194,58,18,40,2,39,16,23,93,87,0,4,2,2
"2011","E00012991","E00012991","Total",147,101,50,51,1,27,11,16,15,15,0,0,0,3
"2011","E00012996","E00012996","Total",127,95,53,42,1,5,5,0,26,24,0,2,0,0
"2011","E00012998","E00012998","Total",131,113,55,58,8,3,2,1,7,6,0,0,1,0
"2011","E00013002","E00013002","Total",130,90,41,49,0,35,32,3,3,3,0,0,0,2
"2011","E00012957","E00012957","Total",138,39,20,19,0,85,78,7,11,10,0,0,1,3
"2011","E00012958","E00012958","Total",134,88,46,42,3,35,31,4,5,5,0,0,0,3
"2011","E00012978","E00012978","Total",157,55,22,33,2,58,43,15,40,35,1,3,1,2
"2011","E00012979","E00012979","Total",118,78,23,55,11,15,2,13,14,11,0,3,0,0
"2011","E00012987","E00012987","Total",129,52,16,36,0,60,57,3,16,14,0,2,0,1
"2011","E00012956","E00012956","Total",129,104,40,64,1,9,7,2,14,11,0,3,0,1
"2011","E00012985","E00012985","Total",126,106,40,66,3,6,4,2,11,11,0,0,0,0
"2011","E00012986","E00012986","Total",117,93,44,49,1,7,5,2,14,13,1,0,0,2
"2011","E00012988","E00012988","Total",138,88,31,57,5,26,22,4,19,16,0,3,0,0
"2011","E00012989","E00012989","Total",145,119,40,79,8,5,3,2,13,13,0,0,0,0
"2011","E00012955","E00012955","Total",139,61,25,36,0,69,64,5,5,5,0,0,0,4
"2011","E00012959","E00012959","Total",107,92,46,46,1,5,3,2,9,9,0,0,0,0
"2011","E00012960","E00012960","Total",136,64,31,33,3,50,47,3,17,16,0,1,0,2
"2011","E00012961","E00012961","Total",132,22,8,14,1,100,99,1,8,8,0,0,0,1
"2011","E00012962","E00012962","Total",118,64,23,41,1,42,40,2,8,7,1,0,0,3
"2011","E00012997","E00012997","Total",116,85,33,52,1,15,13,2,11,8,0,3,0,4
"2011","E00013000","E00013000","Total",133,101,28,73,1,12,4,8,18,18,0,0,0,1
"2011","E00013004","E00013004","Total",129,103,40,63,2,7,3,4,17,17,0,0,0,0
"2011","E00013005","E00013005","Total",145,122,52,70,0,3,1,2,19,18,0,1,0,1
"2011","E00013006","E00013006","Total",119,111,59,52,0,4,2,2,3,2,0,1,0,1
"2011","E00013344","E00013344","Total",157,94,47,47,3,9,1,8,49,47,1,1,0,2
"2011","E00013345","E00013345","Total",139,61,30,31,0,29,22,7,46,44,1,1,0,3
"2011","E00013363","E00013363","Total",126,55,22,33,0,3,3,0,64,60,2,2,0,4
"2011","E00013364","E00013364","Total",133,62,30,32,1,17,7,10,53,52,0,1,0,0
"2011","E00013371","E00013371","Total",166,79,28,51,2,14,11,3,70,67,0,3,0,1
"2011","E00013374","E00013374","Total",111,49,25,24,0,9,8,1,53,52,0,1,0,0
"2011","E00013375","E00013375","Total",135,72,38,34,0,0,0,0,62,60,0,2,0,1
"2011","E00013376","E00013376","Total",111,77,45,32,0,1,0,1,31,30,0,1,0,2
"2011","E00013378","E00013378","Total",117,80,51,29,1,2,2,0,32,31,0,1,0,2
"2011","E00013379","E00013379","Total",114,68,32,36,0,4,3,1,41,38,0,1,2,1
"2011","E00013383","E00013383","Total",114,70,29,41,0,4,0,4,37,36,0,1,0,3
"2011","E00013350","E00013350","Total",133,65,28,37,0,14,9,5,54,50,0,4,0,0
"2011","E00013351","E00013351","Total",139,67,42,25,0,21,21,0,49,47,0,0,2,2
"2011","E00013357","E00013357","Total",113,29,8,21,1,16,14,2,67,67,0,0,0,0
"2011","E00013358","E00013358","Total",180,65,24,41,0,53,26,27,59,55,0,3,1,3
"2011","E00013361","E00013361","Total",143,47,20,27,0,55,48,7,38,38,0,0,0,3
"2011","E00013377","E00013377","Total",203,69,36,33,2,20,9,11,111,106,1,1,3,1
"2011","E00013348","E00013348","Total",169,100,90,10,1,1,0,1,60,57,1,2,0,7
"2011","E00013349","E00013349","Total",128,48,26,22,0,17,9,8,60,60,0,0,0,3
"2011","E00013352","E00013352","Total",148,59,28,31,2,27,11,16,58,58,0,0,0,2
"2011","E00013353","E00013353","Total",106,72,38,34,0,5,5,0,28,26,0,1,1,1
"2011","E00013380","E00013380","Total",152,101,56,45,0,15,9,6,35,35,0,0,0,1
"2011","E00013381","E00013381","Total",138,32,18,14,0,71,62,9,35,33,0,2,0,0
"2011","E00013346","E00013346","Total",137,67,34,33,1,7,5,2,61,59,0,1,1,1
"2011","E00013347","E00013347","Total",152,44,24,20,0,1,1,0,104,101,1,1,1,3
"2011","E00013355","E00013355","Total",122,61,40,21,0,4,3,1,53,51,0,1,1,4
"2011","E00013356","E00013356","Total",118,78,40,38,1,4,1,3,32,30,0,2,0,3
"2011","E00013360","E00013360","Total",109,67,50,17,1,2,1,1,38,37,0,0,1,1
"2011","E00013384","E00013384","Total",107,37,15,22,0,4,0,4,65,65,0,0,0,1
"2011","E00165798","E00165798","Total",115,35,14,21,0,31,27,4,46,41,0,4,1,3
"2011","E00015138","E00015138","Total",116,95,47,48,1,0,0,0,20,19,0,1,0,0
"2011","E00015141","E00015141","Total",116,99,46,53,0,4,2,2,11,10,0,1,0,2
"2011","E00015144","E00015144","Total",133,96,47,49,1,1,0,1,31,29,0,2,0,4
"2011","E00015146","E00015146","Total",133,94,35,59,0,1,0,1,35,34,1,0,0,3
"2011","E00015164","E00015164","Total",113,64,31,33,0,42,1,41,6,5,0,1,0,1
"2011","E00015140","E00015140","Total",152,142,64,78,0,1,1,0,7,6,0,1,0,2
"2011","E00015142","E00015142","Total",132,99,44,55,0,19,19,0,13,11,0,2,0,1
"2011","E00015145","E00015145","Total",124,100,42,58,0,5,5,0,17,15,1,0,1,2
"2011","E00015165","E00015165","Total",141,122,55,67,0,0,0,0,17,14,0,3,0,2
"2011","E00015147","E00015147","Total",127,119,58,61,0,0,0,0,7,6,0,1,0,1
"2011","E00015151","E00015151","Total",115,104,45,59,1,0,0,0,10,10,0,0,0,0
"2011","E00015152","E00015152","Total",138,124,54,70,0,2,1,1,12,11,0,1,0,0
"2011","E00015153","E00015153","Total",134,121,46,75,0,2,0,2,10,10,0,0,0,1
"2011","E00015143","E00015143","Total",116,49,20,29,13,41,26,15,13,11,0,2,0,0
"2011","E00015148","E00015148","Total",123,73,34,39,1,9,8,1,39,39,0,0,0,1
"2011","E00015150","E00015150","Total",148,116,44,72,4,2,2,0,24,21,0,3,0,2
"2011","E00015154","E00015154","Total",116,55,18,37,0,56,7,49,5,5,0,0,0,0
"2011","E00015155","E00015155","Total",126,107,49,58,0,2,0,2,17,17,0,0,0,0
"2011","E00015157","E00015157","Total",144,124,62,62,2,5,2,3,11,11,0,0,0,2
"2011","E00015139","E00015139","Total",169,94,38,56,4,32,1,31,38,36,0,2,0,1
"2011","E00015149","E00015149","Total",142,124,81,43,0,2,1,1,15,15,0,0,0,1
"2011","E00015156","E00015156","Total",105,96,45,51,0,0,0,0,9,9,0,0,0,0
"2011","E00015159","E00015159","Total",138,122,47,75,0,1,0,1,14,13,0,0,1,1
"2011","E00014859","E00014859","Total",124,102,60,42,0,4,0,4,16,16,0,0,0,2
"2011","E00014876","E00014876","Total",114,85,63,22,0,0,0,0,25,24,1,0,0,4
"2011","E00014877","E00014877","Total",124,103,58,45,1,0,0,0,16,16,0,0,0,4
"2011","E00014888","E00014888","Total",124,107,66,41,0,1,1,0,14,13,1,0,0,2
"2011","E00014861","E00014861","Total",171,129,71,58,2,1,1,0,36,36,0,0,0,3
"2011","E00014866","E00014866","Total",133,85,39,46,0,9,3,6,37,35,0,2,0,2
"2011","E00014881","E00014881","Total",149,121,74,47,1,2,1,1,22,21,1,0,0,3
"2011","E00014862","E00014862","Total",134,103,48,55,0,2,2,0,26,24,0,1,1,3
"2011","E00014869","E00014869","Total",115,81,41,40,1,11,9,2,22,21,1,0,0,0
"2011","E00014870","E00014870","Total",130,96,46,50,1,7,7,0,25,24,0,1,0,1
"2011","E00014872","E00014872","Total",134,75,23,52,1,2,1,1,50,47,0,2,1,6
"2011","E00014863","E00014863","Total",113,99,45,54,0,1,0,1,12,12,0,0,0,1
"2011","E00014871","E00014871","Total",105,71,37,34,1,21,20,1,11,10,0,1,0,1
"2011","E00014874","E00014874","Total",119,93,62,31,0,0,0,0,22,22,0,0,0,4
"2011","E00174866","E00174866","Total",54,38,14,24,0,10,8,2,6,6,0,0,0,0
"2011","E00174867","E00174867","Total",46,36,20,16,0,0,0,0,8,8,0,0,0,2
"2011","E00014893","E00014893","Total",122,106,53,53,0,0,0,0,14,14,0,0,0,2
"2011","E00014900","E00014900","Total",115,109,65,44,1,1,0,1,3,3,0,0,0,1
"2011","E00014901","E00014901","Total",119,105,62,43,0,1,1,0,12,9,1,1,1,1
"2011","E00014902","E00014902","Total",123,109,59,50,0,0,0,0,14,14,0,0,0,0
"2011","E00014768","E00014768","Total",126,79,31,48,0,2,0,2,43,41,1,1,0,2
"2011","E00014770","E00014770","Total",116,49,19,30,0,5,1,4,58,52,0,5,1,4
"2011","E00014771","E00014771","Total",138,63,25,38,1,1,1,0,70,62,1,3,4,3
"2011","E00014772","E00014772","Total",132,60,19,41,0,5,4,1,59,58,1,0,0,8
"2011","E00014795","E00014795","Total",131,73,25,48,0,15,2,13,43,39,0,2,2,0
"2011","E00014797","E00014797","Total",132,68,19,49,0,14,13,1,50,44,2,3,1,0
"2011","E00014769","E00014769","Total",124,85,32,53,0,12,12,0,27,25,0,1,1,0
"2011","E00014778","E00014778","Total",128,99,46,53,0,3,2,1,25,22,0,3,0,1
"2011","E00014779","E00014779","Total",125,97,48,49,0,4,1,3,22,10,8,0,4,2
"2011","E00014782","E00014782","Total",129,84,44,40,0,22,22,0,23,22,0,1,0,0
"2011","E00014784","E00014784","Total",133,67,29,38,0,23,23,0,42,40,0,2,0,1
"2011","E00014785","E00014785","Total",143,121,47,74,0,2,2,0,20,20,0,0,0,0
"2011","E00014879","E00014879","Total",120,82,31,51,0,3,3,0,34,33,0,0,1,1
"2011","E00014882","E00014882","Total",124,82,39,43,0,4,3,1,37,35,1,1,0,1
"2011","E00014884","E00014884","Total",129,89,46,43,0,5,0,5,33,31,1,1,0,2
"2011","E00014885","E00014885","Total",135,69,40,29,0,5,4,1,57,54,1,1,1,4
"2011","E00014887","E00014887","Total",116,84,51,33,0,2,2,0,29,26,0,3,0,1
"2011","E00014860","E00014860","Total",121,68,42,26,1,8,4,4,42,40,0,2,0,2
"2011","E00014865","E00014865","Total",118,47,30,17,0,15,15,0,55,55,0,0,0,1
"2011","E00014867","E00014867","Total",111,27,10,17,0,50,47,3,31,30,0,1,0,3
"2011","E00014868","E00014868","Total",89,24,8,16,0,6,4,2,59,58,0,1,0,0
"2011","E00014886","E00014886","Total",126,82,40,42,0,0,0,0,44,41,0,3,0,0
"2011","E00014873","E00014873","Total",116,18,4,14,0,56,54,2,39,39,0,0,0,3
"2011","E00014875","E00014875","Total",120,47,19,28,0,34,33,1,38,38,0,0,0,1
"2011","E00014878","E00014878","Total",129,71,40,31,0,28,27,1,30,29,0,1,0,0
"2011","E00014880","E00014880","Total",114,20,7,13,0,57,57,0,36,34,0,1,1,1
"2011","E00014883","E00014883","Total",129,15,5,10,0,85,80,5,27,26,0,1,0,2
"2011","E00014775","E00014775","Total",166,46,15,31,1,86,64,22,33,32,0,0,1,0
"2011","E00014788","E00014788","Total",139,78,18,60,0,30,26,4,29,28,0,0,1,2
"2011","E00014789","E00014789","Total",133,73,22,51,1,45,43,2,14,11,0,2,1,0
"2011","E00014790","E00014790","Total",112,28,11,17,0,64,61,3,19,18,0,0,1,1
"2011","E00014794","E00014794","Total",137,79,31,48,2,42,29,13,12,12,0,0,0,2
"2011","E00014799","E00014799","Total",120,84,31,53,1,24,21,3,10,9,1,0,0,1
"2011","E00014780","E00014780","Total",134,94,38,56,4,17,2,15,18,15,1,2,0,1
"2011","E00014781","E00014781","Total",124,10,6,4,0,8,4,4,103,8,59,0,36,3
"2011","E00014783","E00014783","Total",134,117,53,64,0,2,1,1,14,13,1,0,0,1
"2011","E00014786","E00014786","Total",137,94,32,62,0,8,5,3,35,34,1,0,0,0
"2011","E00014787","E00014787","Total",120,86,36,50,1,10,7,3,23,21,1,0,1,0
"2011","E00014773","E00014773","Total",119,93,29,64,0,8,1,7,16,16,0,0,0,2
"2011","E00014774","E00014774","Total",130,97,41,56,1,14,10,4,17,17,0,0,0,1
"2011","E00014776","E00014776","Total",134,96,36,60,0,3,3,0,35,31,0,1,3,0
"2011","E00014791","E00014791","Total",136,120,41,79,0,1,0,1,15,14,0,0,1,0
"2011","E00014796","E00014796","Total",126,110,29,81,0,2,0,2,14,14,0,0,0,0
"2011","E00015158","E00015158","Total",189,127,78,49,0,14,0,14,45,44,0,1,0,3
"2011","E00015160","E00015160","Total",130,102,52,50,0,2,0,2,23,20,1,2,0,3
"2011","E00015161","E00015161","Total",154,102,59,43,1,27,23,4,22,19,0,2,1,2
"2011","E00015162","E00015162","Total",129,89,31,58,1,5,5,0,31,28,0,1,2,3
"2011","E00015163","E00015163","Total",128,95,40,55,0,4,1,3,29,29,0,0,0,0
"2011","E00014800","E00014800","Total",169,90,37,53,0,1,0,1,73,69,0,4,0,5
"2011","E00174871","E00174871","Total",114,24,5,19,0,23,1,22,66,60,0,5,1,1
"2011","E00174873","E00174873","Total",104,24,4,20,0,5,2,3,73,71,0,2,0,2
"2011","E00174875","E00174875","Total",181,39,10,29,3,72,11,61,65,64,0,1,0,2
"2011","E00174879","E00174879","Total",150,40,8,32,28,7,3,4,75,74,0,1,0,0
"2011","E00014777","E00014777","Total",159,70,21,49,0,2,1,1,83,80,1,2,0,4
"2011","E00014792","E00014792","Total",138,106,42,64,1,8,0,8,21,21,0,0,0,2
"2011","E00014798","E00014798","Total",152,74,25,49,1,19,9,10,54,52,2,0,0,4
"2011","E00174874","E00174874","Total",134,40,5,35,2,4,3,1,86,83,0,1,2,2
"2011","E00174878","E00174878","Total",113,40,21,19,0,20,2,18,52,51,0,1,0,1
"2011","E00014920","E00014920","Total",187,88,27,61,15,9,2,7,74,73,0,1,0,1
"2011","E00014921","E00014921","Total",151,33,15,18,3,85,71,14,28,26,0,2,0,2
"2011","E00014923","E00014923","Total",162,47,17,30,0,78,49,29,34,25,8,1,0,3
"2011","E00014928","E00014928","Total",136,50,20,30,0,44,43,1,39,37,0,2,0,3
"2011","E00014929","E00014929","Total",158,49,10,39,0,88,45,43,20,19,1,0,0,1
"2011","E00014933","E00014933","Total",188,71,13,58,0,29,23,6,83,79,0,4,0,5
"2011","E00014962","E00014962","Total",131,8,1,7,0,110,109,1,12,12,0,0,0,1
"2011","E00014968","E00014968","Total",65,13,5,8,0,47,47,0,4,4,0,0,0,1
"2011","E00014969","E00014969","Total",137,10,4,6,0,118,117,1,9,8,0,0,1,0
"2011","E00014970","E00014970","Total",142,25,10,15,1,93,88,5,22,22,0,0,0,1
"2011","E00014972","E00014972","Total",131,22,11,11,1,89,86,3,19,17,1,1,0,0
"2011","E00014974","E00014974","Total",150,8,4,4,0,133,131,2,8,8,0,0,0,1
"2011","E00014951","E00014951","Total",131,68,17,51,0,4,2,2,58,54,0,4,0,1
"2011","E00014960","E00014960","Total",131,76,27,49,2,15,8,7,36,35,0,1,0,2
"2011","E00014975","E00014975","Total",169,64,19,45,1,72,37,35,30,27,0,1,2,2
"2011","E00014976","E00014976","Total",132,101,42,59,0,3,1,2,26,23,0,2,1,2
"2011","E00014977","E00014977","Total",142,100,36,64,1,8,1,7,32,28,1,3,0,1
"2011","E00014955","E00014955","Total",137,59,18,41,0,5,2,3,72,68,0,4,0,1
"2011","E00014957","E00014957","Total",149,89,43,46,0,27,3,24,30,29,0,1,0,3
"2011","E00014958","E00014958","Total",236,91,29,62,6,51,27,24,85,82,1,1,1,3
"2011","E00014964","E00014964","Total",168,75,26,49,2,13,11,2,75,71,0,4,0,3
"2011","E00014966","E00014966","Total",138,55,17,38,9,27,10,17,45,41,2,2,0,2
"2011","E00014954","E00014954","Total",223,106,46,60,7,4,4,0,103,94,1,7,1,3
"2011","E00014956","E00014956","Total",116,88,37,51,0,6,3,3,21,19,0,2,0,1
"2011","E00014959","E00014959","Total",134,66,25,41,0,51,48,3,16,15,0,1,0,1
"2011","E00014961","E00014961","Total",124,105,52,53,1,8,6,2,10,9,1,0,0,0
"2011","E00014963","E00014963","Total",129,9,2,7,2,96,92,4,16,15,0,0,1,6
"2011","E00014738","E00014738","Total",98,47,20,27,1,38,36,2,12,12,0,0,0,0
"2011","E00014741","E00014741","Total",122,36,9,27,14,39,3,36,31,28,0,2,1,2
"2011","E00014759","E00014759","Total",131,79,25,54,0,12,6,6,36,35,0,1,0,4
"2011","E00014766","E00014766","Total",187,13,7,6,21,131,12,119,19,13,0,6,0,3
"2011","E00014767","E00014767","Total",140,55,14,41,1,57,37,20,27,22,0,4,1,0
"2011","E00014903","E00014903","Total",117,96,39,57,1,2,2,0,17,16,0,1,0,1
"2011","E00014906","E00014906","Total",94,50,20,30,1,2,1,1,41,41,0,0,0,0
"2011","E00014908","E00014908","Total",117,103,60,43,0,5,3,2,8,7,0,1,0,1
"2011","E00014909","E00014909","Total",132,91,43,48,0,11,9,2,30,27,0,3,0,0
"2011","E00014913","E00014913","Total",114,89,44,45,1,5,4,1,18,18,0,0,0,1
"2011","E00014889","E00014889","Total",126,76,23,53,1,38,33,5,8,8,0,0,0,3
"2011","E00014891","E00014891","Total",125,65,23,42,0,36,36,0,23,22,0,1,0,1
"2011","E00014904","E00014904","Total",126,106,48,58,1,4,2,2,15,14,0,1,0,0
"2011","E00014916","E00014916","Total",134,78,36,42,0,34,29,5,20,18,0,1,1,2
"2011","E00014950","E00014950","Total",114,50,18,32,0,44,42,2,19,19,0,0,0,1
"2011","E00014965","E00014965","Total",109,55,22,33,0,34,34,0,19,17,0,0,2,1
"2011","E00014967","E00014967","Total",117,64,22,42,1,29,29,0,22,21,0,0,1,1
"2011","E00014971","E00014971","Total",123,43,11,32,2,21,18,3,56,53,0,3,0,1
"2011","E00014979","E00014979","Total",107,54,17,37,1,26,23,3,23,20,0,2,1,3
"2011","E00014952","E00014952","Total",105,42,13,29,0,47,44,3,14,11,0,2,1,2
"2011","E00014953","E00014953","Total",114,61,26,35,2,13,11,2,37,34,0,3,0,1
"2011","E00014973","E00014973","Total",118,44,11,33,0,45,41,4,27,25,0,1,1,2
"2011","E00014978","E00014978","Total",128,63,22,41,2,24,22,2,38,36,0,1,1,1
"2011","E00014752","E00014752","Total",132,97,69,28,1,2,1,1,30,29,1,0,0,2
"2011","E00014753","E00014753","Total",129,117,70,47,0,0,0,0,11,10,0,1,0,1
"2011","E00014754","E00014754","Total",109,85,40,45,0,7,7,0,16,16,0,0,0,1
"2011","E00014756","E00014756","Total",137,101,44,57,0,10,7,3,23,23,0,0,0,3
"2011","E00014758","E00014758","Total",128,99,52,47,0,1,1,0,28,27,0,0,1,0
"2011","E00014744","E00014744","Total",119,26,9,17,1,34,31,3,52,48,2,0,2,6
"2011","E00014746","E00014746","Total",139,95,45,50,0,8,7,1,35,32,0,3,0,1
"2011","E00014755","E00014755","Total",155,59,17,42,0,12,6,6,82,80,1,0,1,2
"2011","E00014761","E00014761","Total",144,100,51,49,0,3,3,0,39,39,0,0,0,2
"2011","E00014763","E00014763","Total",126,80,43,37,2,1,0,1,43,41,0,2,0,0
"2011","E00014739","E00014739","Total",134,86,45,41,1,9,9,0,35,31,0,3,1,3
"2011","E00014740","E00014740","Total",136,114,42,72,2,5,3,2,14,13,0,0,1,1
"2011","E00014757","E00014757","Total",135,107,39,68,1,1,1,0,23,18,0,5,0,3
"2011","E00014760","E00014760","Total",123,106,51,55,0,2,2,0,15,14,0,0,1,0
"2011","E00014762","E00014762","Total",126,112,50,62,0,3,3,0,10,10,0,0,0,1
"2011","E00014890","E00014890","Total",138,67,38,29,8,36,36,0,27,23,0,2,2,0
"2011","E00014894","E00014894","Total",132,86,38,48,1,7,4,3,36,32,0,2,2,2
"2011","E00014895","E00014895","Total",125,58,24,34,1,6,4,2,58,55,0,2,1,2
"2011","E00014897","E00014897","Total",129,36,12,24,0,3,0,3,89,89,0,0,0,1
"2011","E00014898","E00014898","Total",106,54,22,32,0,16,15,1,35,35,0,0,0,1
"2011","E00014915","E00014915","Total",138,79,31,48,0,3,1,2,54,52,0,1,1,2
"2011","E00015010","E00015010","Total",117,86,53,33,0,6,4,2,24,23,0,0,1,1
"2011","E00015020","E00015020","Total",136,90,36,54,3,9,6,3,32,28,0,2,2,2
"2011","E00015021","E00015021","Total",124,78,32,46,0,17,16,1,26,25,0,1,0,3
"2011","E00015024","E00015024","Total",108,61,21,40,0,7,7,0,37,34,0,2,1,3
"2011","E00015027","E00015027","Total",118,83,31,52,0,6,3,3,28,27,0,1,0,1
"2011","E00014743","E00014743","Total",112,88,42,46,0,3,2,1,20,19,1,0,0,1
"2011","E00014747","E00014747","Total",121,106,58,48,1,2,2,0,12,11,0,1,0,0
"2011","E00014748","E00014748","Total",137,112,52,60,0,12,11,1,13,13,0,0,0,0
"2011","E00014750","E00014750","Total",122,71,40,31,2,37,35,2,9,9,0,0,0,3
"2011","E00014765","E00014765","Total",122,89,29,60,1,1,1,0,30,28,0,2,0,1
"2011","E00014742","E00014742","Total",141,75,27,48,0,6,3,3,56,52,0,4,0,4
"2011","E00014745","E00014745","Total",126,76,50,26,1,3,1,2,40,36,0,3,1,6
"2011","E00014749","E00014749","Total",139,89,46,43,0,0,0,0,48,47,0,1,0,2
"2011","E00014751","E00014751","Total",134,110,63,47,1,5,4,1,17,14,1,1,1,1
"2011","E00014764","E00014764","Total",120,69,28,41,0,6,1,5,42,41,0,1,0,3
"2011","E00014892","E00014892","Total",123,91,35,56,0,10,8,2,22,20,0,1,1,0
"2011","E00014896","E00014896","Total",122,103,34,69,1,7,1,6,11,11,0,0,0,0
"2011","E00014899","E00014899","Total",155,107,29,78,0,5,5,0,43,41,0,2,0,0
"2011","E00014914","E00014914","Total",126,110,44,66,0,0,0,0,16,16,0,0,0,0
"2011","E00014917","E00014917","Total",133,118,53,65,0,4,3,1,9,9,0,0,0,2
"2011","E00014905","E00014905","Total",123,104,60,44,1,2,2,0,16,15,0,0,1,0
"2011","E00014907","E00014907","Total",127,108,60,48,0,1,1,0,17,16,0,1,0,1
"2011","E00014910","E00014910","Total",113,97,62,35,1,0,0,0,13,10,1,0,2,2
"2011","E00014911","E00014911","Total",121,93,39,54,1,7,7,0,18,17,0,0,1,2
"2011","E00014912","E00014912","Total",125,109,37,72,0,2,1,1,13,13,0,0,0,1
"2011","E00015023","E00015023","Total",105,79,41,38,1,4,4,0,21,19,0,2,0,0
"2011","E00015025","E00015025","Total",121,74,30,44,0,36,36,0,10,8,1,1,0,1
"2011","E00015028","E00015028","Total",118,89,53,36,1,13,12,1,15,13,1,1,0,0
"2011","E00015031","E00015031","Total",127,107,59,48,0,2,2,0,18,18,0,0,0,0
"2011","E00014919","E00014919","Total",140,87,62,25,0,1,0,1,51,47,0,4,0,1
"2011","E00014922","E00014922","Total",128,63,37,26,0,38,10,28,26,25,0,0,1,1
"2011","E00014930","E00014930","Total",218,121,46,75,0,26,15,11,70,67,0,3,0,1
"2011","E00014932","E00014932","Total",130,54,22,32,0,10,1,9,65,63,1,1,0,1
"2011","E00014938","E00014938","Total",217,64,23,41,1,15,4,11,137,129,4,0,4,0
"2011","E00014939","E00014939","Total",125,38,11,27,1,24,23,1,61,61,0,0,0,1
"2011","E00014940","E00014940","Total",113,42,22,20,0,30,30,0,40,37,0,2,1,1
"2011","E00014941","E00014941","Total",114,66,29,37,0,6,0,6,42,40,0,2,0,0
"2011","E00014942","E00014942","Total",144,70,37,33,5,9,3,6,60,58,1,1,0,0
"2011","E00014943","E00014943","Total",151,86,38,48,1,2,0,2,62,59,0,2,1,0
"2011","E00014944","E00014944","Total",128,74,38,36,0,7,1,6,47,45,0,2,0,0
"2011","E00014945","E00014945","Total",150,96,46,50,0,2,2,0,51,50,0,1,0,1
"2011","E00014946","E00014946","Total",127,81,31,50,0,2,2,0,44,43,0,1,0,0
"2011","E00014947","E00014947","Total",144,79,35,44,0,1,1,0,60,58,0,2,0,4
"2011","E00014924","E00014924","Total",181,72,25,47,6,18,7,11,83,75,1,4,3,2
"2011","E00014926","E00014926","Total",151,89,37,52,1,8,4,4,53,48,0,2,3,0
"2011","E00014927","E00014927","Total",142,95,34,61,0,10,6,4,36,31,0,2,3,1
"2011","E00014948","E00014948","Total",119,59,16,43,1,4,2,2,53,53,0,0,0,2
"2011","E00014949","E00014949","Total",220,50,18,32,5,26,1,25,133,113,0,0,20,6
"2011","E00174868","E00174868","Total",67,20,11,9,0,1,1,0,44,41,0,3,0,2
"2011","E00174869","E00174869","Total",243,113,56,57,1,4,1,3,121,113,0,4,4,4
"2011","E00015039","E00015039","Total",134,45,8,37,0,4,0,4,83,82,1,0,0,2
"2011","E00015041","E00015041","Total",148,79,46,33,1,0,0,0,65,62,0,3,0,3
"2011","E00015046","E00015046","Total",101,44,7,37,0,27,3,24,30,26,0,3,1,0
"2011","E00015050","E00015050","Total",128,90,34,56,0,0,0,0,38,38,0,0,0,0
"2011","E00015051","E00015051","Total",129,50,15,35,0,0,0,0,77,77,0,0,0,2
"2011","E00015052","E00015052","Total",122,64,34,30,0,14,11,3,44,41,2,1,0,0
"2011","E00015053","E00015053","Total",175,56,21,35,1,9,8,1,109,107,0,1,1,0
"2011","E00015038","E00015038","Total",106,78,30,48,0,1,0,1,26,26,0,0,0,1
"2011","E00015043","E00015043","Total",79,70,28,42,0,0,0,0,9,9,0,0,0,0
"2011","E00015044","E00015044","Total",126,96,37,59,0,3,1,2,26,25,0,1,0,1
"2011","E00015047","E00015047","Total",122,69,32,37,0,10,2,8,41,39,0,1,1,2
"2011","E00015049","E00015049","Total",131,87,36,51,0,2,2,0,42,40,0,2,0,0
"2011","E00015069","E00015069","Total",146,43,19,24,0,8,1,7,93,90,0,0,3,2
"2011","E00014706","E00014706","Total",126,86,40,46,1,0,0,0,37,36,0,1,0,2
"2011","E00014720","E00014720","Total",112,94,46,48,0,3,1,2,15,15,0,0,0,0
"2011","E00014722","E00014722","Total",125,107,52,55,0,0,0,0,15,14,0,1,0,3
"2011","E00014723","E00014723","Total",106,68,31,37,1,9,2,7,27,23,0,2,2,1
"2011","E00014725","E00014725","Total",117,52,28,24,0,46,34,12,18,17,0,0,1,1
"2011","E00014731","E00014731","Total",139,58,25,33,0,37,31,6,42,40,0,2,0,2
"2011","E00014708","E00014708","Total",117,105,58,47,0,1,1,0,11,10,0,1,0,0
"2011","E00014717","E00014717","Total",124,76,36,40,0,4,4,0,41,40,0,1,0,3
"2011","E00014718","E00014718","Total",98,89,37,52,0,3,0,3,6,6,0,0,0,0
"2011","E00014719","E00014719","Total",128,68,26,42,0,2,1,1,57,55,0,2,0,1
"2011","E00014721","E00014721","Total",123,113,49,64,0,3,0,3,7,7,0,0,0,0
"2011","E00014918","E00014918","Total",82,41,19,22,0,25,13,12,14,14,0,0,0,2
"2011","E00014931","E00014931","Total",122,82,32,50,0,2,2,0,38,37,1,0,0,0
"2011","E00014934","E00014934","Total",164,89,40,49,0,13,3,10,61,58,3,0,0,1
"2011","E00014935","E00014935","Total",117,58,18,40,0,10,9,1,46,43,0,3,0,3
"2011","E00014936","E00014936","Total",126,95,31,64,0,0,0,0,30,30,0,0,0,1
"2011","E00014937","E00014937","Total",133,93,40,53,0,16,14,2,24,22,0,2,0,0
"2011","E00015037","E00015037","Total",114,65,25,40,2,9,8,1,36,33,0,2,1,2
"2011","E00015045","E00015045","Total",108,71,14,57,0,6,6,0,29,29,0,0,0,2
"2011","E00015048","E00015048","Total",110,82,35,47,0,3,1,2,25,22,1,2,0,0
"2011","E00174870","E00174870","Total",63,49,22,27,0,7,7,0,7,6,0,0,1,0
"2011","E00174876","E00174876","Total",43,31,13,18,0,3,3,0,8,8,0,0,0,1
"2011","E00014702","E00014702","Total",124,48,16,32,0,14,11,3,60,58,1,1,0,2
"2011","E00014704","E00014704","Total",121,38,18,20,0,26,0,26,57,51,0,4,2,0
"2011","E00014709","E00014709","Total",117,40,14,26,0,14,0,14,63,60,0,3,0,0
"2011","E00014724","E00014724","Total",121,55,14,41,0,7,0,7,58,55,0,3,0,1
"2011","E00014726","E00014726","Total",156,46,16,30,1,37,28,9,72,70,0,1,1,0
"2011","E00014727","E00014727","Total",111,50,19,31,1,22,14,8,38,38,0,0,0,0
"2011","E00014728","E00014728","Total",107,48,19,29,0,4,3,1,54,48,0,6,0,1
"2011","E00015055","E00015055","Total",125,39,15,24,0,25,11,14,58,56,0,1,1,3
"2011","E00015056","E00015056","Total",87,31,11,20,1,5,2,3,49,46,0,1,2,1
"2011","E00015057","E00015057","Total",113,29,17,12,0,62,1,61,19,17,0,2,0,3
"2011","E00015058","E00015058","Total",115,65,26,39,0,2,0,2,45,44,0,1,0,3
"2011","E00015060","E00015060","Total",109,66,43,23,3,0,0,0,38,37,0,1,0,2
"2011","E00015062","E00015062","Total",142,61,21,40,0,6,3,3,70,67,0,3,0,5
"2011","E00015067","E00015067","Total",153,49,7,42,3,7,0,7,90,88,1,1,0,4
"2011","E00015035","E00015035","Total",126,61,33,28,0,2,0,2,62,60,0,2,0,1
"2011","E00015036","E00015036","Total",159,88,31,57,3,25,0,25,43,41,0,1,1,0
"2011","E00015068","E00015068","Total",139,42,14,28,0,22,5,17,72,72,0,0,0,3
"2011","E00174872","E00174872","Total",61,46,15,31,2,4,3,1,8,7,0,1,0,1
"2011","E00174877","E00174877","Total",87,55,20,35,1,2,1,1,29,29,0,0,0,0
"2011","E00015042","E00015042","Total",130,89,33,56,0,6,4,2,35,34,0,1,0,0
"2011","E00015054","E00015054","Total",134,96,35,61,1,2,2,0,33,27,4,1,1,2
"2011","E00015059","E00015059","Total",121,101,35,66,0,1,0,1,18,18,0,0,0,1
"2011","E00015061","E00015061","Total",106,50,9,41,0,6,0,6,50,45,1,3,1,0
"2011","E00015063","E00015063","Total",118,57,20,37,1,6,2,4,53,50,1,1,1,1
"2011","E00015065","E00015065","Total",103,38,3,35,1,2,1,1,61,60,0,1,0,1
"2011","E00015066","E00015066","Total",197,110,39,71,2,3,2,1,82,80,0,1,1,0
"2011","E00014991","E00014991","Total",131,112,61,51,0,1,1,0,18,17,0,1,0,0
"2011","E00014992","E00014992","Total",121,105,42,63,1,1,0,1,13,10,0,3,0,1
"2011","E00014995","E00014995","Total",114,94,45,49,2,0,0,0,17,15,0,2,0,1
"2011","E00014997","E00014997","Total",117,65,34,31,0,26,25,1,25,23,1,0,1,1
"2011","E00014982","E00014982","Total",159,63,20,43,0,70,62,8,25,25,0,0,0,1
"2011","E00014996","E00014996","Total",118,83,41,42,0,27,27,0,8,7,0,1,0,0
"2011","E00014999","E00014999","Total",139,27,8,19,2,94,91,3,15,13,0,1,1,1
"2011","E00015002","E00015002","Total",113,78,45,33,1,15,15,0,19,15,0,2,2,0
"2011","E00015003","E00015003","Total",125,114,59,55,0,3,2,1,8,6,1,1,0,0
"2011","E00014980","E00014980","Total",113,98,56,42,0,1,1,0,13,12,0,1,0,1
"2011","E00014989","E00014989","Total",129,112,56,56,2,3,2,1,12,10,0,2,0,0
"2011","E00014990","E00014990","Total",119,104,51,53,1,3,3,0,10,10,0,0,0,1
"2011","E00014993","E00014993","Total",121,108,45,63,0,0,0,0,12,12,0,0,0,1
"2011","E00015013","E00015013","Total",148,130,63,67,0,2,1,1,14,13,0,1,0,2
"2011","E00015016","E00015016","Total",127,107,58,49,1,2,2,0,17,16,0,0,1,0
"2011","E00015030","E00015030","Total",123,106,47,59,0,5,4,1,9,9,0,0,0,3
"2011","E00015033","E00015033","Total",120,97,41,56,2,1,0,1,18,18,0,0,0,2
"2011","E00015011","E00015011","Total",130,71,28,43,0,34,32,2,24,23,0,1,0,1
"2011","E00015019","E00015019","Total",102,29,15,14,0,52,45,7,18,17,0,1,0,3
"2011","E00015022","E00015022","Total",126,79,42,37,0,26,26,0,19,18,0,0,1,2
"2011","E00015026","E00015026","Total",126,93,55,38,1,6,4,2,24,22,1,1,0,2
"2011","E00015029","E00015029","Total",120,79,52,27,2,20,2,18,19,18,0,1,0,0
"2011","E00014710","E00014710","Total",138,54,17,37,0,43,38,5,40,38,0,0,2,1
"2011","E00014711","E00014711","Total",130,11,2,9,0,111,35,76,7,6,0,1,0,1
"2011","E00014730","E00014730","Total",125,33,7,26,0,62,57,5,29,29,0,0,0,1
"2011","E00014732","E00014732","Total",122,25,6,19,0,81,78,3,15,14,0,1,0,1
"2011","E00014733","E00014733","Total",124,35,13,22,0,54,51,3,34,34,0,0,0,1
"2011","E00014735","E00014735","Total",138,29,11,18,0,96,88,8,12,12,0,0,0,1
"2011","E00014705","E00014705","Total",115,52,10,42,1,9,1,8,53,49,0,4,0,0
"2011","E00014707","E00014707","Total",169,98,27,71,2,26,24,2,42,39,0,3,0,1
"2011","E00014712","E00014712","Total",125,42,12,30,0,11,1,10,70,69,0,1,0,2
"2011","E00014714","E00014714","Total",108,59,38,21,0,3,1,2,40,36,0,2,2,6
"2011","E00014715","E00014715","Total",90,67,14,53,0,3,2,1,19,18,0,1,0,1
"2011","E00014716","E00014716","Total",90,56,15,41,0,2,2,0,31,31,0,0,0,1
"2011","E00014737","E00014737","Total",99,33,5,28,3,9,0,9,54,54,0,0,0,0
"2011","E00015074","E00015074","Total",190,75,49,26,0,4,2,2,109,99,0,10,0,2
"2011","E00015078","E00015078","Total",114,50,24,26,0,3,3,0,60,59,0,0,1,1
"2011","E00015079","E00015079","Total",120,72,45,27,0,1,1,0,43,42,0,1,0,4
"2011","E00015082","E00015082","Total",119,51,30,21,1,1,0,1,66,65,0,1,0,0
"2011","E00015104","E00015104","Total",118,78,29,49,1,1,1,0,37,36,0,1,0,1
"2011","E00015106","E00015106","Total",122,52,28,24,0,3,2,1,67,67,0,0,0,0
"2011","E00015107","E00015107","Total",84,15,7,8,1,35,0,35,33,33,0,0,0,0
"2011","E00015073","E00015073","Total",129,89,39,50,0,1,1,0,38,36,0,2,0,1
"2011","E00015075","E00015075","Total",119,91,56,35,0,1,0,1,25,25,0,0,0,2
"2011","E00015076","E00015076","Total",97,49,26,23,1,2,1,1,45,45,0,0,0,0
"2011","E00015081","E00015081","Total",142,106,44,62,0,1,0,1,34,31,1,2,0,1
"2011","E00015083","E00015083","Total",115,98,54,44,0,2,2,0,9,9,0,0,0,6
"2011","E00015072","E00015072","Total",122,64,33,31,2,2,1,1,54,50,0,3,1,0
"2011","E00015077","E00015077","Total",128,56,14,42,0,18,13,5,54,51,0,3,0,0
"2011","E00015101","E00015101","Total",127,36,10,26,0,26,4,22,64,64,0,0,0,1
"2011","E00015102","E00015102","Total",118,36,10,26,2,31,28,3,49,48,0,1,0,0
"2011","E00015103","E00015103","Total",130,59,29,30,0,16,4,12,54,53,0,1,0,1
"2011","E00015105","E00015105","Total",118,49,27,22,4,2,1,1,62,61,0,0,1,1
"2011","E00014677","E00014677","Total",125,103,46,57,1,1,1,0,20,17,0,3,0,0
"2011","E00014679","E00014679","Total",124,109,49,60,0,5,3,2,8,8,0,0,0,2
"2011","E00014682","E00014682","Total",119,116,64,52,0,0,0,0,3,3,0,0,0,0
"2011","E00014699","E00014699","Total",111,100,48,52,0,3,0,3,7,7,0,0,0,1
"2011","E00014675","E00014675","Total",137,120,72,48,0,3,3,0,13,13,0,0,0,1
"2011","E00014680","E00014680","Total",127,105,50,55,0,6,0,6,14,14,0,0,0,2
"2011","E00014681","E00014681","Total",127,115,63,52,1,0,0,0,11,11,0,0,0,0
"2011","E00014701","E00014701","Total",129,114,46,68,0,0,0,0,14,13,0,0,1,1
"2011","E00014678","E00014678","Total",125,118,71,47,0,0,0,0,7,7,0,0,0,0
"2011","E00014697","E00014697","Total",130,120,65,55,1,0,0,0,8,6,0,1,1,1
"2011","E00014698","E00014698","Total",128,118,60,58,1,1,1,0,7,7,0,0,0,1
"2011","E00014700","E00014700","Total",114,103,41,62,0,0,0,0,10,10,0,0,0,1
"2011","E00014692","E00014692","Total",119,113,46,67,0,0,0,0,6,6,0,0,0,0
"2011","E00014693","E00014693","Total",111,105,45,60,0,0,0,0,6,5,0,1,0,0
"2011","E00014694","E00014694","Total",121,68,28,40,10,31,30,1,10,10,0,0,0,2
"2011","E00014695","E00014695","Total",120,112,65,47,0,0,0,0,8,7,0,1,0,0
"2011","E00014696","E00014696","Total",122,113,53,60,1,0,0,0,7,7,0,0,0,1
"2011","E00014703","E00014703","Total",113,104,62,42,0,3,2,1,6,6,0,0,0,0
"2011","E00014713","E00014713","Total",104,86,41,45,0,1,1,0,17,17,0,0,0,0
"2011","E00014729","E00014729","Total",106,100,51,49,1,0,0,0,4,2,1,0,1,1
"2011","E00014734","E00014734","Total",119,110,49,61,0,1,1,0,8,8,0,0,0,0
"2011","E00014736","E00014736","Total",118,115,64,51,1,1,0,1,1,1,0,0,0,0
"2011","E00014988","E00014988","Total",131,114,50,64,1,5,4,1,11,11,0,0,0,0
"2011","E00014994","E00014994","Total",129,112,39,73,0,1,1,0,16,16,0,0,0,0
"2011","E00015000","E00015000","Total",129,99,41,58,1,13,13,0,16,16,0,0,0,0
"2011","E00015001","E00015001","Total",120,103,52,51,0,5,0,5,11,10,0,0,1,1
"2011","E00015004","E00015004","Total",132,117,59,58,1,0,0,0,13,12,0,1,0,1
"2011","E00014981","E00014981","Total",186,147,66,81,0,13,5,8,22,20,0,2,0,4
"2011","E00014983","E00014983","Total",132,126,72,54,0,0,0,0,6,6,0,0,0,0
"2011","E00014986","E00014986","Total",121,91,48,43,0,1,0,1,23,20,0,3,0,6
"2011","E00015005","E00015005","Total",118,88,37,51,0,0,0,0,29,26,1,2,0,1
"2011","E00015007","E00015007","Total",127,108,67,41,0,8,1,7,10,10,0,0,0,1
"2011","E00014984","E00014984","Total",123,115,58,57,0,1,1,0,4,2,0,2,0,3
"2011","E00014985","E00014985","Total",124,100,49,51,0,11,3,8,11,11,0,0,0,2
"2011","E00014987","E00014987","Total",126,121,57,64,0,0,0,0,5,5,0,0,0,0
"2011","E00014998","E00014998","Total",132,57,10,47,0,10,9,1,62,60,0,2,0,3
"2011","E00015006","E00015006","Total",109,91,44,47,0,13,7,6,4,4,0,0,0,1
"2011","E00015008","E00015008","Total",131,116,60,56,0,0,0,0,15,15,0,0,0,0
"2011","E00015012","E00015012","Total",137,127,66,61,0,0,0,0,10,9,0,1,0,0
"2011","E00015015","E00015015","Total",124,117,70,47,0,0,0,0,5,4,0,1,0,2
"2011","E00015032","E00015032","Total",125,62,27,35,0,41,41,0,22,22,0,0,0,0
"2011","E00015009","E00015009","Total",123,107,47,60,0,2,2,0,13,13,0,0,0,1
"2011","E00015014","E00015014","Total",128,111,58,53,0,7,7,0,9,9,0,0,0,1
"2011","E00015017","E00015017","Total",105,96,46,50,0,2,1,1,7,7,0,0,0,0
"2011","E00015018","E00015018","Total",123,115,64,51,0,2,1,1,4,4,0,0,0,2
"2011","E00015034","E00015034","Total",116,103,60,43,0,6,6,0,5,5,0,0,0,2
"2011","E00015071","E00015071","Total",117,84,21,63,0,4,3,1,29,29,0,0,0,0
"2011","E00015085","E00015085","Total",109,81,40,41,0,9,1,8,16,16,0,0,0,3
"2011","E00015090","E00015090","Total",110,90,39,51,0,1,0,1,19,19,0,0,0,0
"2011","E00015091","E00015091","Total",122,111,70,41,0,1,0,1,10,10,0,0,0,0
"2011","E00015099","E00015099","Total",144,79,28,51,0,4,2,2,60,56,0,3,1,1
"2011","E00015084","E00015084","Total",113,77,25,52,1,1,0,1,33,31,0,1,1,1
"2011","E00015087","E00015087","Total",140,102,40,62,0,2,0,2,33,32,0,1,0,3
"2011","E00015089","E00015089","Total",110,85,39,46,0,3,2,1,20,20,0,0,0,2
"2011","E00015093","E00015093","Total",96,59,23,36,2,2,1,1,33,32,1,0,0,0
"2011","E00015094","E00015094","Total",130,91,28,63,1,6,1,5,32,31,0,1,0,0
"2011","E00015080","E00015080","Total",132,84,23,61,0,4,4,0,42,35,0,5,2,2
"2011","E00015086","E00015086","Total",99,79,31,48,0,1,0,1,19,19,0,0,0,0
"2011","E00015088","E00015088","Total",109,83,48,35,1,12,9,3,12,10,0,2,0,1
"2011","E00015092","E00015092","Total",131,98,38,60,0,3,2,1,30,30,0,0,0,0
"2011","E00015095","E00015095","Total",117,93,35,58,1,0,0,0,23,22,0,1,0,0
"2011","E00015070","E00015070","Total",149,50,12,38,2,82,81,1,15,14,0,1,0,0
"2011","E00015096","E00015096","Total",113,49,18,31,1,47,45,2,16,15,1,0,0,0
"2011","E00015097","E00015097","Total",105,86,27,59,1,1,0,1,17,17,0,0,0,0
"2011","E00015098","E00015098","Total",128,86,31,55,3,5,5,0,34,33,0,1,0,0
"2011","E00015100","E00015100","Total",117,95,37,58,0,5,2,3,17,16,0,1,0,0
"2011","E00015108","E00015108","Total",138,60,27,33,1,57,53,4,19,18,0,1,0,1
"2011","E00015122","E00015122","Total",139,58,30,28,1,39,5,34,38,35,2,0,1,3
"2011","E00015124","E00015124","Total",123,83,31,52,0,12,4,8,28,27,0,1,0,0
"2011","E00015129","E00015129","Total",129,49,19,30,0,68,3,65,12,11,0,1,0,0
"2011","E00015130","E00015130","Total",132,78,19,59,2,9,6,3,43,43,0,0,0,0
"2011","E00015132","E00015132","Total",122,94,30,64,2,4,3,1,21,21,0,0,0,1
"2011","E00014676","E00014676","Total",124,93,26,67,0,8,8,0,22,21,0,1,0,1
"2011","E00014683","E00014683","Total",125,94,43,51,2,1,0,1,27,23,0,2,2,1
"2011","E00014684","E00014684","Total",108,88,32,56,2,2,1,1,15,14,0,1,0,1
"2011","E00014687","E00014687","Total",127,97,23,74,0,5,4,1,24,20,0,4,0,1
"2011","E00014688","E00014688","Total",131,107,38,69,2,6,1,5,15,12,0,3,0,1
"2011","E00014685","E00014685","Total",137,70,35,35,5,32,28,4,30,27,1,1,1,0
"2011","E00014686","E00014686","Total",118,85,35,50,0,6,3,3,27,27,0,0,0,0
"2011","E00014689","E00014689","Total",141,81,35,46,1,10,8,2,47,45,0,2,0,2
"2011","E00014690","E00014690","Total",134,61,37,24,4,38,8,30,29,26,1,2,0,2
"2011","E00014691","E00014691","Total",139,76,17,59,1,8,5,3,54,49,0,4,1,0
"2011","E00015116","E00015116","Total",132,60,14,46,10,44,37,7,17,15,0,0,2,1
"2011","E00015125","E00015125","Total",112,57,21,36,1,40,38,2,14,12,0,2,0,0
"2011","E00015127","E00015127","Total",115,55,24,31,2,48,46,2,10,10,0,0,0,0
"2011","E00015131","E00015131","Total",111,95,38,57,0,0,0,0,16,14,1,1,0,0
"2011","E00015134","E00015134","Total",117,106,49,57,0,1,1,0,10,10,0,0,0,0
"2011","E00015118","E00015118","Total",132,100,44,56,1,4,3,1,27,23,1,3,0,0
"2011","E00015123","E00015123","Total",134,114,62,52,1,1,0,1,15,15,0,0,0,3
"2011","E00015126","E00015126","Total",128,108,38,70,1,1,0,1,16,14,1,1,0,2
"2011","E00015128","E00015128","Total",111,98,34,64,2,2,2,0,9,8,0,1,0,0
"2011","E00015135","E00015135","Total",122,105,39,66,0,2,0,2,14,13,0,0,1,1
"2011","E00015117","E00015117","Total",143,70,24,46,1,8,8,0,62,59,1,0,2,2
"2011","E00015119","E00015119","Total",140,113,39,74,0,8,3,5,18,18,0,0,0,1
"2011","E00015120","E00015120","Total",131,75,36,39,0,1,1,0,53,52,0,0,1,2
"2011","E00015121","E00015121","Total",160,131,69,62,3,2,0,2,23,13,4,1,5,1
"2011","E00014803","E00014803","Total",131,117,53,64,0,0,0,0,13,12,0,1,0,1
"2011","E00014804","E00014804","Total",120,75,29,46,2,31,27,4,11,9,0,2,0,1
"2011","E00014810","E00014810","Total",123,62,18,44,2,7,7,0,50,48,0,2,0,2
"2011","E00014813","E00014813","Total",119,95,41,54,0,10,9,1,14,12,1,1,0,0
"2011","E00014817","E00014817","Total",112,72,22,50,0,29,26,3,10,9,0,1,0,1
"2011","E00014811","E00014811","Total",125,113,50,63,0,0,0,0,7,7,0,0,0,5
"2011","E00014814","E00014814","Total",121,109,55,54,1,1,0,1,8,6,0,1,1,2
"2011","E00014816","E00014816","Total",140,126,64,62,0,9,7,2,5,5,0,0,0,0
"2011","E00014819","E00014819","Total",118,64,40,24,1,46,42,4,3,3,0,0,0,4
"2011","E00014821","E00014821","Total",124,77,31,46,1,17,13,4,25,21,2,2,0,4
"2011","E00014812","E00014812","Total",119,111,60,51,0,4,3,1,4,4,0,0,0,0
"2011","E00014818","E00014818","Total",134,109,43,66,0,15,13,2,10,7,0,3,0,0
"2011","E00014820","E00014820","Total",139,119,58,61,1,8,8,0,7,7,0,0,0,4
"2011","E00014825","E00014825","Total",130,117,58,59,0,4,4,0,9,7,0,2,0,0
"2011","E00015110","E00015110","Total",114,85,34,51,1,12,11,1,16,16,0,0,0,0
"2011","E00015112","E00015112","Total",112,84,34,50,1,3,2,1,24,23,0,1,0,0
"2011","E00015133","E00015133","Total",123,105,47,58,1,3,1,2,13,12,0,1,0,1
"2011","E00015136","E00015136","Total",109,77,23,54,1,10,5,5,20,19,0,0,1,1
"2011","E00015137","E00015137","Total",133,104,63,41,0,0,0,0,28,26,1,1,0,1
"2011","E00015109","E00015109","Total",123,110,50,60,0,1,1,0,11,9,0,2,0,1
"2011","E00015111","E00015111","Total",123,105,35,70,0,5,5,0,12,10,0,1,1,1
"2011","E00015113","E00015113","Total",109,92,38,54,1,2,0,2,14,11,0,3,0,0
"2011","E00015114","E00015114","Total",109,101,41,60,0,0,0,0,7,7,0,0,0,1
"2011","E00015115","E00015115","Total",106,85,28,57,0,14,11,3,7,6,0,0,1,0
"2011","E00014801","E00014801","Total",131,96,28,68,3,19,2,17,13,13,0,0,0,0
"2011","E00014805","E00014805","Total",120,92,33,59,1,17,12,5,10,7,0,3,0,0
"2011","E00014823","E00014823","Total",125,112,41,71,1,8,5,3,4,3,0,1,0,0
"2011","E00014827","E00014827","Total",132,108,41,67,1,13,7,6,8,7,0,1,0,2
"2011","E00014834","E00014834","Total",123,109,40,69,1,9,6,3,4,4,0,0,0,0
"2011","E00014835","E00014835","Total",119,97,31,66,1,5,3,2,15,14,0,1,0,1
"2011","E00014837","E00014837","Total",131,97,47,50,10,16,16,0,8,5,0,1,2,0
"2011","E00014847","E00014847","Total",140,123,34,89,0,1,0,1,16,15,0,1,0,0
"2011","E00014849","E00014849","Total",142,117,33,84,0,7,3,4,18,17,0,1,0,0
"2011","E00014830","E00014830","Total",117,102,35,67,0,4,3,1,11,9,0,2,0,0
"2011","E00014838","E00014838","Total",116,102,36,66,1,2,2,0,11,9,0,2,0,0
"2011","E00014844","E00014844","Total",112,97,46,51,0,3,1,2,12,12,0,0,0,0
"2011","E00014846","E00014846","Total",124,113,45,68,1,4,2,2,6,6,0,0,0,0
"2011","E00014852","E00014852","Total",134,117,52,65,1,2,1,1,12,12,0,0,0,2
"2011","E00014829","E00014829","Total",122,113,46,67,0,1,1,0,8,7,0,1,0,0
"2011","E00014836","E00014836","Total",111,95,37,58,0,2,1,1,13,11,0,1,1,1
"2011","E00014839","E00014839","Total",117,102,45,57,1,3,0,3,11,8,0,3,0,0
"2011","E00014842","E00014842","Total",122,116,57,59,1,1,1,0,4,4,0,0,0,0
"2011","E00014851","E00014851","Total",125,98,39,59,0,10,9,1,17,15,0,2,0,0
"2011","E00014808","E00014808","Total",126,85,37,48,0,35,33,2,4,3,0,1,0,2
"2011","E00014809","E00014809","Total",113,78,23,55,0,23,20,3,10,8,0,2,0,2
"2011","E00014822","E00014822","Total",119,63,33,30,0,45,41,4,8,7,0,1,0,3
"2011","E00014824","E00014824","Total",116,86,38,48,1,16,14,2,11,11,0,0,0,2
"2011","E00014826","E00014826","Total",130,110,46,64,0,9,8,1,9,7,0,2,0,2
"2011","E00014802","E00014802","Total",138,88,29,59,4,37,37,0,9,7,0,1,1,0
"2011","E00014806","E00014806","Total",116,38,17,21,0,66,61,5,11,11,0,0,0,1
"2011","E00014807","E00014807","Total",130,98,43,55,1,25,17,8,5,4,0,0,1,1
"2011","E00014815","E00014815","Total",123,107,57,50,0,4,2,2,11,9,0,2,0,1
"2011","E00014840","E00014840","Total",138,74,23,51,2,44,12,32,17,13,1,3,0,1
"2011","E00014850","E00014850","Total",164,98,34,64,2,49,4,45,13,13,0,0,0,2
"2011","E00014856","E00014856","Total",116,89,43,46,0,13,6,7,13,7,5,1,0,1
"2011","E00014857","E00014857","Total",204,143,46,97,0,26,4,22,32,29,0,3,0,3
"2011","E00014858","E00014858","Total",162,126,51,75,1,8,6,2,27,23,1,1,2,0
"2011","E00014828","E00014828","Total",133,118,41,77,0,5,3,2,9,7,1,1,0,1
"2011","E00014831","E00014831","Total",147,108,45,63,0,11,4,7,26,23,0,3,0,2
"2011","E00014841","E00014841","Total",121,111,39,72,1,3,1,2,6,5,0,1,0,0
"2011","E00014843","E00014843","Total",119,95,40,55,4,16,10,6,3,2,0,1,0,1
"2011","E00014845","E00014845","Total",157,126,61,65,1,18,7,11,11,10,0,1,0,1
"2011","E00014832","E00014832","Total",131,53,18,35,0,71,67,4,4,3,1,0,0,3
"2011","E00014833","E00014833","Total",130,46,13,33,2,68,67,1,14,11,0,3,0,0
"2011","E00014848","E00014848","Total",113,80,30,50,0,26,25,1,7,6,0,1,0,0
"2011","E00014853","E00014853","Total",99,78,20,58,0,17,16,1,3,3,0,0,0,1
"2011","E00014854","E00014854","Total",121,66,19,47,0,28,27,1,26,25,0,0,1,1
"2011","E00014855","E00014855","Total",125,110,54,56,0,1,1,0,14,12,0,2,0,0
"2011","E00017596","E00017596","Total",105,87,43,44,0,2,1,1,16,16,0,0,0,0
"2011","E00017597","E00017597","Total",121,105,41,64,0,1,1,0,15,15,0,0,0,0
"2011","E00017598","E00017598","Total",140,114,45,69,1,0,0,0,23,23,0,0,0,2
"2011","E00017599","E00017599","Total",115,101,45,56,0,1,0,1,13,13,0,0,0,0
"2011","E00017572","E00017572","Total",152,58,23,35,0,1,0,1,92,90,0,2,0,1
"2011","E00017600","E00017600","Total",107,84,39,45,0,1,0,1,22,22,0,0,0,0
"2011","E00017601","E00017601","Total",130,108,54,54,1,1,1,0,19,18,0,1,0,1
"2011","E00017602","E00017602","Total",116,88,42,46,0,2,0,2,25,24,1,0,0,1
"2011","E00017574","E00017574","Total",115,85,48,37,0,2,0,2,27,26,0,1,0,1
"2011","E00017579","E00017579","Total",130,92,52,40,1,1,1,0,34,33,0,1,0,2
"2011","E00017580","E00017580","Total",115,83,44,39,0,3,1,2,28,27,0,1,0,1
"2011","E00017582","E00017582","Total",120,97,50,47,1,4,2,2,18,16,0,2,0,0
"2011","E00017575","E00017575","Total",125,80,38,42,0,2,1,1,40,37,1,1,1,3
"2011","E00017578","E00017578","Total",114,87,30,57,0,3,1,2,24,24,0,0,0,0
"2011","E00017581","E00017581","Total",125,70,31,39,1,29,12,17,25,24,0,1,0,0
"2011","E00017583","E00017583","Total",121,62,31,31,0,19,9,10,40,37,0,3,0,0
"2011","E00166828","E00166828","Total",237,24,6,18,51,41,10,31,119,116,0,3,0,2
"2011","E00166829","E00166829","Total",111,16,9,7,3,80,12,68,11,9,0,2,0,1
"2011","E00166830","E00166830","Total",82,62,25,37,1,2,0,2,17,16,0,1,0,0
"2011","E00166831","E00166831","Total",111,30,7,23,2,4,1,3,73,71,0,2,0,2
"2011","E00166832","E00166832","Total",136,22,0,22,40,15,1,14,59,56,0,2,1,0
"2011","E00017591","E00017591","Total",115,83,30,53,1,1,0,1,30,29,0,1,0,0
"2011","E00017592","E00017592","Total",116,97,34,63,0,2,1,1,16,16,0,0,0,1
"2011","E00017593","E00017593","Total",125,56,20,36,0,5,1,4,60,57,0,3,0,4
"2011","E00017594","E00017594","Total",127,102,37,65,0,2,1,1,23,23,0,0,0,0
"2011","E00017595","E00017595","Total",119,101,44,57,0,1,0,1,16,16,0,0,0,1
"2011","E00017516","E00017516","Total",111,71,50,21,0,2,0,2,38,35,0,3,0,0
"2011","E00017518","E00017518","Total",104,43,18,25,0,30,14,16,28,25,1,2,0,3
"2011","E00017519","E00017519","Total",98,55,31,24,0,20,0,20,20,17,2,1,0,3
"2011","E00017536","E00017536","Total",108,77,53,24,0,5,1,4,24,21,0,2,1,2
"2011","E00017537","E00017537","Total",151,87,50,37,0,27,3,24,27,24,1,1,1,10
"2011","E00017540","E00017540","Total",107,75,51,24,0,6,3,3,22,19,0,3,0,4
"2011","E00017512","E00017512","Total",113,56,28,28,0,17,4,13,33,31,2,0,0,7
"2011","E00017513","E00017513","Total",119,63,35,28,0,30,0,30,23,22,1,0,0,3
"2011","E00017515","E00017515","Total",122,113,70,43,0,2,0,2,5,4,0,1,0,2
"2011","E00017517","E00017517","Total",118,97,59,38,0,8,3,5,12,12,0,0,0,1
"2011","E00017522","E00017522","Total",127,101,66,35,1,2,1,1,23,21,0,2,0,0
"2011","E00017525","E00017525","Total",124,106,74,32,0,2,1,1,14,13,0,1,0,2
"2011","E00017526","E00017526","Total",120,75,42,33,0,20,5,15,23,20,1,2,0,2
"2011","E00017527","E00017527","Total",96,75,54,21,0,0,0,0,15,15,0,0,0,6
"2011","E00017529","E00017529","Total",102,80,55,25,1,1,1,0,19,19,0,0,0,1
"2011","E00017530","E00017530","Total",108,69,54,15,0,4,1,3,31,31,0,0,0,4
"2011","E00017528","E00017528","Total",114,92,60,32,0,1,0,1,17,16,0,0,1,4
"2011","E00017531","E00017531","Total",121,106,83,23,0,1,0,1,11,11,0,0,0,3
"2011","E00017532","E00017532","Total",118,85,53,32,1,3,0,3,26,25,0,1,0,3
"2011","E00017533","E00017533","Total",119,99,61,38,0,1,0,1,19,19,0,0,0,0
"2011","E00017196","E00017196","Total",83,52,29,23,0,5,2,3,26,26,0,0,0,0
"2011","E00017214","E00017214","Total",124,41,13,28,2,14,2,12,66,65,0,0,1,1
"2011","E00017215","E00017215","Total",114,59,21,38,0,2,1,1,52,51,0,1,0,1
"2011","E00017216","E00017216","Total",108,49,14,35,0,8,0,8,50,49,0,1,0,1
"2011","E00017219","E00017219","Total",106,48,26,22,0,9,2,7,47,47,0,0,0,2
"2011","E00017220","E00017220","Total",124,60,27,33,0,2,0,2,62,59,0,2,1,0
"2011","E00017483","E00017483","Total",143,45,14,31,15,34,0,34,46,43,0,3,0,3
"2011","E00017498","E00017498","Total",134,85,41,44,0,4,0,4,45,44,0,1,0,0
"2011","E00017500","E00017500","Total",95,68,23,45,0,1,1,0,26,24,0,2,0,0
"2011","E00017501","E00017501","Total",104,74,50,24,0,7,1,6,19,16,0,3,0,4
"2011","E00017504","E00017504","Total",111,66,23,43,1,5,0,5,39,38,0,1,0,0
"2011","E00017479","E00017479","Total",107,83,43,40,0,4,1,3,19,19,0,0,0,1
"2011","E00017480","E00017480","Total",119,61,27,34,1,8,3,5,49,47,0,1,1,0
"2011","E00017489","E00017489","Total",143,48,25,23,0,3,0,3,90,87,0,0,3,2
"2011","E00017493","E00017493","Total",102,45,17,28,0,1,0,1,55,54,0,1,0,1
"2011","E00017495","E00017495","Total",196,66,30,36,13,24,4,20,90,87,0,2,1,3
"2011","E00017576","E00017576","Total",123,101,52,49,1,5,2,3,15,15,0,0,0,1
"2011","E00017584","E00017584","Total",120,27,10,17,1,66,18,48,25,19,0,5,1,1
"2011","E00017585","E00017585","Total",123,70,31,39,0,2,2,0,50,50,0,0,0,1
"2011","E00017588","E00017588","Total",116,46,10,36,1,31,16,15,38,33,2,3,0,0
"2011","E00017573","E00017573","Total",94,59,24,35,0,3,1,2,30,30,0,0,0,2
"2011","E00017586","E00017586","Total",133,92,38,54,0,1,1,0,38,36,0,2,0,2
"2011","E00017587","E00017587","Total",132,73,27,46,0,14,2,12,45,45,0,0,0,0
"2011","E00017589","E00017589","Total",118,82,30,52,0,4,2,2,30,30,0,0,0,2
"2011","E00017590","E00017590","Total",96,57,21,36,0,5,1,4,34,32,0,2,0,0
"2011","E00017213","E00017213","Total",108,43,24,19,0,23,4,19,40,40,0,0,0,2
"2011","E00017217","E00017217","Total",91,11,5,6,0,61,1,60,16,11,0,0,5,3
"2011","E00017218","E00017218","Total",103,64,35,29,0,3,0,3,34,33,0,1,0,2
"2011","E00017221","E00017221","Total",99,55,27,28,0,3,1,2,41,38,0,3,0,0
"2011","E00017224","E00017224","Total",107,69,37,32,0,1,0,1,36,34,0,2,0,1
"2011","E00017225","E00017225","Total",139,46,15,31,0,0,0,0,87,81,2,4,0,6
"2011","E00017197","E00017197","Total",106,64,40,24,0,24,2,22,18,16,0,2,0,0
"2011","E00017222","E00017222","Total",119,69,44,25,0,0,0,0,46,44,1,1,0,4
"2011","E00017223","E00017223","Total",132,80,59,21,0,1,1,0,46,43,0,2,1,5
"2011","E00017226","E00017226","Total",131,47,26,21,1,3,0,3,80,73,0,5,2,0
"2011","E00017227","E00017227","Total",101,61,42,19,0,6,0,6,34,31,1,1,1,0
"2011","E00017231","E00017231","Total",116,52,28,24,0,1,0,1,62,60,0,2,0,1
"2011","E00017198","E00017198","Total",108,63,34,29,0,11,0,11,34,32,0,2,0,0
"2011","E00017202","E00017202","Total",134,95,58,37,1,0,0,0,36,34,0,2,0,2
"2011","E00017203","E00017203","Total",138,69,31,38,0,3,0,3,64,64,0,0,0,2
"2011","E00017228","E00017228","Total",112,80,59,21,0,2,0,2,30,30,0,0,0,0
"2011","E00017229","E00017229","Total",106,65,40,25,0,1,0,1,36,33,0,3,0,4
"2011","E00017230","E00017230","Total",112,36,25,11,0,28,0,28,48,45,0,1,2,0
"2011","E00017199","E00017199","Total",143,70,37,33,0,24,0,24,44,41,0,2,1,5
"2011","E00017200","E00017200","Total",138,86,47,39,0,5,2,3,47,45,0,2,0,0
"2011","E00017201","E00017201","Total",121,44,22,22,1,42,1,41,33,33,0,0,0,1
"2011","E00017204","E00017204","Total",124,57,27,30,0,4,0,4,61,57,0,3,1,2
"2011","E00017205","E00017205","Total",114,55,24,31,0,9,3,6,49,45,0,4,0,1
"2011","E00017206","E00017206","Total",118,58,24,34,0,1,1,0,56,56,0,0,0,3
"2011","E00017207","E00017207","Total",154,48,23,25,6,57,4,53,39,36,0,1,2,4
"2011","E00017514","E00017514","Total",109,61,31,30,0,0,0,0,42,42,0,0,0,6
"2011","E00017534","E00017534","Total",121,81,48,33,0,2,0,2,34,34,0,0,0,4
"2011","E00017535","E00017535","Total",122,94,67,27,0,2,0,2,26,26,0,0,0,0
"2011","E00017538","E00017538","Total",133,57,35,22,0,0,0,0,76,73,1,0,2,0
"2011","E00017539","E00017539","Total",103,30,18,12,0,4,0,4,63,61,1,1,0,6
"2011","E00017541","E00017541","Total",124,61,39,22,0,1,1,0,58,56,0,2,0,4
"2011","E00017041","E00017041","Total",114,67,17,50,0,2,1,1,42,40,0,2,0,3
"2011","E00017043","E00017043","Total",113,82,36,46,0,8,0,8,23,19,0,3,1,0
"2011","E00017057","E00017057","Total",93,37,11,26,7,30,12,18,19,19,0,0,0,0
"2011","E00017060","E00017060","Total",123,56,21,35,2,14,9,5,51,48,1,2,0,0
"2011","E00017062","E00017062","Total",121,57,21,36,1,9,0,9,51,50,0,1,0,3
"2011","E00166835","E00166835","Total",89,38,7,31,0,5,1,4,46,45,0,1,0,0
"2011","E00166836","E00166836","Total",119,50,8,42,0,1,1,0,67,65,0,2,0,1
"2011","E00166837","E00166837","Total",144,62,12,50,0,2,0,2,79,70,0,9,0,1
"2011","E00166838","E00166838","Total",45,23,8,15,0,1,0,1,20,18,0,2,0,1
"2011","E00017036","E00017036","Total",142,57,17,40,1,6,1,5,78,72,0,4,2,0
"2011","E00017045","E00017045","Total",147,78,19,59,1,12,2,10,56,55,0,1,0,0
"2011","E00017046","E00017046","Total",126,61,16,45,0,14,3,11,48,47,0,0,1,3
"2011","E00017049","E00017049","Total",112,61,23,38,1,10,1,9,39,37,0,0,2,1
"2011","E00017050","E00017050","Total",109,64,24,40,1,2,0,2,42,41,0,1,0,0
"2011","E00017052","E00017052","Total",132,66,23,43,0,13,0,13,52,47,0,5,0,1
"2011","E00017047","E00017047","Total",176,58,16,42,2,46,15,31,67,64,0,3,0,3
"2011","E00017048","E00017048","Total",175,83,22,61,1,18,4,14,72,69,1,1,1,1
"2011","E00017051","E00017051","Total",233,50,12,38,19,14,2,12,146,142,1,3,0,4
"2011","E00017055","E00017055","Total",136,70,21,49,0,4,2,2,60,57,1,2,0,2
"2011","E00017056","E00017056","Total",149,85,31,54,0,2,0,2,62,59,1,2,0,0
"2011","E00017037","E00017037","Total",158,101,42,59,0,4,0,4,51,48,1,1,1,2
"2011","E00017040","E00017040","Total",123,79,36,43,0,4,0,4,40,40,0,0,0,0
"2011","E00017053","E00017053","Total",109,66,24,42,0,12,0,12,31,31,0,0,0,0
"2011","E00017054","E00017054","Total",117,80,41,39,0,0,0,0,36,35,0,1,0,1
"2011","E00017061","E00017061","Total",119,53,24,29,3,19,8,11,42,40,2,0,0,2
"2011","E00017478","E00017478","Total",142,61,22,39,0,52,4,48,28,28,0,0,0,1
"2011","E00017482","E00017482","Total",141,69,15,54,2,8,0,8,61,59,0,0,2,1
"2011","E00017499","E00017499","Total",100,65,11,54,3,0,0,0,30,29,0,1,0,2
"2011","E00017502","E00017502","Total",117,51,8,43,0,13,0,13,52,50,0,2,0,1
"2011","E00017508","E00017508","Total",133,52,9,43,0,7,0,7,73,69,0,3,1,1
"2011","E00017510","E00017510","Total",116,79,25,54,0,2,0,2,34,33,0,1,0,1
"2011","E00016973","E00016973","Total",113,60,21,39,0,31,8,23,22,22,0,0,0,0
"2011","E00016974","E00016974","Total",147,92,35,57,0,15,5,10,40,39,0,1,0,0
"2011","E00016983","E00016983","Total",134,59,32,27,0,40,7,33,35,33,0,2,0,0
"2011","E00016984","E00016984","Total",157,36,8,28,0,31,0,31,89,84,3,2,0,1
"2011","E00016990","E00016990","Total",124,52,16,36,1,32,4,28,36,34,0,0,2,3
"2011","E00017007","E00017007","Total",141,60,23,37,2,32,10,22,44,42,0,2,0,3
"2011","E00016977","E00016977","Total",122,67,26,41,0,1,0,1,52,49,0,2,1,2
"2011","E00016978","E00016978","Total",123,83,36,47,1,5,0,5,33,33,0,0,0,1
"2011","E00016986","E00016986","Total",122,67,26,41,0,0,0,0,55,54,0,1,0,0
"2011","E00016987","E00016987","Total",116,76,17,59,1,2,0,2,34,32,0,2,0,3
"2011","E00017004","E00017004","Total",133,74,24,50,0,11,4,7,43,42,0,0,1,5
"2011","E00017006","E00017006","Total",124,90,33,57,0,4,2,2,30,28,0,1,1,0
"2011","E00017487","E00017487","Total",94,66,27,39,0,1,0,1,27,27,0,0,0,0
"2011","E00017490","E00017490","Total",111,78,37,41,0,2,0,2,29,29,0,0,0,2
"2011","E00017505","E00017505","Total",102,77,31,46,0,6,3,3,19,19,0,0,0,0
"2011","E00017506","E00017506","Total",104,76,32,44,0,2,0,2,26,25,0,1,0,0
"2011","E00017509","E00017509","Total",106,62,24,38,0,21,2,19,22,22,0,0,0,1
"2011","E00017511","E00017511","Total",106,78,37,41,0,4,0,4,23,22,0,1,0,1
"2011","E00017481","E00017481","Total",107,57,17,40,0,6,0,6,44,43,0,0,1,0
"2011","E00017485","E00017485","Total",106,75,31,44,0,5,1,4,26,24,0,2,0,0
"2011","E00017486","E00017486","Total",105,84,30,54,1,1,0,1,18,18,0,0,0,1
"2011","E00017492","E00017492","Total",122,90,40,50,1,1,0,1,29,29,0,0,0,1
"2011","E00017503","E00017503","Total",120,57,18,39,0,5,1,4,56,54,0,2,0,2
"2011","E00017507","E00017507","Total",133,74,19,55,0,5,0,5,53,51,0,1,1,1
"2011","E00017484","E00017484","Total",120,65,17,48,1,10,3,7,44,42,0,2,0,0
"2011","E00017488","E00017488","Total",130,37,12,25,0,63,23,40,29,27,0,2,0,1
"2011","E00017491","E00017491","Total",101,23,9,14,0,63,22,41,14,12,0,2,0,1
"2011","E00017494","E00017494","Total",140,57,20,37,0,8,0,8,75,74,0,0,1,0
"2011","E00017497","E00017497","Total",118,48,17,31,1,2,2,0,67,66,0,1,0,0
"2011","E00166833","E00166833","Total",113,49,16,33,0,50,8,42,14,11,1,1,1,0
"2011","E00166834","E00166834","Total",118,31,10,21,1,63,6,57,22,22,0,0,0,1
"2011","E00166839","E00166839","Total",116,58,11,47,3,17,2,15,38,38,0,0,0,0
"2011","E00017170","E00017170","Total",123,71,26,45,2,0,0,0,50,49,0,1,0,0
"2011","E00017173","E00017173","Total",127,90,40,50,0,4,1,3,31,29,0,1,1,2
"2011","E00017176","E00017176","Total",142,80,46,34,2,4,0,4,54,50,2,2,0,2
"2011","E00017178","E00017178","Total",130,85,43,42,0,5,0,5,38,38,0,0,0,2
"2011","E00017182","E00017182","Total",114,71,37,34,0,1,0,1,39,35,0,4,0,3
"2011","E00017171","E00017171","Total",144,113,46,67,0,1,1,0,29,28,0,1,0,1
"2011","E00017180","E00017180","Total",100,76,40,36,0,3,0,3,19,19,0,0,0,2
"2011","E00017181","E00017181","Total",112,95,44,51,0,2,1,1,14,9,0,5,0,1
"2011","E00017183","E00017183","Total",147,112,61,51,3,0,0,0,32,30,0,1,1,0
"2011","E00017184","E00017184","Total",128,78,30,48,1,5,2,3,41,39,0,1,1,3
"2011","E00017185","E00017185","Total",133,91,44,47,0,0,0,0,41,37,0,2,2,1
"2011","E00017186","E00017186","Total",126,87,45,42,0,5,0,5,31,30,0,1,0,3
"2011","E00017193","E00017193","Total",147,83,38,45,0,5,1,4,57,56,0,0,1,2
"2011","E00017169","E00017169","Total",111,72,39,33,0,7,0,7,31,27,0,3,1,1
"2011","E00017175","E00017175","Total",121,70,22,48,0,4,1,3,45,43,0,0,2,2
"2011","E00017187","E00017187","Total",98,71,46,25,1,0,0,0,25,23,0,2,0,1
"2011","E00017188","E00017188","Total",107,63,30,33,0,15,0,15,29,26,0,2,1,0
"2011","E00017191","E00017191","Total",120,81,38,43,1,1,0,1,36,35,0,1,0,1
"2011","E00017168","E00017168","Total",115,75,36,39,0,18,2,16,22,21,0,1,0,0
"2011","E00017174","E00017174","Total",115,88,36,52,0,6,2,4,21,17,0,2,2,0
"2011","E00017177","E00017177","Total",113,71,33,38,0,2,0,2,38,34,1,2,1,2
"2011","E00017179","E00017179","Total",109,67,29,38,0,0,0,0,42,37,0,2,3,0
"2011","E00017189","E00017189","Total",131,90,46,44,1,6,2,4,34,31,1,2,0,0
"2011","E00017044","E00017044","Total",106,70,38,32,0,20,5,15,16,15,0,1,0,0
"2011","E00017064","E00017064","Total",126,72,32,40,1,19,13,6,33,32,1,0,0,1
"2011","E00017065","E00017065","Total",107,70,31,39,0,2,2,0,35,35,0,0,0,0
"2011","E00017066","E00017066","Total",117,74,24,50,0,19,8,11,24,24,0,0,0,0
"2011","E00017067","E00017067","Total",122,77,32,45,1,1,0,1,43,43,0,0,0,0
"2011","E00017038","E00017038","Total",124,55,15,40,0,36,13,23,31,28,0,3,0,2
"2011","E00017039","E00017039","Total",121,52,16,36,0,26,10,16,42,39,0,3,0,1
"2011","E00017058","E00017058","Total",126,40,14,26,6,56,23,33,23,23,0,0,0,1
"2011","E00017059","E00017059","Total",143,23,6,17,2,74,15,59,42,41,0,1,0,2
"2011","E00017063","E00017063","Total",113,42,14,28,0,51,18,33,20,19,0,1,0,0
"2011","E00017172","E00017172","Total",144,70,24,46,1,3,0,3,70,67,0,3,0,0
"2011","E00017190","E00017190","Total",109,36,11,25,0,2,1,1,70,66,0,3,1,1
"2011","E00017192","E00017192","Total",128,34,11,23,1,20,2,18,71,69,0,2,0,2
"2011","E00017194","E00017194","Total",141,69,10,59,1,15,7,8,56,52,0,4,0,0
"2011","E00017195","E00017195","Total",124,51,12,39,2,2,0,2,68,65,0,2,1,1
"2011","E00017237","E00017237","Total",134,75,14,61,0,22,0,22,35,32,1,2,0,2
"2011","E00017242","E00017242","Total",81,44,11,33,1,17,1,16,18,18,0,0,0,1
"2011","E00017243","E00017243","Total",128,66,16,50,0,42,16,26,17,17,0,0,0,3
"2011","E00017244","E00017244","Total",112,5,2,3,0,100,3,97,6,6,0,0,0,1
"2011","E00017246","E00017246","Total",111,60,16,44,1,16,8,8,31,30,0,1,0,3
"2011","E00017232","E00017232","Total",131,65,13,52,2,23,1,22,41,38,0,3,0,0
"2011","E00017234","E00017234","Total",130,72,21,51,1,16,2,14,41,40,0,1,0,0
"2011","E00017245","E00017245","Total",120,40,6,34,0,1,0,1,77,76,0,1,0,2
"2011","E00017247","E00017247","Total",109,36,6,30,0,2,0,2,70,69,0,1,0,1
"2011","E00017252","E00017252","Total",147,64,15,49,1,3,1,2,76,73,0,3,0,3
"2011","E00017261","E00017261","Total",131,65,19,46,1,6,2,4,59,56,0,3,0,0
"2011","E00016972","E00016972","Total",109,32,14,18,2,2,0,2,72,70,0,2,0,1
"2011","E00016979","E00016979","Total",122,57,27,30,0,9,2,7,55,54,0,1,0,1
"2011","E00016981","E00016981","Total",140,76,27,49,0,2,0,2,62,61,0,1,0,0
"2011","E00016988","E00016988","Total",143,55,17,38,0,7,1,6,79,77,0,2,0,2
"2011","E00016991","E00016991","Total",119,64,21,43,1,2,0,2,52,49,0,3,0,0
"2011","E00016995","E00016995","Total",132,69,31,38,0,1,0,1,62,59,1,2,0,0
"2011","E00016989","E00016989","Total",91,57,26,31,0,9,3,6,25,24,0,1,0,0
"2011","E00016994","E00016994","Total",114,79,31,48,1,2,0,2,28,26,1,1,0,4
"2011","E00016999","E00016999","Total",130,67,30,37,0,23,6,17,40,38,1,1,0,0
"2011","E00017000","E00017000","Total",106,75,44,31,1,1,0,1,29,27,0,2,0,0
"2011","E00017001","E00017001","Total",132,103,40,63,0,2,1,1,26,22,0,4,0,1
"2011","E00017002","E00017002","Total",123,59,28,31,1,8,3,5,55,47,1,7,0,0
"2011","E00016975","E00016975","Total",106,55,21,34,0,7,1,6,44,43,0,0,1,0
"2011","E00016976","E00016976","Total",139,78,37,41,0,3,1,2,55,54,0,1,0,3
"2011","E00016980","E00016980","Total",110,76,31,45,0,0,0,0,34,34,0,0,0,0
"2011","E00016982","E00016982","Total",113,32,11,21,0,1,1,0,79,75,0,3,1,1
"2011","E00017003","E00017003","Total",167,77,24,53,0,12,0,12,77,70,0,7,0,1
"2011","E00017005","E00017005","Total",166,75,50,25,0,6,2,4,84,80,1,3,0,1
"2011","E00017117","E00017117","Total",118,62,20,42,0,0,0,0,56,56,0,0,0,0
"2011","E00017118","E00017118","Total",80,49,21,28,2,2,1,1,26,25,0,1,0,1
"2011","E00017119","E00017119","Total",123,62,20,42,0,1,0,1,57,55,1,1,0,3
"2011","E00017120","E00017120","Total",129,80,32,48,0,8,4,4,41,38,1,2,0,0
"2011","E00017121","E00017121","Total",130,58,28,30,1,5,0,5,64,63,0,1,0,2
"2011","E00017122","E00017122","Total",112,49,16,33,1,0,0,0,57,56,0,1,0,5
"2011","E00017102","E00017102","Total",132,67,25,42,2,7,0,7,52,50,1,1,0,4
"2011","E00017103","E00017103","Total",130,112,61,51,0,1,0,1,17,17,0,0,0,0
"2011","E00017124","E00017124","Total",144,79,37,42,0,3,0,3,61,59,1,1,0,1
"2011","E00017125","E00017125","Total",111,47,20,27,1,4,0,4,57,57,0,0,0,2
"2011","E00017127","E00017127","Total",106,37,15,22,0,21,1,20,48,45,2,1,0,0
"2011","E00017414","E00017414","Total",128,98,57,41,0,4,2,2,24,21,3,0,0,2
"2011","E00017418","E00017418","Total",131,94,36,58,0,7,4,3,27,27,0,0,0,3
"2011","E00017444","E00017444","Total",192,106,60,46,2,15,0,15,65,63,0,2,0,4
"2011","E00017445","E00017445","Total",117,56,23,33,0,18,1,17,38,35,1,2,0,5
"2011","E00017446","E00017446","Total",133,107,59,48,0,0,0,0,25,25,0,0,0,1
"2011","E00017417","E00017417","Total",121,108,65,43,0,3,1,2,8,8,0,0,0,2
"2011","E00017420","E00017420","Total",120,87,51,36,0,6,0,6,27,24,1,2,0,0
"2011","E00017424","E00017424","Total",113,78,38,40,1,7,3,4,25,24,1,0,0,2
"2011","E00017427","E00017427","Total",139,122,56,66,0,0,0,0,16,15,0,1,0,1
"2011","E00017430","E00017430","Total",140,98,45,53,0,1,0,1,41,37,1,3,0,0
"2011","E00017416","E00017416","Total",118,84,44,40,0,6,3,3,27,26,0,1,0,1
"2011","E00017419","E00017419","Total",102,63,27,36,0,20,1,19,19,15,0,4,0,0
"2011","E00017422","E00017422","Total",110,80,54,26,1,7,3,4,20,17,0,3,0,2
"2011","E00017426","E00017426","Total",112,81,40,41,0,2,0,2,29,28,0,1,0,0
"2011","E00017429","E00017429","Total",115,50,21,29,1,1,1,0,61,59,0,2,0,2
"2011","E00017434","E00017434","Total",138,104,50,54,0,1,0,1,33,31,0,1,1,0
"2011","E00017415","E00017415","Total",107,63,26,37,1,28,13,15,15,15,0,0,0,0
"2011","E00017423","E00017423","Total",115,79,32,47,0,27,8,19,8,7,0,1,0,1
"2011","E00017425","E00017425","Total",92,77,32,45,0,0,0,0,14,13,1,0,0,1
"2011","E00017431","E00017431","Total",111,89,49,40,0,1,1,0,20,19,0,1,0,1
"2011","E00017433","E00017433","Total",109,93,44,49,1,2,1,1,11,11,0,0,0,2
"2011","E00017438","E00017438","Total",124,102,55,47,0,2,1,1,20,19,1,0,0,0
"2011","E00017520","E00017520","Total",96,74,52,22,0,2,0,2,19,18,0,0,1,1
"2011","E00017521","E00017521","Total",114,103,63,40,0,0,0,0,10,10,0,0,0,1
"2011","E00017523","E00017523","Total",125,92,52,40,1,0,0,0,30,30,0,0,0,2
"2011","E00017524","E00017524","Total",124,106,52,54,0,2,0,2,12,11,0,0,1,4
"2011","E00017109","E00017109","Total",112,57,14,43,1,2,0,2,52,51,0,1,0,0
"2011","E00017111","E00017111","Total",130,87,34,53,1,2,0,2,39,38,1,0,0,1
"2011","E00017116","E00017116","Total",110,79,26,53,1,2,2,0,28,26,0,2,0,0
"2011","E00017130","E00017130","Total",112,85,40,45,0,4,1,3,21,19,0,2,0,2
"2011","E00017132","E00017132","Total",119,88,46,42,1,11,4,7,19,18,0,1,0,0
"2011","E00017134","E00017134","Total",97,76,40,36,1,4,2,2,15,14,0,1,0,1
"2011","E00017104","E00017104","Total",108,74,31,43,0,4,0,4,29,26,1,2,0,1
"2011","E00017105","E00017105","Total",100,58,24,34,0,9,3,6,33,30,0,3,0,0
"2011","E00017108","E00017108","Total",140,92,37,55,1,0,0,0,46,45,0,1,0,1
"2011","E00017112","E00017112","Total",112,60,23,37,0,4,0,4,45,45,0,0,0,3
"2011","E00017133","E00017133","Total",119,91,37,54,0,3,3,0,25,25,0,0,0,0
"2011","E00017135","E00017135","Total",97,62,22,40,0,6,4,2,29,27,0,2,0,0
"2011","E00017123","E00017123","Total",132,81,31,50,0,11,2,9,40,39,0,1,0,0
"2011","E00017126","E00017126","Total",120,75,30,45,0,5,1,4,37,37,0,0,0,3
"2011","E00017128","E00017128","Total",127,99,50,49,0,4,1,3,24,24,0,0,0,0
"2011","E00017129","E00017129","Total",124,76,31,45,0,0,0,0,46,44,0,2,0,2
"2011","E00017131","E00017131","Total",123,90,41,49,1,7,3,4,23,22,0,1,0,2
"2011","E00017208","E00017208","Total",118,43,20,23,0,31,0,31,44,44,0,0,0,0
"2011","E00017209","E00017209","Total",112,83,48,35,0,3,3,0,24,24,0,0,0,2
"2011","E00017210","E00017210","Total",116,74,43,31,0,4,1,3,37,34,1,2,0,1
"2011","E00017211","E00017211","Total",126,75,29,46,0,7,0,7,43,41,0,2,0,1
"2011","E00017212","E00017212","Total",146,59,17,42,1,22,0,22,63,63,0,0,0,1
"2011","E00017345","E00017345","Total",139,96,34,62,0,2,1,1,39,38,0,1,0,2
"2011","E00017346","E00017346","Total",122,102,35,67,0,1,0,1,18,17,0,0,1,1
"2011","E00017348","E00017348","Total",106,81,35,46,0,3,1,2,20,19,0,1,0,2
"2011","E00017349","E00017349","Total",118,46,13,33,0,0,0,0,70,65,1,2,2,2
"2011","E00017350","E00017350","Total",120,75,27,48,0,8,2,6,37,33,0,1,3,0
"2011","E00016985","E00016985","Total",118,23,9,14,1,59,30,29,33,31,0,1,1,2
"2011","E00016992","E00016992","Total",121,22,10,12,0,66,27,39,31,31,0,0,0,2
"2011","E00016993","E00016993","Total",128,41,10,31,4,50,19,31,32,29,0,3,0,1
"2011","E00016996","E00016996","Total",123,21,6,15,1,84,34,50,17,14,0,2,1,0
"2011","E00016997","E00016997","Total",121,75,28,47,1,6,2,4,37,36,0,1,0,2
"2011","E00016998","E00016998","Total",139,32,11,21,15,79,32,47,12,12,0,0,0,1
"2011","E00017069","E00017069","Total",130,43,18,25,1,69,4,65,13,13,0,0,0,4
"2011","E00017074","E00017074","Total",141,46,11,35,2,63,1,62,29,27,0,0,2,1
"2011","E00017076","E00017076","Total",107,61,27,34,0,15,6,9,30,27,0,1,2,1
"2011","E00017077","E00017077","Total",102,21,11,10,0,71,7,64,8,6,1,0,1,2
"2011","E00017080","E00017080","Total",108,59,24,35,0,36,15,21,12,12,0,0,0,1
"2011","E00017078","E00017078","Total",96,37,9,28,0,43,1,42,16,16,0,0,0,0
"2011","E00017079","E00017079","Total",115,17,4,13,0,92,19,73,6,6,0,0,0,0
"2011","E00017083","E00017083","Total",105,31,14,17,0,45,27,18,29,28,0,1,0,0
"2011","E00017086","E00017086","Total",100,26,8,18,0,55,29,26,16,15,0,1,0,3
"2011","E00017093","E00017093","Total",110,30,6,24,2,59,21,38,18,18,0,0,0,1
"2011","E00017233","E00017233","Total",174,96,29,67,5,19,2,17,54,52,0,2,0,0
"2011","E00017238","E00017238","Total",151,88,34,54,1,6,2,4,55,52,0,2,1,1
"2011","E00017239","E00017239","Total",157,82,33,49,2,11,2,9,60,59,0,1,0,2
"2011","E00017248","E00017248","Total",135,63,13,50,1,8,1,7,62,60,0,2,0,1
"2011","E00017251","E00017251","Total",113,61,21,40,0,3,1,2,48,46,0,2,0,1
"2011","E00017258","E00017258","Total",143,56,16,40,0,56,24,32,31,28,0,2,1,0
"2011","E00017236","E00017236","Total",158,75,28,47,2,10,2,8,69,64,0,3,2,2
"2011","E00017256","E00017256","Total",123,36,11,25,1,63,8,55,23,23,0,0,0,0
"2011","E00017259","E00017259","Total",104,34,9,25,0,54,7,47,16,15,0,1,0,0
"2011","E00017262","E00017262","Total",119,43,8,35,0,10,0,10,65,63,0,2,0,1
"2011","E00017264","E00017264","Total",126,92,29,63,1,3,0,3,29,22,0,5,2,1
"2011","E00017145","E00017145","Total",112,68,27,41,0,3,2,1,39,37,0,1,1,2
"2011","E00017146","E00017146","Total",127,94,31,63,0,5,2,3,28,27,0,1,0,0
"2011","E00017150","E00017150","Total",120,89,38,51,0,2,0,2,27,25,0,2,0,2
"2011","E00166840","E00166840","Total",61,11,5,6,16,23,2,21,11,11,0,0,0,0
"2011","E00166841","E00166841","Total",114,61,28,33,2,5,1,4,43,41,0,2,0,3
"2011","E00166842","E00166842","Total",97,9,3,6,5,30,1,29,53,53,0,0,0,0
"2011","E00166843","E00166843","Total",91,17,8,9,0,17,0,17,55,53,0,1,1,2
"2011","E00017147","E00017147","Total",126,62,33,29,3,16,0,16,42,41,0,1,0,3
"2011","E00017148","E00017148","Total",122,42,11,31,3,54,1,53,21,16,1,1,3,2
"2011","E00017152","E00017152","Total",110,85,37,48,1,4,1,3,20,16,1,2,1,0
"2011","E00017157","E00017157","Total",105,47,16,31,1,42,20,22,15,12,0,2,1,0
"2011","E00017164","E00017164","Total",127,73,31,42,1,37,3,34,14,14,0,0,0,2
"2011","E00017141","E00017141","Total",114,84,38,46,0,1,0,1,28,27,0,1,0,1
"2011","E00017162","E00017162","Total",128,83,27,56,1,4,2,2,39,38,0,1,0,1
"2011","E00017163","E00017163","Total",124,74,23,51,2,10,4,6,37,37,0,0,0,1
"2011","E00017166","E00017166","Total",138,26,11,15,1,38,8,30,72,68,1,2,1,1
"2011","E00017167","E00017167","Total",127,90,40,50,0,8,0,8,26,21,1,2,2,3
"2011","E00017140","E00017140","Total",139,85,29,56,8,16,2,14,30,29,0,1,0,0
"2011","E00017142","E00017142","Total",121,85,45,40,1,2,0,2,33,31,0,2,0,0
"2011","E00017143","E00017143","Total",101,66,23,43,0,5,0,5,26,23,0,3,0,4
"2011","E00017144","E00017144","Total",140,82,14,68,4,11,1,10,41,38,0,3,0,2
"2011","E00017241","E00017241","Total",110,44,15,29,0,51,23,28,15,13,0,1,1,0
"2011","E00017249","E00017249","Total",104,61,25,36,0,30,14,16,13,10,0,2,1,0
"2011","E00017250","E00017250","Total",107,59,17,42,0,29,14,15,18,17,0,1,0,1
"2011","E00017253","E00017253","Total",124,56,22,34,14,18,6,12,32,31,0,1,0,4
"2011","E00017254","E00017254","Total",117,65,29,36,1,23,2,21,27,25,0,2,0,1
"2011","E00017137","E00017137","Total",131,88,22,66,2,9,2,7,31,30,0,1,0,1
"2011","E00017139","E00017139","Total",132,58,27,31,6,51,7,44,17,16,0,1,0,0
"2011","E00017153","E00017153","Total",118,25,4,21,2,76,45,31,15,14,0,1,0,0
"2011","E00017161","E00017161","Total",103,42,19,23,0,41,22,19,20,20,0,0,0,0
"2011","E00017165","E00017165","Total",130,93,44,49,0,19,6,13,15,15,0,0,0,3
"2011","E00017138","E00017138","Total",155,58,15,43,1,73,31,42,22,22,0,0,0,1
"2011","E00017151","E00017151","Total",105,36,11,25,1,52,17,35,15,14,0,1,0,1
"2011","E00017159","E00017159","Total",136,77,38,39,0,43,12,31,13,11,0,1,1,3
"2011","E00017160","E00017160","Total",148,39,17,22,0,92,46,46,16,16,0,0,0,1
"2011","E00017273","E00017273","Total",130,76,25,51,4,11,4,7,38,38,0,0,0,1
"2011","E00017274","E00017274","Total",130,81,36,45,0,12,5,7,35,32,0,3,0,2
"2011","E00017275","E00017275","Total",121,97,31,66,0,2,1,1,22,19,0,2,1,0
"2011","E00017276","E00017276","Total",131,64,10,54,2,16,2,14,49,46,0,3,0,0
"2011","E00017277","E00017277","Total",85,43,16,27,0,28,11,17,14,11,0,2,1,0
"2011","E00017282","E00017282","Total",122,48,11,37,0,55,18,37,19,17,0,2,0,0
"2011","E00017265","E00017265","Total",127,78,20,58,0,30,11,19,18,16,0,1,1,1
"2011","E00017266","E00017266","Total",125,77,20,57,0,11,2,9,37,35,0,2,0,0
"2011","E00017269","E00017269","Total",139,65,20,45,9,53,5,48,8,7,0,1,0,4
"2011","E00017271","E00017271","Total",69,11,2,9,7,48,3,45,3,2,0,1,0,0
"2011","E00017280","E00017280","Total",137,90,29,61,4,16,4,12,26,25,0,1,0,1
"2011","E00017356","E00017356","Total",121,109,52,57,0,2,0,2,9,9,0,0,0,1
"2011","E00017357","E00017357","Total",133,100,48,52,0,4,0,4,23,22,0,1,0,6
"2011","E00017370","E00017370","Total",110,94,45,49,0,3,1,2,12,11,0,1,0,1
"2011","E00017375","E00017375","Total",126,96,36,60,4,13,4,9,13,11,0,2,0,0
"2011","E00017018","E00017018","Total",123,87,40,47,0,10,3,7,23,21,0,1,1,3
"2011","E00017022","E00017022","Total",144,79,28,51,0,19,2,17,46,46,0,0,0,0
"2011","E00017023","E00017023","Total",121,96,44,52,0,7,0,7,15,14,0,0,1,3
"2011","E00017024","E00017024","Total",117,98,53,45,0,1,0,1,18,18,0,0,0,0
"2011","E00017026","E00017026","Total",116,62,30,32,0,4,3,1,49,44,4,1,0,1
"2011","E00017322","E00017322","Total",130,118,63,55,0,0,0,0,11,11,0,0,0,1
"2011","E00017323","E00017323","Total",102,91,54,37,0,1,0,1,9,9,0,0,0,1
"2011","E00017328","E00017328","Total",106,92,53,39,0,0,0,0,13,13,0,0,0,1
"2011","E00017343","E00017343","Total",117,109,77,32,0,1,0,1,7,6,0,1,0,0
"2011","E00017347","E00017347","Total",119,108,64,44,1,1,0,1,8,8,0,0,0,1
"2011","E00017330","E00017330","Total",127,112,59,53,0,0,0,0,14,13,1,0,0,1
"2011","E00017331","E00017331","Total",123,116,62,54,0,1,0,1,5,5,0,0,0,1
"2011","E00017335","E00017335","Total",132,120,68,52,0,2,1,1,10,9,0,1,0,0
"2011","E00017351","E00017351","Total",126,109,54,55,0,1,0,1,16,16,0,0,0,0
"2011","E00017326","E00017326","Total",130,100,48,52,2,1,1,0,26,23,1,1,1,1
"2011","E00017327","E00017327","Total",109,98,52,46,0,1,0,1,10,9,1,0,0,0
"2011","E00017332","E00017332","Total",118,92,56,36,0,1,0,1,23,23,0,0,0,2
"2011","E00017333","E00017333","Total",123,94,50,44,1,1,0,1,26,24,0,1,1,1
"2011","E00017334","E00017334","Total",129,101,44,57,0,1,0,1,27,25,0,2,0,0
"2011","E00017325","E00017325","Total",122,92,60,32,0,9,1,8,21,21,0,0,0,0
"2011","E00017329","E00017329","Total",119,108,62,46,0,3,2,1,5,5,0,0,0,3
"2011","E00017341","E00017341","Total",145,64,33,31,6,37,9,28,37,31,0,4,2,1
"2011","E00017342","E00017342","Total",144,63,21,42,3,25,2,23,51,51,0,0,0,2
"2011","E00017344","E00017344","Total",119,64,29,35,0,4,1,3,50,45,0,5,0,1
"2011","E00017016","E00017016","Total",113,65,27,38,0,17,0,17,26,25,0,1,0,5
"2011","E00017017","E00017017","Total",129,68,30,38,1,37,13,24,20,16,0,2,2,3
"2011","E00017019","E00017019","Total",103,59,21,38,1,3,1,2,39,35,0,4,0,1
"2011","E00017020","E00017020","Total",108,63,21,42,0,22,7,15,22,21,0,0,1,1
"2011","E00017021","E00017021","Total",142,93,38,55,2,14,4,10,32,32,0,0,0,1
"2011","E00017106","E00017106","Total",96,59,23,36,0,4,1,3,33,30,0,3,0,0
"2011","E00017107","E00017107","Total",117,42,16,26,1,7,3,4,65,63,0,1,1,2
"2011","E00017110","E00017110","Total",109,68,29,39,0,5,0,5,36,35,0,1,0,0
"2011","E00017113","E00017113","Total",128,89,46,43,0,2,1,1,37,35,0,2,0,0
"2011","E00017114","E00017114","Total",145,94,62,32,0,2,0,2,49,49,0,0,0,0
"2011","E00017115","E00017115","Total",125,83,35,48,0,0,0,0,41,38,0,3,0,1
"2011","E00017421","E00017421","Total",147,65,31,34,0,17,2,15,63,58,2,3,0,2
"2011","E00017428","E00017428","Total",105,77,41,36,0,3,0,3,23,22,0,1,0,2
"2011","E00017432","E00017432","Total",128,61,28,33,0,16,1,15,50,46,0,3,1,1
"2011","E00017435","E00017435","Total",138,63,25,38,0,5,0,5,68,66,0,2,0,2
"2011","E00017436","E00017436","Total",132,74,29,45,0,6,3,3,50,44,1,5,0,2
"2011","E00017437","E00017437","Total",149,40,14,26,0,12,1,11,97,95,1,1,0,0
"2011","E00017413","E00017413","Total",138,91,17,74,0,14,8,6,31,29,0,2,0,2
"2011","E00017439","E00017439","Total",136,46,16,30,0,52,26,26,37,33,1,2,1,1
"2011","E00017440","E00017440","Total",104,33,4,29,0,54,23,31,15,15,0,0,0,2
"2011","E00017441","E00017441","Total",116,48,15,33,0,45,21,24,23,20,1,2,0,0
"2011","E00017442","E00017442","Total",118,37,14,23,0,54,21,33,24,22,1,1,0,3
"2011","E00017443","E00017443","Total",79,29,3,26,0,10,5,5,40,36,1,2,1,0
"2011","E00017545","E00017545","Total",136,84,38,46,0,15,1,14,37,35,1,1,0,0
"2011","E00017567","E00017567","Total",118,80,38,42,0,2,1,1,33,32,0,1,0,3
"2011","E00017568","E00017568","Total",119,90,42,48,0,11,6,5,18,16,0,2,0,0
"2011","E00017569","E00017569","Total",129,91,47,44,0,20,0,20,18,18,0,0,0,0
"2011","E00017570","E00017570","Total",102,49,26,23,0,31,0,31,19,18,0,1,0,3
"2011","E00017267","E00017267","Total",201,136,44,92,2,15,0,15,47,46,0,1,0,1
"2011","E00017272","E00017272","Total",131,91,33,58,3,15,1,14,21,20,0,1,0,1
"2011","E00017278","E00017278","Total",159,103,40,63,10,17,0,17,29,28,0,1,0,0
"2011","E00017279","E00017279","Total",121,67,22,45,2,17,4,13,32,32,0,0,0,3
"2011","E00017281","E00017281","Total",97,74,23,51,1,0,0,0,21,20,0,1,0,1
"2011","E00017284","E00017284","Total",109,94,46,48,0,3,1,2,12,9,0,3,0,0
"2011","E00017285","E00017285","Total",112,99,40,59,1,0,0,0,12,12,0,0,0,0
"2011","E00017286","E00017286","Total",117,86,40,46,1,1,0,1,29,27,0,2,0,0
"2011","E00017287","E00017287","Total",94,74,23,51,0,1,0,1,18,17,0,1,0,1
"2011","E00017293","E00017293","Total",107,81,42,39,1,4,2,2,20,19,0,1,0,1
"2011","E00017283","E00017283","Total",103,82,31,51,0,2,1,1,19,16,0,3,0,0
"2011","E00017288","E00017288","Total",108,78,32,46,0,5,1,4,21,21,0,0,0,4
"2011","E00017289","E00017289","Total",98,89,42,47,0,1,0,1,7,6,0,1,0,1
"2011","E00017290","E00017290","Total",129,109,46,63,0,2,1,1,17,16,0,1,0,1
"2011","E00017292","E00017292","Total",110,89,32,57,1,1,0,1,18,18,0,0,0,1
"2011","E00017268","E00017268","Total",145,107,42,65,0,17,2,15,19,16,0,3,0,2
"2011","E00017270","E00017270","Total",136,110,46,64,1,0,0,0,23,23,0,0,0,2
"2011","E00017291","E00017291","Total",137,118,57,61,1,2,0,2,15,15,0,0,0,1
"2011","E00017294","E00017294","Total",116,100,39,61,0,2,0,2,13,12,0,0,1,1
"2011","E00017361","E00017361","Total",117,91,49,42,2,6,4,2,17,17,0,0,0,1
"2011","E00017374","E00017374","Total",135,108,41,67,0,7,0,7,20,17,1,1,1,0
"2011","E00017377","E00017377","Total",134,107,37,70,1,5,0,5,20,17,0,2,1,1
"2011","E00017380","E00017380","Total",120,98,39,59,1,7,5,2,14,13,0,1,0,0
"2011","E00017071","E00017071","Total",134,52,10,42,2,49,4,45,30,30,0,0,0,1
"2011","E00017087","E00017087","Total",131,30,13,17,3,88,42,46,8,6,0,1,1,2
"2011","E00017094","E00017094","Total",135,31,11,20,1,90,31,59,11,10,0,0,1,2
"2011","E00017095","E00017095","Total",136,42,11,31,0,69,33,36,23,21,0,1,1,2
"2011","E00017068","E00017068","Total",134,92,26,66,0,15,1,14,27,24,0,3,0,0
"2011","E00017072","E00017072","Total",174,88,28,60,2,45,10,35,33,29,0,4,0,6
"2011","E00017073","E00017073","Total",140,56,19,37,1,40,5,35,42,40,0,2,0,1
"2011","E00017082","E00017082","Total",171,80,27,53,12,62,1,61,16,15,0,1,0,1
"2011","E00017091","E00017091","Total",109,77,28,49,0,9,2,7,23,22,0,1,0,0
"2011","E00017070","E00017070","Total",129,49,10,39,2,46,14,32,29,26,0,1,2,3
"2011","E00017081","E00017081","Total",114,38,9,29,1,37,6,31,34,33,0,1,0,4
"2011","E00017084","E00017084","Total",123,41,20,21,1,60,21,39,20,16,1,2,1,1
"2011","E00017085","E00017085","Total",139,37,17,20,0,58,28,30,40,39,0,0,1,4
"2011","E00017088","E00017088","Total",108,36,11,25,0,51,19,32,20,20,0,0,0,1
"2011","E00017090","E00017090","Total",129,42,18,24,4,71,16,55,11,8,2,0,1,1
"2011","E00017149","E00017149","Total",112,41,7,34,2,29,15,14,39,36,0,2,1,1
"2011","E00017154","E00017154","Total",115,20,4,16,1,80,38,42,11,11,0,0,0,3
"2011","E00017155","E00017155","Total",106,14,4,10,12,50,11,39,30,28,0,0,2,0
"2011","E00017156","E00017156","Total",162,28,10,18,1,116,51,65,17,13,0,4,0,0
"2011","E00017158","E00017158","Total",128,24,8,16,1,90,45,45,12,10,0,1,1,1
"2011","E00017235","E00017235","Total",75,4,1,3,0,67,2,65,2,2,0,0,0,2
"2011","E00017240","E00017240","Total",114,66,28,38,2,24,7,17,22,22,0,0,0,0
"2011","E00017255","E00017255","Total",105,77,33,44,0,3,2,1,24,23,0,1,0,1
"2011","E00017257","E00017257","Total",120,65,23,42,0,21,10,11,31,29,0,2,0,3
"2011","E00017260","E00017260","Total",82,39,12,27,2,26,6,20,15,11,0,2,2,0
"2011","E00017263","E00017263","Total",134,64,23,41,0,40,16,24,29,28,0,1,0,1
"2011","E00017360","E00017360","Total",125,109,46,63,0,3,1,2,12,12,0,0,0,1
"2011","E00017362","E00017362","Total",140,99,35,64,4,15,0,15,22,19,0,3,0,0
"2011","E00017364","E00017364","Total",129,101,35,66,1,8,1,7,18,16,0,1,1,1
"2011","E00017367","E00017367","Total",113,85,41,44,0,11,1,10,16,16,0,0,0,1
"2011","E00017358","E00017358","Total",121,52,10,42,2,39,2,37,27,24,0,2,1,1
"2011","E00017371","E00017371","Total",90,37,11,26,0,38,2,36,14,13,0,1,0,1
"2011","E00017372","E00017372","Total",89,35,7,28,1,45,2,43,8,8,0,0,0,0
"2011","E00017379","E00017379","Total",133,46,11,35,2,62,3,59,23,22,0,1,0,0
"2011","E00017381","E00017381","Total",112,48,9,39,1,51,2,49,12,12,0,0,0,0
"2011","E00017352","E00017352","Total",130,58,15,43,3,51,3,48,17,17,0,0,0,1
"2011","E00017353","E00017353","Total",209,55,19,36,0,140,5,135,14,12,0,2,0,0
"2011","E00017363","E00017363","Total",102,75,34,41,0,4,1,3,21,21,0,0,0,2
"2011","E00017365","E00017365","Total",104,64,20,44,0,28,2,26,12,11,0,0,1,0
"2011","E00017354","E00017354","Total",106,70,21,49,1,26,0,26,9,9,0,0,0,0
"2011","E00017355","E00017355","Total",154,64,17,47,0,74,4,70,14,14,0,0,0,2
"2011","E00017359","E00017359","Total",115,42,18,24,1,65,5,60,6,6,0,0,0,1
"2011","E00017366","E00017366","Total",133,16,0,16,0,108,4,104,4,4,0,0,0,5
"2011","E00017368","E00017368","Total",101,79,34,45,1,7,1,6,13,11,0,0,2,1
"2011","E00017369","E00017369","Total",122,96,49,47,0,4,0,4,22,19,0,3,0,0
"2011","E00017373","E00017373","Total",128,58,12,46,0,42,7,35,28,27,0,1,0,0
"2011","E00017376","E00017376","Total",104,56,24,32,1,14,4,10,32,28,1,3,0,1
"2011","E00017378","E00017378","Total",123,105,38,67,1,5,0,5,9,8,0,0,1,3
"2011","E00017546","E00017546","Total",114,106,60,46,0,0,0,0,8,7,0,1,0,0
"2011","E00017547","E00017547","Total",106,87,39,48,0,1,0,1,17,16,0,1,0,1
"2011","E00017554","E00017554","Total",109,97,48,49,0,0,0,0,10,10,0,0,0,2
"2011","E00017556","E00017556","Total",155,128,63,65,0,2,0,2,25,25,0,0,0,0
"2011","E00017571","E00017571","Total",115,92,48,44,0,1,0,1,21,18,0,3,0,1
"2011","E00017543","E00017543","Total",113,106,62,44,0,0,0,0,6,5,0,0,1,1
"2011","E00017544","E00017544","Total",117,85,36,49,1,1,0,1,29,29,0,0,0,1
"2011","E00017548","E00017548","Total",125,102,41,61,1,2,1,1,19,19,0,0,0,1
"2011","E00017551","E00017551","Total",113,98,50,48,0,2,0,2,13,13,0,0,0,0
"2011","E00017559","E00017559","Total",133,83,30,53,15,19,1,18,16,12,2,2,0,0
"2011","E00017553","E00017553","Total",114,90,34,56,0,5,1,4,16,16,0,0,0,3
"2011","E00017558","E00017558","Total",128,108,46,62,0,3,0,3,17,16,0,1,0,0
"2011","E00017560","E00017560","Total",137,121,60,61,1,0,0,0,15,12,0,2,1,0
"2011","E00017563","E00017563","Total",123,112,48,64,1,1,1,0,9,8,0,1,0,0
"2011","E00017566","E00017566","Total",128,112,52,60,0,1,1,0,13,12,0,1,0,2
"2011","E00017549","E00017549","Total",123,75,33,42,3,16,8,8,25,25,0,0,0,4
"2011","E00017552","E00017552","Total",123,70,22,48,2,4,1,3,46,44,0,1,1,1
"2011","E00017555","E00017555","Total",96,68,26,42,0,10,3,7,18,17,0,1,0,0
"2011","E00017561","E00017561","Total",116,94,34,60,1,0,0,0,21,19,0,1,1,0
"2011","E00017565","E00017565","Total",116,77,20,57,0,17,8,9,21,20,0,1,0,1
"2011","E00017542","E00017542","Total",128,95,41,54,3,1,0,1,26,25,0,1,0,3
"2011","E00017550","E00017550","Total",118,85,26,59,0,2,1,1,31,28,0,3,0,0
"2011","E00017557","E00017557","Total",121,96,50,46,0,12,6,6,11,11,0,0,0,2
"2011","E00017562","E00017562","Total",125,103,42,61,0,3,2,1,18,18,0,0,0,1
"2011","E00017564","E00017564","Total",115,75,32,43,0,5,1,4,32,29,0,3,0,3
"2011","E00017008","E00017008","Total",119,112,58,54,0,0,0,0,7,7,0,0,0,0
"2011","E00017025","E00017025","Total",112,95,49,46,0,2,0,2,14,13,0,1,0,1
"2011","E00017028","E00017028","Total",123,92,46,46,1,16,8,8,13,12,0,1,0,1
"2011","E00017030","E00017030","Total",145,133,83,50,0,2,1,1,9,8,0,1,0,1
"2011","E00017009","E00017009","Total",116,103,53,50,0,0,0,0,12,10,0,2,0,1
"2011","E00017010","E00017010","Total",104,95,50,45,1,1,0,1,7,6,0,1,0,0
"2011","E00017011","E00017011","Total",126,114,48,66,0,2,1,1,9,8,0,1,0,1
"2011","E00017012","E00017012","Total",128,115,53,62,0,0,0,0,12,12,0,0,0,1
"2011","E00017032","E00017032","Total",116,107,63,44,0,1,0,1,8,7,0,1,0,0
"2011","E00017013","E00017013","Total",130,123,61,62,1,1,0,1,5,4,0,1,0,0
"2011","E00017014","E00017014","Total",127,118,60,58,1,0,0,0,8,8,0,0,0,0
"2011","E00017015","E00017015","Total",144,131,67,64,1,0,0,0,10,9,0,1,0,2
"2011","E00017034","E00017034","Total",132,123,56,67,0,0,0,0,9,9,0,0,0,0
"2011","E00017035","E00017035","Total",115,79,43,36,0,27,9,18,9,9,0,0,0,0
"2011","E00017027","E00017027","Total",124,112,53,59,0,2,1,1,9,8,0,1,0,1
"2011","E00017029","E00017029","Total",129,114,58,56,0,1,0,1,13,12,0,1,0,1
"2011","E00017031","E00017031","Total",124,115,65,50,1,0,0,0,8,7,0,1,0,0
"2011","E00017033","E00017033","Total",120,107,63,44,0,2,0,2,11,9,0,2,0,0
"2011","E00017313","E00017313","Total",119,108,63,45,0,2,1,1,8,6,0,2,0,1
"2011","E00017314","E00017314","Total",109,69,28,41,0,0,0,0,40,36,0,4,0,0
"2011","E00017315","E00017315","Total",121,107,50,57,0,0,0,0,11,10,0,1,0,3
"2011","E00017316","E00017316","Total",143,79,24,55,0,35,15,20,28,27,0,1,0,1
"2011","E00017318","E00017318","Total",148,86,28,58,3,33,12,21,25,22,0,2,1,1
"2011","E00017089","E00017089","Total",150,35,10,25,10,87,25,62,18,17,0,1,0,0
"2011","E00017092","E00017092","Total",143,90,56,34,8,18,4,14,27,22,1,4,0,0
"2011","E00017096","E00017096","Total",115,44,16,28,9,20,1,19,40,39,0,0,1,2
"2011","E00017099","E00017099","Total",138,83,40,43,4,16,1,15,34,34,0,0,0,1
"2011","E00017075","E00017075","Total",114,92,39,53,2,6,0,6,11,7,0,3,1,3
"2011","E00017097","E00017097","Total",131,48,14,34,0,15,0,15,67,66,0,1,0,1
"2011","E00017098","E00017098","Total",128,110,53,57,0,4,0,4,12,10,0,2,0,2
"2011","E00017100","E00017100","Total",141,28,15,13,0,89,12,77,20,18,0,1,1,4
"2011","E00017101","E00017101","Total",140,110,46,64,1,3,0,3,25,25,0,0,0,1
"2011","E00017386","E00017386","Total",126,55,13,42,3,44,17,27,24,21,0,2,1,0
"2011","E00017405","E00017405","Total",127,81,44,37,0,27,3,24,18,15,0,3,0,1
"2011","E00017407","E00017407","Total",128,107,59,48,0,2,0,2,16,16,0,0,0,3
"2011","E00017409","E00017409","Total",123,105,68,37,0,5,4,1,13,12,0,1,0,0
"2011","E00017410","E00017410","Total",133,80,32,48,0,17,2,15,35,33,0,1,1,1
"2011","E00017411","E00017411","Total",127,97,56,41,1,2,0,2,27,26,0,1,0,0
"2011","E00017393","E00017393","Total",125,82,22,60,0,5,1,4,37,36,0,1,0,1
"2011","E00017397","E00017397","Total",155,56,14,42,0,69,24,45,30,27,0,3,0,0
"2011","E00017398","E00017398","Total",118,96,54,42,0,7,2,5,13,11,0,2,0,2
"2011","E00017400","E00017400","Total",109,87,41,46,2,11,0,11,9,9,0,0,0,0
"2011","E00017401","E00017401","Total",120,40,19,21,1,65,24,41,14,13,0,1,0,0
"2011","E00017383","E00017383","Total",116,44,9,35,0,55,23,32,16,16,0,0,0,1
"2011","E00017402","E00017402","Total",104,50,14,36,0,28,17,11,24,24,0,0,0,2
"2011","E00017403","E00017403","Total",154,79,28,51,1,36,13,23,38,37,0,1,0,0
"2011","E00017404","E00017404","Total",113,89,39,50,0,5,3,2,18,17,1,0,0,1
"2011","E00017406","E00017406","Total",130,50,17,33,4,54,12,42,21,21,0,0,0,1
"2011","E00017324","E00017324","Total",102,37,10,27,0,0,0,0,63,59,2,1,1,2
"2011","E00017336","E00017336","Total",121,86,45,41,1,1,0,1,32,31,0,1,0,1
"2011","E00017337","E00017337","Total",112,86,51,35,0,1,0,1,25,23,0,2,0,0
"2011","E00017338","E00017338","Total",131,67,28,39,0,18,9,9,45,42,1,2,0,1
"2011","E00017339","E00017339","Total",113,57,25,32,0,13,7,6,41,38,0,2,1,2
"2011","E00017340","E00017340","Total",127,51,19,32,0,5,4,1,69,67,0,2,0,2
"2011","E00017384","E00017384","Total",128,73,30,43,0,41,20,21,12,12,0,0,0,2
"2011","E00017387","E00017387","Total",98,52,24,28,0,30,10,20,16,15,0,1,0,0
"2011","E00017388","E00017388","Total",131,80,23,57,0,37,17,20,14,14,0,0,0,0
"2011","E00017408","E00017408","Total",126,83,30,53,0,27,6,21,16,14,0,1,1,0
"2011","E00017412","E00017412","Total",105,55,15,40,2,35,14,21,13,12,0,1,0,0
"2011","E00017382","E00017382","Total",130,58,21,37,0,37,15,22,32,30,0,2,0,3
"2011","E00017394","E00017394","Total",75,11,9,2,0,5,3,2,57,56,0,0,1,2
"2011","E00017395","E00017395","Total",109,53,17,36,0,18,6,12,36,33,1,1,1,2
"2011","E00017396","E00017396","Total",117,44,13,31,0,46,22,24,27,25,0,2,0,0
"2011","E00017399","E00017399","Total",117,67,23,44,0,15,9,6,34,33,0,1,0,1
"2011","E00017449","E00017449","Total",130,78,28,50,0,37,11,26,13,13,0,0,0,2
"2011","E00017451","E00017451","Total",156,77,20,57,4,54,25,29,21,17,0,3,1,0
"2011","E00017456","E00017456","Total",123,62,20,42,0,38,13,25,23,21,0,1,1,0
"2011","E00017458","E00017458","Total",116,55,20,35,2,45,22,23,13,13,0,0,0,1
"2011","E00017477","E00017477","Total",123,62,28,34,1,37,13,24,20,17,0,2,1,3
"2011","E00017448","E00017448","Total",163,86,28,58,0,43,17,26,32,30,0,1,1,2
"2011","E00017473","E00017473","Total",116,49,15,34,0,20,5,15,46,42,0,3,1,1
"2011","E00017474","E00017474","Total",149,79,42,37,0,44,23,21,25,25,0,0,0,1
"2011","E00017475","E00017475","Total",119,64,29,35,0,35,13,22,19,17,0,0,2,1
"2011","E00017476","E00017476","Total",103,63,36,27,0,15,2,13,23,22,0,1,0,2
"2011","E00017385","E00017385","Total",153,90,30,60,0,44,15,29,17,16,0,1,0,2
"2011","E00017389","E00017389","Total",126,59,19,40,0,50,21,29,16,14,0,2,0,1
"2011","E00017390","E00017390","Total",127,58,19,39,1,52,13,39,16,15,0,1,0,0
"2011","E00017391","E00017391","Total",137,74,35,39,0,44,21,23,18,16,0,2,0,1
"2011","E00017392","E00017392","Total",107,55,28,27,0,38,19,19,12,12,0,0,0,2
"2011","E00017450","E00017450","Total",142,61,20,41,2,56,13,43,22,19,0,2,1,1
"2011","E00017452","E00017452","Total",131,71,30,41,1,29,9,20,29,28,1,0,0,1
"2011","E00017453","E00017453","Total",160,106,27,79,2,9,2,7,38,33,0,3,2,5
"2011","E00017454","E00017454","Total",127,83,43,40,0,24,9,15,19,16,0,1,2,1
"2011","E00017455","E00017455","Total",117,68,33,35,1,27,7,20,19,17,0,2,0,2
"2011","E00017459","E00017459","Total",116,74,28,46,1,31,9,22,10,7,0,1,2,0
"2011","E00017460","E00017460","Total",135,63,26,37,1,52,21,31,16,16,0,0,0,3
"2011","E00017463","E00017463","Total",116,52,18,34,0,45,22,23,18,18,0,0,0,1
"2011","E00017465","E00017465","Total",118,75,24,51,1,25,9,16,15,15,0,0,0,2
"2011","E00017466","E00017466","Total",112,48,18,30,11,42,10,32,10,7,0,2,1,1
"2011","E00017447","E00017447","Total",119,97,49,48,2,1,0,1,15,13,0,1,1,4
"2011","E00017462","E00017462","Total",113,46,17,29,0,62,4,58,5,4,0,0,1,0
"2011","E00017464","E00017464","Total",140,128,71,57,1,5,2,3,6,6,0,0,0,0
"2011","E00017467","E00017467","Total",107,95,37,58,0,6,4,2,5,5,0,0,0,1
"2011","E00017471","E00017471","Total",119,107,51,56,0,4,1,3,7,6,0,1,0,1
"2011","E00017457","E00017457","Total",130,35,7,28,0,73,18,55,22,21,0,1,0,0
"2011","E00017461","E00017461","Total",176,8,2,6,0,159,2,157,6,5,0,0,1,3
"2011","E00017468","E00017468","Total",105,58,16,42,1,39,18,21,6,5,0,1,0,1
"2011","E00017469","E00017469","Total",149,67,24,43,0,61,22,39,21,20,0,1,0,0
"2011","E00017470","E00017470","Total",112,66,18,48,1,35,15,20,10,10,0,0,0,0
"2011","E00017472","E00017472","Total",134,36,16,20,7,79,21,58,11,9,0,1,1,1
"2011","E00017300","E00017300","Total",130,104,44,60,0,5,3,2,18,16,0,2,0,3
"2011","E00017301","E00017301","Total",119,105,48,57,0,5,0,5,9,9,0,0,0,0
"2011","E00017306","E00017306","Total",122,117,47,70,0,0,0,0,5,5,0,0,0,0
"2011","E00017309","E00017309","Total",126,113,61,52,0,0,0,0,12,11,1,0,0,1
"2011","E00017319","E00017319","Total",111,107,51,56,0,1,1,0,3,3,0,0,0,0
"2011","E00017296","E00017296","Total",132,118,62,56,0,7,5,2,7,3,0,4,0,0
"2011","E00017299","E00017299","Total",136,125,66,59,0,0,0,0,10,9,0,1,0,1
"2011","E00017307","E00017307","Total",124,120,51,69,1,0,0,0,2,2,0,0,0,1
"2011","E00017308","E00017308","Total",139,126,53,73,1,0,0,0,10,8,0,2,0,2
"2011","E00017295","E00017295","Total",127,113,51,62,1,1,0,1,12,11,0,1,0,0
"2011","E00017298","E00017298","Total",121,109,41,68,0,3,2,1,7,7,0,0,0,2
"2011","E00017302","E00017302","Total",103,87,33,54,1,6,5,1,9,9,0,0,0,0
"2011","E00017303","E00017303","Total",118,101,35,66,0,2,1,1,13,12,0,1,0,2
"2011","E00017304","E00017304","Total",173,136,49,87,5,9,0,9,23,23,0,0,0,0
"2011","E00017305","E00017305","Total",131,118,40,78,0,0,0,0,13,12,0,1,0,0
"2011","E00017310","E00017310","Total",130,114,55,59,0,1,0,1,13,13,0,0,0,2
"2011","E00017311","E00017311","Total",125,105,41,64,1,4,1,3,15,15,0,0,0,0
"2011","E00017312","E00017312","Total",120,102,47,55,0,6,4,2,11,11,0,0,0,1
"2011","E00017297","E00017297","Total",164,121,52,69,4,16,4,12,21,20,0,1,0,2
"2011","E00017317","E00017317","Total",117,100,45,55,0,2,0,2,15,13,1,1,0,0
"2011","E00017320","E00017320","Total",114,100,50,50,1,1,0,1,10,9,0,0,1,2
"2011","E00017321","E00017321","Total",118,112,60,52,0,1,0,1,5,5,0,0,0,0
"2011","E00018828","E00018828","Total",121,113,67,46,0,1,1,0,6,6,0,0,0,1
"2011","E00018829","E00018829","Total",112,96,61,35,1,1,0,1,13,11,1,1,0,1
"2011","E00018830","E00018830","Total",121,105,58,47,1,2,2,0,13,12,1,0,0,0
"2011","E00018831","E00018831","Total",109,78,42,36,0,9,9,0,19,18,0,1,0,3
"2011","E00018833","E00018833","Total",129,114,59,55,0,0,0,0,14,13,0,1,0,1
"2011","E00018832","E00018832","Total",132,120,66,54,0,1,0,1,10,10,0,0,0,1
"2011","E00018836","E00018836","Total",118,116,66,50,0,0,0,0,2,2,0,0,0,0
"2011","E00018839","E00018839","Total",116,112,45,67,0,0,0,0,4,4,0,0,0,0
"2011","E00018840","E00018840","Total",117,113,59,54,0,0,0,0,2,2,0,0,0,2
"2011","E00018834","E00018834","Total",121,115,58,57,0,1,1,0,5,5,0,0,0,0
"2011","E00018835","E00018835","Total",145,112,52,60,0,6,3,3,23,23,0,0,0,4
"2011","E00018838","E00018838","Total",122,102,72,30,0,0,0,0,20,18,0,1,1,0
"2011","E00018841","E00018841","Total",131,115,67,48,2,0,0,0,14,14,0,0,0,0
"2011","E00018845","E00018845","Total",142,117,77,40,1,2,2,0,16,15,0,1,0,6
"2011","E00018837","E00018837","Total",115,114,58,56,0,1,1,0,0,0,0,0,0,0
"2011","E00018842","E00018842","Total",131,124,67,57,1,0,0,0,6,6,0,0,0,0
"2011","E00018843","E00018843","Total",112,105,56,49,0,0,0,0,6,6,0,0,0,1
"2011","E00018844","E00018844","Total",132,97,57,40,0,30,2,28,2,2,0,0,0,3
"2011","E00018846","E00018846","Total",129,118,63,55,0,2,0,2,8,8,0,0,0,1
"2011","E00018847","E00018847","Total",144,140,90,50,0,1,0,1,2,2,0,0,0,1
"2011","E00018848","E00018848","Total",147,136,83,53,0,1,0,1,8,4,0,4,0,2
"2011","E00018849","E00018849","Total",152,80,41,39,0,2,1,1,68,64,1,2,1,2
"2011","E00018824","E00018824","Total",129,108,66,42,1,0,0,0,18,18,0,0,0,2
"2011","E00018826","E00018826","Total",133,113,58,55,0,1,1,0,17,17,0,0,0,2
"2011","E00018852","E00018852","Total",136,80,53,27,3,3,2,1,48,43,1,3,1,2
"2011","E00018853","E00018853","Total",150,128,69,59,0,0,0,0,18,17,0,1,0,4
"2011","E00018854","E00018854","Total",133,86,48,38,0,6,4,2,38,35,1,2,0,3
"2011","E00018822","E00018822","Total",138,100,57,43,0,14,6,8,24,23,0,1,0,0
"2011","E00018823","E00018823","Total",129,85,39,46,0,22,21,1,21,19,0,1,1,1
"2011","E00018825","E00018825","Total",143,138,74,64,0,3,1,2,1,1,0,0,0,1
"2011","E00018827","E00018827","Total",122,50,21,29,0,54,5,49,18,18,0,0,0,0
"2011","E00018850","E00018850","Total",155,98,57,41,2,4,1,3,44,43,0,1,0,7
"2011","E00018851","E00018851","Total",111,57,29,28,0,23,15,8,28,26,0,2,0,3
"2011","E00018736","E00018736","Total",159,46,20,26,0,84,50,34,20,17,0,2,1,9
"2011","E00018741","E00018741","Total",126,77,28,49,0,36,31,5,12,12,0,0,0,1
"2011","E00018742","E00018742","Total",129,78,50,28,0,40,38,2,9,9,0,0,0,2
"2011","E00018743","E00018743","Total",132,111,66,45,1,5,5,0,14,14,0,0,0,1
"2011","E00018745","E00018745","Total",145,53,24,29,0,79,53,26,11,8,1,2,0,2
"2011","E00018746","E00018746","Total",130,56,24,32,0,45,8,37,29,28,0,0,1,0
"2011","E00018712","E00018712","Total",143,94,35,59,0,35,34,1,12,12,0,0,0,2
"2011","E00018713","E00018713","Total",147,97,40,57,0,33,25,8,14,13,0,1,0,3
"2011","E00018725","E00018725","Total",139,76,31,45,0,54,51,3,8,8,0,0,0,1
"2011","E00018749","E00018749","Total",135,92,38,54,9,11,9,2,21,18,0,2,1,2
"2011","E00018750","E00018750","Total",126,62,31,31,3,40,36,4,17,15,0,2,0,4
"2011","E00018716","E00018716","Total",147,100,46,54,0,33,28,5,12,10,0,2,0,2
"2011","E00018719","E00018719","Total",151,73,20,53,0,61,52,9,17,17,0,0,0,0
"2011","E00018727","E00018727","Total",115,71,33,38,0,39,29,10,5,5,0,0,0,0
"2011","E00018732","E00018732","Total",145,80,31,49,1,51,40,11,10,9,0,1,0,3
"2011","E00018748","E00018748","Total",146,91,31,60,0,43,41,2,9,9,0,0,0,3
"2011","E00018715","E00018715","Total",154,79,39,40,2,46,42,4,26,24,1,1,0,1
"2011","E00018718","E00018718","Total",160,45,15,30,2,80,63,17,27,26,0,1,0,6
"2011","E00018723","E00018723","Total",121,50,20,30,0,58,51,7,9,7,0,1,1,4
"2011","E00018724","E00018724","Total",110,64,20,44,1,32,32,0,12,10,1,1,0,1
"2011","E00018730","E00018730","Total",104,66,24,42,1,33,27,6,4,4,0,0,0,0
"2011","E00018738","E00018738","Total",127,55,26,29,4,47,38,9,20,19,0,1,0,1
"2011","E00018739","E00018739","Total",126,73,29,44,2,32,32,0,17,16,0,1,0,2
"2011","E00018740","E00018740","Total",123,107,54,53,1,8,8,0,6,5,0,1,0,1
"2011","E00018744","E00018744","Total",119,101,55,46,0,3,1,2,15,13,0,2,0,0
"2011","E00018747","E00018747","Total",109,79,35,44,1,3,3,0,24,22,0,2,0,2
"2011","E00018714","E00018714","Total",138,103,41,62,0,21,19,2,14,12,0,2,0,0
"2011","E00018717","E00018717","Total",110,103,49,54,0,1,0,1,6,5,0,1,0,0
"2011","E00018720","E00018720","Total",137,75,26,49,17,29,25,4,15,12,0,3,0,1
"2011","E00018729","E00018729","Total",126,86,37,49,4,10,8,2,25,23,0,2,0,1
"2011","E00018711","E00018711","Total",160,70,15,55,3,52,17,35,34,33,0,1,0,1
"2011","E00018721","E00018721","Total",129,76,28,48,2,10,8,2,38,35,0,3,0,3
"2011","E00018726","E00018726","Total",133,78,29,49,2,37,27,10,15,15,0,0,0,1
"2011","E00018734","E00018734","Total",120,66,31,35,0,26,25,1,26,25,0,1,0,2
"2011","E00018737","E00018737","Total",108,67,18,49,4,12,3,9,25,25,0,0,0,0
"2011","E00018722","E00018722","Total",143,85,37,48,0,43,38,5,14,13,0,0,1,1
"2011","E00018728","E00018728","Total",128,64,20,44,0,44,40,4,16,16,0,0,0,4
"2011","E00018731","E00018731","Total",116,51,17,34,1,48,42,6,10,10,0,0,0,6
"2011","E00018733","E00018733","Total",132,73,21,52,0,40,38,2,18,14,0,4,0,1
"2011","E00018735","E00018735","Total",136,86,37,49,0,37,28,9,12,10,0,2,0,1
"2011","E00018408","E00018408","Total",124,77,28,49,4,29,28,1,12,11,0,1,0,2
"2011","E00018432","E00018432","Total",129,85,25,60,2,28,26,2,14,13,0,1,0,0
"2011","E00018437","E00018437","Total",108,83,25,58,0,2,2,0,23,21,0,2,0,0
"2011","E00018438","E00018438","Total",138,99,39,60,0,17,16,1,20,20,0,0,0,2
"2011","E00018440","E00018440","Total",104,90,58,32,0,0,0,0,14,12,0,2,0,0
"2011","E00018405","E00018405","Total",135,98,39,59,0,23,8,15,14,13,0,1,0,0
"2011","E00018419","E00018419","Total",132,107,32,75,1,3,3,0,20,19,0,1,0,1
"2011","E00018422","E00018422","Total",119,97,36,61,0,2,1,1,19,19,0,0,0,1
"2011","E00018423","E00018423","Total",123,102,65,37,0,2,2,0,18,18,0,0,0,1
"2011","E00018429","E00018429","Total",133,82,50,32,0,3,2,1,46,45,0,1,0,2
"2011","E00018426","E00018426","Total",163,16,2,14,1,117,102,15,22,21,0,0,1,7
"2011","E00018427","E00018427","Total",142,40,11,29,1,61,15,46,33,31,1,1,0,7
"2011","E00018430","E00018430","Total",132,65,28,37,0,47,20,27,18,18,0,0,0,2
"2011","E00018433","E00018433","Total",140,82,30,52,3,41,31,10,14,14,0,0,0,0
"2011","E00018434","E00018434","Total",122,103,38,65,0,7,7,0,10,10,0,0,0,2
"2011","E00018413","E00018413","Total",137,125,60,65,0,1,1,0,8,7,0,1,0,3
"2011","E00018414","E00018414","Total",147,105,34,71,0,6,4,2,35,33,0,2,0,1
"2011","E00018415","E00018415","Total",126,116,48,68,0,1,0,1,9,7,0,2,0,0
"2011","E00018416","E00018416","Total",122,95,46,49,1,5,3,2,18,16,0,2,0,3
"2011","E00018417","E00018417","Total",131,118,44,74,0,0,0,0,12,11,0,1,0,1
"2011","E00018418","E00018418","Total",120,78,41,37,1,34,33,1,7,7,0,0,0,0
"2011","E00018420","E00018420","Total",106,80,33,47,0,16,14,2,10,9,0,1,0,0
"2011","E00018421","E00018421","Total",141,64,28,36,0,53,14,39,23,22,0,0,1,1
"2011","E00018424","E00018424","Total",147,71,28,43,0,48,46,2,26,25,0,1,0,2
"2011","E00018425","E00018425","Total",129,70,35,35,0,35,33,2,19,17,0,2,0,5
"2011","E00018406","E00018406","Total",120,106,51,55,0,2,2,0,10,9,0,1,0,2
"2011","E00018410","E00018410","Total",111,70,42,28,1,23,19,4,16,14,0,2,0,1
"2011","E00018411","E00018411","Total",121,70,20,50,0,17,17,0,31,29,0,2,0,3
"2011","E00018428","E00018428","Total",142,109,48,61,2,2,1,1,28,27,0,1,0,1
"2011","E00018431","E00018431","Total",140,98,38,60,0,5,3,2,35,32,0,1,2,2
"2011","E00018435","E00018435","Total",129,80,31,49,1,11,11,0,35,31,0,4,0,2
"2011","E00018436","E00018436","Total",107,98,60,38,0,1,1,0,8,7,0,1,0,0
"2011","E00018407","E00018407","Total",141,120,36,84,1,3,1,2,15,15,0,0,0,2
"2011","E00018409","E00018409","Total",133,98,24,74,0,3,2,1,32,30,0,2,0,0
"2011","E00018412","E00018412","Total",126,101,33,68,1,4,4,0,19,17,0,1,1,1
"2011","E00018439","E00018439","Total",127,120,58,62,0,2,1,1,4,3,0,0,1,1
"2011","E00018441","E00018441","Total",111,101,40,61,0,1,1,0,9,8,0,1,0,0
"2011","E00018608","E00018608","Total",129,115,53,62,0,5,4,1,9,9,0,0,0,0
"2011","E00018616","E00018616","Total",126,89,35,54,1,4,2,2,30,30,0,0,0,2
"2011","E00018621","E00018621","Total",123,113,56,57,2,2,2,0,6,6,0,0,0,0
"2011","E00018622","E00018622","Total",141,113,42,71,0,7,6,1,19,17,0,2,0,2
"2011","E00018606","E00018606","Total",102,75,32,43,2,7,7,0,16,15,0,1,0,2
"2011","E00018611","E00018611","Total",115,102,64,38,0,2,2,0,11,10,0,1,0,0
"2011","E00018613","E00018613","Total",121,109,47,62,0,1,1,0,10,10,0,0,0,1
"2011","E00018625","E00018625","Total",112,70,22,48,0,7,6,1,32,28,0,4,0,3
"2011","E00018638","E00018638","Total",144,122,63,59,0,5,3,2,15,15,0,0,0,2
"2011","E00018626","E00018626","Total",132,80,27,53,1,26,23,3,25,24,0,1,0,0
"2011","E00018628","E00018628","Total",112,76,27,49,1,24,23,1,9,9,0,0,0,2
"2011","E00018629","E00018629","Total",144,111,49,62,1,9,9,0,23,22,0,1,0,0
"2011","E00018630","E00018630","Total",165,88,34,54,7,17,15,2,47,43,1,2,1,6
"2011","E00175162","E00175162","Total",116,49,23,26,2,36,2,34,29,28,0,0,1,0
"2011","E00175176","E00175176","Total",91,84,43,41,1,1,0,1,5,5,0,0,0,0
"2011","E00175178","E00175178","Total",89,83,31,52,0,0,0,0,6,6,0,0,0,0
"2011","E00018631","E00018631","Total",122,90,41,49,0,3,3,0,28,27,0,1,0,1
"2011","E00018632","E00018632","Total",124,77,40,37,0,24,23,1,23,23,0,0,0,0
"2011","E00018633","E00018633","Total",139,66,27,39,0,7,7,0,63,61,0,0,2,3
"2011","E00018634","E00018634","Total",118,90,49,41,2,0,0,0,25,24,1,0,0,1
"2011","E00018635","E00018635","Total",123,95,48,47,0,3,1,2,22,20,0,2,0,3
"2011","E00018607","E00018607","Total",115,96,46,50,0,0,0,0,18,18,0,0,0,1
"2011","E00018612","E00018612","Total",137,86,40,46,0,7,4,3,42,39,0,1,2,2
"2011","E00018614","E00018614","Total",120,65,27,38,7,11,4,7,33,32,0,1,0,4
"2011","E00018617","E00018617","Total",123,77,41,36,0,5,2,3,41,38,0,3,0,0
"2011","E00018618","E00018618","Total",119,67,20,47,0,10,1,9,40,39,0,1,0,2
"2011","E00018640","E00018640","Total",130,101,52,49,0,6,5,1,20,20,0,0,0,3
"2011","E00018610","E00018610","Total",130,110,51,59,0,7,3,4,13,10,0,3,0,0
"2011","E00018636","E00018636","Total",105,72,25,47,0,20,19,1,9,8,0,1,0,4
"2011","E00018637","E00018637","Total",104,30,9,21,0,51,46,5,17,17,0,0,0,6
"2011","E00018639","E00018639","Total",117,81,28,53,0,18,17,1,17,17,0,0,0,1
"2011","E00175159","E00175159","Total",130,99,38,61,0,0,0,0,27,27,0,0,0,4
"2011","E00175160","E00175160","Total",128,90,34,56,6,3,2,1,28,28,0,0,0,1
"2011","E00175161","E00175161","Total",127,90,39,51,1,0,0,0,35,34,0,1,0,1
"2011","E00175163","E00175163","Total",127,107,41,66,1,0,0,0,19,19,0,0,0,0
"2011","E00018615","E00018615","Total",152,29,12,17,2,96,56,40,22,16,0,5,1,3
"2011","E00018619","E00018619","Total",137,108,44,64,1,5,2,3,21,17,0,4,0,2
"2011","E00018620","E00018620","Total",123,90,36,54,1,6,2,4,25,24,0,1,0,1
"2011","E00018623","E00018623","Total",134,110,38,72,2,11,1,10,10,10,0,0,0,1
"2011","E00018624","E00018624","Total",120,56,21,35,0,35,29,6,26,26,0,0,0,3
"2011","E00018481","E00018481","Total",150,98,41,57,5,0,0,0,45,44,0,1,0,2
"2011","E00018482","E00018482","Total",136,78,32,46,0,10,8,2,45,45,0,0,0,3
"2011","E00018497","E00018497","Total",183,96,55,41,4,14,13,1,64,63,0,1,0,5
"2011","E00018498","E00018498","Total",137,94,65,29,0,1,0,1,41,37,0,3,1,1
"2011","E00018499","E00018499","Total",149,116,71,45,0,3,2,1,30,29,0,1,0,0
"2011","E00018477","E00018477","Total",230,158,70,88,1,12,3,9,56,53,0,3,0,3
"2011","E00018486","E00018486","Total",133,102,46,56,1,2,0,2,28,28,0,0,0,0
"2011","E00018490","E00018490","Total",93,73,31,42,1,2,2,0,17,17,0,0,0,0
"2011","E00018504","E00018504","Total",150,136,63,73,0,0,0,0,13,12,0,1,0,1
"2011","E00018500","E00018500","Total",74,30,22,8,0,41,1,40,3,3,0,0,0,0
"2011","E00018501","E00018501","Total",107,54,24,30,1,30,29,1,19,17,0,2,0,3
"2011","E00018505","E00018505","Total",161,101,44,57,0,15,13,2,42,34,6,1,1,3
"2011","E00018507","E00018507","Total",113,107,59,48,0,1,0,1,5,4,0,1,0,0
"2011","E00018509","E00018509","Total",122,100,38,62,0,2,0,2,20,18,1,1,0,0
"2011","E00018485","E00018485","Total",127,119,53,66,0,1,0,1,7,7,0,0,0,0
"2011","E00018502","E00018502","Total",103,98,43,55,1,1,0,1,3,3,0,0,0,0
"2011","E00018503","E00018503","Total",118,105,46,59,1,3,0,3,8,7,0,1,0,1
"2011","E00018506","E00018506","Total",109,106,45,61,0,0,0,0,3,3,0,0,0,0
"2011","E00018508","E00018508","Total",95,90,36,54,0,0,0,0,4,4,0,0,0,1
"2011","E00018483","E00018483","Total",135,27,7,20,0,61,13,48,46,38,0,5,3,1
"2011","E00018484","E00018484","Total",112,51,27,24,0,19,13,6,41,37,0,4,0,1
"2011","E00018491","E00018491","Total",130,100,39,61,0,6,4,2,23,21,0,2,0,1
"2011","E00175124","E00175124","Total",91,30,10,20,47,2,2,0,11,11,0,0,0,1
"2011","E00175125","E00175125","Total",98,56,46,10,0,4,1,3,37,36,0,1,0,1
"2011","E00175126","E00175126","Total",124,37,7,30,1,58,5,53,27,27,0,0,0,1
"2011","E00018480","E00018480","Total",139,104,23,81,0,3,1,2,29,29,0,0,0,3
"2011","E00018488","E00018488","Total",107,85,27,58,0,2,1,1,19,18,0,0,1,1
"2011","E00018489","E00018489","Total",125,98,39,59,0,2,0,2,24,24,0,0,0,1
"2011","E00018494","E00018494","Total",101,65,31,34,0,6,0,6,28,26,0,2,0,2
"2011","E00175149","E00175149","Total",114,14,5,9,10,3,1,2,87,87,0,0,0,0
"2011","E00175167","E00175167","Total",90,42,17,25,13,12,9,3,23,19,0,4,0,0
"2011","E00175177","E00175177","Total",113,47,23,24,35,6,2,4,24,23,0,0,1,1
"2011","E00018478","E00018478","Total",156,84,20,64,1,26,25,1,43,39,0,3,1,2
"2011","E00018492","E00018492","Total",130,81,36,45,0,29,2,27,17,17,0,0,0,3
"2011","E00018495","E00018495","Total",136,63,20,43,0,2,1,1,70,63,0,7,0,1
"2011","E00018496","E00018496","Total",152,49,19,30,1,2,1,1,97,90,2,4,1,3
"2011","E00175145","E00175145","Total",100,46,17,29,1,11,0,11,41,37,1,3,0,1
"2011","E00175146","E00175146","Total",111,70,20,50,0,11,4,7,29,28,0,1,0,1
"2011","E00175147","E00175147","Total",108,33,10,23,0,3,0,3,72,71,0,1,0,0
"2011","E00175148","E00175148","Total",107,51,11,40,1,0,0,0,54,53,0,1,0,1
"2011","E00018644","E00018644","Total",133,113,47,66,0,7,3,4,12,11,1,0,0,1
"2011","E00018654","E00018654","Total",118,102,44,58,0,3,2,1,9,7,0,2,0,4
"2011","E00018656","E00018656","Total",99,77,40,37,0,6,6,0,15,15,0,0,0,1
"2011","E00018675","E00018675","Total",119,87,35,52,0,22,21,1,9,8,0,1,0,1
"2011","E00018651","E00018651","Total",115,98,44,54,0,5,3,2,12,12,0,0,0,0
"2011","E00018668","E00018668","Total",135,63,26,37,0,53,48,5,18,18,0,0,0,1
"2011","E00018669","E00018669","Total",127,56,26,30,2,38,35,3,30,28,0,2,0,1
"2011","E00018670","E00018670","Total",121,46,16,30,0,47,45,2,25,21,0,4,0,3
"2011","E00018672","E00018672","Total",115,39,18,21,0,60,34,26,12,12,0,0,0,4
"2011","E00018648","E00018648","Total",112,96,53,43,1,3,1,2,12,12,0,0,0,0
"2011","E00018649","E00018649","Total",108,96,44,52,0,1,1,0,10,9,0,1,0,1
"2011","E00018650","E00018650","Total",125,104,66,38,0,4,1,3,16,14,0,1,1,1
"2011","E00018655","E00018655","Total",100,83,39,44,0,8,7,1,9,8,0,1,0,0
"2011","E00018659","E00018659","Total",125,105,52,53,0,1,0,1,19,16,0,3,0,0
"2011","E00018641","E00018641","Total",125,117,48,69,1,3,0,3,4,4,0,0,0,0
"2011","E00018643","E00018643","Total",122,104,51,53,0,4,3,1,12,10,0,2,0,2
"2011","E00018658","E00018658","Total",138,130,75,55,0,2,0,2,6,6,0,0,0,0
"2011","E00018660","E00018660","Total",122,102,63,39,1,1,1,0,18,14,0,4,0,0
"2011","E00018924","E00018924","Total",145,136,69,67,1,0,0,0,7,7,0,0,0,1
"2011","E00018925","E00018925","Total",123,112,58,54,0,2,1,1,7,6,0,1,0,2
"2011","E00018926","E00018926","Total",156,129,50,79,0,1,0,1,25,25,0,0,0,1
"2011","E00018927","E00018927","Total",130,116,63,53,0,4,3,1,10,10,0,0,0,0
"2011","E00018895","E00018895","Total",173,123,40,83,6,3,3,0,39,38,0,0,1,2
"2011","E00018898","E00018898","Total",113,43,14,29,1,47,36,11,20,19,0,1,0,2
"2011","E00018901","E00018901","Total",122,103,52,51,1,2,2,0,16,15,1,0,0,0
"2011","E00018905","E00018905","Total",123,97,44,53,0,2,1,1,24,22,0,2,0,0
"2011","E00018906","E00018906","Total",130,87,30,57,0,1,1,0,42,40,0,1,1,0
"2011","E00018894","E00018894","Total",118,15,6,9,0,95,90,5,7,7,0,0,0,1
"2011","E00018896","E00018896","Total",106,3,2,1,1,98,94,4,4,4,0,0,0,0
"2011","E00018897","E00018897","Total",102,21,6,15,0,46,15,31,34,33,0,0,1,1
"2011","E00018899","E00018899","Total",108,28,11,17,1,52,51,1,25,24,0,0,1,2
"2011","E00018902","E00018902","Total",130,22,8,14,0,96,93,3,10,9,0,1,0,2
"2011","E00018903","E00018903","Total",134,21,6,15,1,99,71,28,12,11,0,0,1,1
"2011","E00018892","E00018892","Total",156,119,45,74,0,7,5,2,29,29,0,0,0,1
"2011","E00018900","E00018900","Total",123,113,39,74,0,0,0,0,10,10,0,0,0,0
"2011","E00018904","E00018904","Total",122,88,25,63,0,3,1,2,31,30,0,1,0,0
"2011","E00018907","E00018907","Total",134,51,22,29,0,52,2,50,29,27,0,1,1,2
"2011","E00018908","E00018908","Total",121,94,31,63,0,3,2,1,21,21,0,0,0,3
"2011","E00018909","E00018909","Total",117,94,36,58,0,3,2,1,17,13,0,4,0,3
"2011","E00018910","E00018910","Total",138,108,39,69,0,6,4,2,24,21,0,3,0,0
"2011","E00018912","E00018912","Total",118,108,36,72,0,1,0,1,9,8,0,1,0,0
"2011","E00018914","E00018914","Total",147,129,64,65,0,3,1,2,13,8,0,5,0,2
"2011","E00018918","E00018918","Total",137,112,43,69,0,4,4,0,19,13,0,5,1,2
"2011","E00018893","E00018893","Total",158,82,23,59,0,29,13,16,45,44,0,1,0,2
"2011","E00018919","E00018919","Total",128,94,33,61,0,17,0,17,17,17,0,0,0,0
"2011","E00018920","E00018920","Total",139,81,31,50,0,22,21,1,34,32,0,2,0,2
"2011","E00018921","E00018921","Total",151,74,30,44,0,18,18,0,58,58,0,0,0,1
"2011","E00018922","E00018922","Total",121,86,36,50,0,2,1,1,32,31,0,1,0,1
"2011","E00018923","E00018923","Total",138,76,35,41,0,11,10,1,46,45,0,1,0,5
"2011","E00018911","E00018911","Total",129,84,30,54,1,11,8,3,32,31,0,1,0,1
"2011","E00018913","E00018913","Total",128,111,53,58,1,3,1,2,13,13,0,0,0,0
"2011","E00018915","E00018915","Total",126,91,20,71,0,3,2,1,31,23,1,6,1,1
"2011","E00018916","E00018916","Total",125,99,33,66,0,1,0,1,24,23,0,1,0,1
"2011","E00018917","E00018917","Total",134,63,13,50,0,3,1,2,65,62,0,3,0,3
"2011","E00018646","E00018646","Total",123,105,45,60,0,7,5,2,10,9,0,1,0,1
"2011","E00018652","E00018652","Total",147,127,58,69,1,5,4,1,13,12,1,0,0,1
"2011","E00018661","E00018661","Total",155,72,32,40,1,8,4,4,69,66,1,2,0,5
"2011","E00018673","E00018673","Total",111,89,57,32,1,13,9,4,7,7,0,0,0,1
"2011","E00175164","E00175164","Total",184,133,42,91,14,13,2,11,23,22,0,1,0,1
"2011","E00175165","E00175165","Total",82,32,11,21,5,23,6,17,21,21,0,0,0,1
"2011","E00018647","E00018647","Total",119,109,59,50,0,0,0,0,10,10,0,0,0,0
"2011","E00018671","E00018671","Total",132,78,44,34,0,17,13,4,32,27,0,5,0,5
"2011","E00018674","E00018674","Total",114,88,28,60,1,3,3,0,22,21,0,0,1,0
"2011","E00018676","E00018676","Total",124,91,58,33,0,7,6,1,25,24,0,0,1,1
"2011","E00018677","E00018677","Total",124,65,37,28,1,20,20,0,37,36,0,1,0,1
"2011","E00018653","E00018653","Total",125,101,49,52,1,5,2,3,17,15,0,2,0,1
"2011","E00018657","E00018657","Total",119,104,64,40,0,4,0,4,9,8,0,1,0,2
"2011","E00018662","E00018662","Total",119,101,51,50,0,3,1,2,13,13,0,0,0,2
"2011","E00018664","E00018664","Total",181,95,39,56,1,23,21,2,62,59,0,3,0,0
"2011","E00018667","E00018667","Total",118,54,26,28,0,49,8,41,14,12,0,2,0,1
"2011","E00018642","E00018642","Total",131,30,14,16,0,89,30,59,10,9,0,0,1,2
"2011","E00018663","E00018663","Total",138,83,29,54,0,39,34,5,15,15,0,0,0,1
"2011","E00018665","E00018665","Total",130,49,18,31,1,64,43,21,13,12,0,1,0,3
"2011","E00018666","E00018666","Total",137,59,27,32,1,53,37,16,22,19,0,1,2,2
"2011","E00018372","E00018372","Total",168,105,64,41,0,11,5,6,49,42,0,4,3,3
"2011","E00018377","E00018377","Total",130,94,37,57,1,15,15,0,20,18,1,1,0,0
"2011","E00018387","E00018387","Total",131,90,36,54,0,1,1,0,39,36,0,3,0,1
"2011","E00018389","E00018389","Total",143,92,42,50,0,4,3,1,45,40,2,2,1,2
"2011","E00018392","E00018392","Total",115,103,62,41,0,1,1,0,10,6,1,3,0,1
"2011","E00018395","E00018395","Total",124,115,76,39,0,0,0,0,7,7,0,0,0,2
"2011","E00018396","E00018396","Total",143,134,74,60,0,1,1,0,7,7,0,0,0,1
"2011","E00018397","E00018397","Total",146,135,63,72,0,0,0,0,11,11,0,0,0,0
"2011","E00018393","E00018393","Total",142,65,25,40,0,35,31,4,41,36,0,5,0,1
"2011","E00018394","E00018394","Total",153,142,67,75,0,1,1,0,10,10,0,0,0,0
"2011","E00018398","E00018398","Total",115,107,41,66,0,1,1,0,7,7,0,0,0,0
"2011","E00018400","E00018400","Total",111,105,45,60,0,1,1,0,5,5,0,0,0,0
"2011","E00018374","E00018374","Total",122,114,32,82,0,0,0,0,8,7,0,1,0,0
"2011","E00018378","E00018378","Total",96,78,57,21,2,1,0,1,8,8,0,0,0,7
"2011","E00018382","E00018382","Total",112,96,42,54,0,2,1,1,14,11,0,3,0,0
"2011","E00018404","E00018404","Total",136,124,61,63,0,0,0,0,12,12,0,0,0,0
"2011","E00018337","E00018337","Total",115,36,15,21,1,53,16,37,23,23,0,0,0,2
"2011","E00018341","E00018341","Total",137,86,35,51,1,23,20,3,24,23,0,1,0,3
"2011","E00018347","E00018347","Total",120,94,54,40,0,5,5,0,18,14,0,4,0,3
"2011","E00018352","E00018352","Total",154,64,23,41,6,52,47,5,32,27,0,5,0,0
"2011","E00018371","E00018371","Total",139,97,33,64,7,11,9,2,24,24,0,0,0,0
"2011","E00018339","E00018339","Total",131,112,42,70,0,7,5,2,12,12,0,0,0,0
"2011","E00018342","E00018342","Total",151,109,47,62,2,4,3,1,34,30,0,4,0,2
"2011","E00018343","E00018343","Total",95,85,42,43,0,2,1,1,8,7,0,1,0,0
"2011","E00018350","E00018350","Total",140,119,55,64,0,4,2,2,17,16,0,1,0,0
"2011","E00018353","E00018353","Total",131,65,15,50,5,18,17,1,39,38,0,1,0,4
"2011","E00018346","E00018346","Total",153,107,51,56,0,21,17,4,24,24,0,0,0,1
"2011","E00018351","E00018351","Total",125,98,37,61,8,6,6,0,13,13,0,0,0,0
"2011","E00018360","E00018360","Total",126,98,40,58,5,4,2,2,18,16,0,2,0,1
"2011","E00018364","E00018364","Total",126,75,24,51,2,3,2,1,45,43,0,2,0,1
"2011","E00018348","E00018348","Total",123,89,39,50,0,22,21,1,9,8,0,1,0,3
"2011","E00018354","E00018354","Total",126,93,35,58,1,12,12,0,19,15,0,3,1,1
"2011","E00018358","E00018358","Total",130,101,53,48,0,3,3,0,23,22,0,1,0,3
"2011","E00018362","E00018362","Total",163,65,32,33,3,61,13,48,31,30,0,1,0,3
"2011","E00018963","E00018963","Total",171,138,64,74,0,18,15,3,14,12,0,2,0,1
"2011","E00018964","E00018964","Total",143,125,49,76,0,1,1,0,16,16,0,0,0,1
"2011","E00018983","E00018983","Total",104,36,18,18,0,40,10,30,28,24,0,2,2,0
"2011","E00018985","E00018985","Total",173,107,52,55,0,11,9,2,52,51,0,1,0,3
"2011","E00018988","E00018988","Total",143,77,24,53,6,17,1,16,40,38,0,2,0,3
"2011","E00018992","E00018992","Total",133,83,27,56,0,1,0,1,49,46,0,3,0,0
"2011","E00018962","E00018962","Total",149,89,41,48,0,4,4,0,55,53,0,2,0,1
"2011","E00018971","E00018971","Total",122,66,33,33,0,1,1,0,54,51,0,1,2,1
"2011","E00018980","E00018980","Total",91,80,51,29,0,1,1,0,9,7,1,1,0,1
"2011","E00018982","E00018982","Total",114,103,54,49,0,1,0,1,9,9,0,0,0,1
"2011","E00018984","E00018984","Total",105,76,37,39,0,9,9,0,19,15,0,4,0,1
"2011","E00018989","E00018989","Total",105,78,49,29,1,1,1,0,22,21,0,1,0,3
"2011","E00018986","E00018986","Total",115,38,11,27,2,53,52,1,19,18,0,1,0,3
"2011","E00018987","E00018987","Total",138,30,10,20,0,74,34,40,28,26,0,1,1,6
"2011","E00018990","E00018990","Total",103,31,10,21,0,53,52,1,19,19,0,0,0,0
"2011","E00018991","E00018991","Total",147,46,11,35,0,40,5,35,59,58,0,1,0,2
"2011","E00018994","E00018994","Total",165,94,53,41,0,10,9,1,61,54,0,6,1,0
"2011","E00018995","E00018995","Total",139,56,29,27,0,51,6,45,31,31,0,0,0,1
"2011","E00018999","E00018999","Total",125,33,27,6,0,74,6,68,18,18,0,0,0,0
"2011","E00018965","E00018965","Total",154,120,38,82,2,1,0,1,31,31,0,0,0,0
"2011","E00018966","E00018966","Total",138,102,52,50,0,0,0,0,33,31,0,2,0,3
"2011","E00018967","E00018967","Total",161,93,40,53,0,9,3,6,56,54,0,2,0,3
"2011","E00018968","E00018968","Total",134,105,58,47,0,7,2,5,20,19,0,1,0,2
"2011","E00018993","E00018993","Total",149,55,13,42,0,10,0,10,83,82,0,1,0,1
"2011","E00018997","E00018997","Total",120,59,32,27,1,14,12,2,45,39,0,5,1,1
"2011","E00018969","E00018969","Total",155,60,28,32,6,20,12,8,66,62,1,2,1,3
"2011","E00018975","E00018975","Total",155,84,55,29,0,0,0,0,67,65,1,1,0,4
"2011","E00018996","E00018996","Total",162,113,54,59,0,23,18,5,24,23,0,1,0,2
"2011","E00018998","E00018998","Total",123,53,30,23,0,1,0,1,66,64,2,0,0,3
"2011","E00019000","E00019000","Total",150,93,49,44,0,6,6,0,48,43,0,4,1,3
"2011","E00019002","E00019002","Total",134,113,51,62,0,0,0,0,19,18,0,1,0,2
"2011","E00018970","E00018970","Total",126,114,54,60,1,1,1,0,10,10,0,0,0,0
"2011","E00018972","E00018972","Total",137,53,19,34,1,45,5,40,36,28,1,6,1,2
"2011","E00018973","E00018973","Total",138,112,92,20,1,4,1,3,17,17,0,0,0,4
"2011","E00018974","E00018974","Total",120,41,20,21,1,27,3,24,50,49,0,1,0,1
"2011","E00019001","E00019001","Total",82,65,27,38,0,1,0,1,14,14,0,0,0,2
"2011","E00019003","E00019003","Total",105,87,30,57,0,1,1,0,14,12,0,2,0,3
"2011","E00018976","E00018976","Total",100,93,49,44,0,1,0,1,6,6,0,0,0,0
"2011","E00018977","E00018977","Total",96,88,54,34,0,2,2,0,4,3,0,1,0,2
"2011","E00018978","E00018978","Total",104,99,53,46,0,1,0,1,3,3,0,0,0,1
"2011","E00018979","E00018979","Total",92,81,38,43,0,3,2,1,8,8,0,0,0,0
"2011","E00018981","E00018981","Total",115,107,65,42,0,3,3,0,4,3,1,0,0,1
"2011","E00018385","E00018385","Total",107,92,47,45,0,3,1,2,12,11,0,1,0,0
"2011","E00018386","E00018386","Total",136,110,56,54,0,4,2,2,19,17,0,2,0,3
"2011","E00018390","E00018390","Total",124,91,40,51,0,0,0,0,30,29,0,1,0,3
"2011","E00018391","E00018391","Total",245,117,58,59,1,2,2,0,123,117,0,4,2,2
"2011","E00018373","E00018373","Total",122,87,43,44,0,10,9,1,25,23,0,1,1,0
"2011","E00018376","E00018376","Total",101,29,9,20,0,52,15,37,20,19,0,0,1,0
"2011","E00018379","E00018379","Total",121,114,55,59,0,0,0,0,6,6,0,0,0,1
"2011","E00018399","E00018399","Total",121,104,56,48,2,3,1,2,12,11,0,1,0,0
"2011","E00018401","E00018401","Total",115,48,24,24,2,27,24,3,34,34,0,0,0,4
"2011","E00018375","E00018375","Total",123,114,40,74,0,2,0,2,7,6,0,1,0,0
"2011","E00018380","E00018380","Total",116,95,42,53,0,8,1,7,10,9,0,0,1,3
"2011","E00018402","E00018402","Total",127,98,38,60,1,1,1,0,27,25,0,2,0,0
"2011","E00018403","E00018403","Total",116,90,48,42,0,6,2,4,19,16,0,3,0,1
"2011","E00018381","E00018381","Total",125,63,39,24,1,4,3,1,55,52,2,1,0,2
"2011","E00018383","E00018383","Total",127,97,43,54,0,4,2,2,25,25,0,0,0,1
"2011","E00018384","E00018384","Total",105,78,38,40,1,1,0,1,24,23,0,1,0,1
"2011","E00018388","E00018388","Total",159,69,37,32,0,1,1,0,84,79,0,4,1,5
"2011","E00018338","E00018338","Total",220,94,52,42,25,84,35,49,13,11,0,1,1,4
"2011","E00018340","E00018340","Total",126,106,43,63,0,9,8,1,9,8,0,1,0,2
"2011","E00018344","E00018344","Total",114,85,30,55,2,15,9,6,8,8,0,0,0,4
"2011","E00018345","E00018345","Total",130,82,22,60,0,34,31,3,14,14,0,0,0,0
"2011","E00018349","E00018349","Total",125,108,68,40,0,6,5,1,10,9,0,1,0,1
"2011","E00018355","E00018355","Total",130,95,48,47,0,8,3,5,27,26,0,1,0,0
"2011","E00018356","E00018356","Total",121,98,41,57,1,2,1,1,18,16,0,1,1,2
"2011","E00018357","E00018357","Total",122,80,39,41,0,8,6,2,32,31,1,0,0,2
"2011","E00018359","E00018359","Total",124,115,48,67,0,1,1,0,7,7,0,0,0,1
"2011","E00018361","E00018361","Total",121,103,48,55,1,3,2,1,14,14,0,0,0,0
"2011","E00018366","E00018366","Total",136,109,52,57,1,5,4,1,19,15,0,2,2,2
"2011","E00018367","E00018367","Total",117,94,47,47,0,5,4,1,18,18,0,0,0,0
"2011","E00018370","E00018370","Total",124,98,53,45,0,7,2,5,19,19,0,0,0,0
"2011","E00018363","E00018363","Total",136,93,47,46,0,4,2,2,39,38,0,1,0,0
"2011","E00018365","E00018365","Total",120,77,27,50,0,8,5,3,35,33,0,1,1,0
"2011","E00018368","E00018368","Total",128,76,29,47,0,11,7,4,40,35,0,5,0,1
"2011","E00175128","E00175128","Total",131,32,7,25,4,25,6,19,68,66,0,2,0,2
"2011","E00175155","E00175155","Total",127,37,10,27,0,3,1,2,86,84,0,2,0,1
"2011","E00175172","E00175172","Total",136,51,12,39,6,11,7,4,66,57,2,6,1,2
"2011","E00175175","E00175175","Total",132,42,7,35,34,5,1,4,51,46,2,2,1,0
"2011","E00019070","E00019070","Total",128,100,43,57,0,2,1,1,26,17,2,7,0,0
"2011","E00019073","E00019073","Total",141,3,0,3,0,130,2,128,5,5,0,0,0,3
"2011","E00019074","E00019074","Total",118,109,52,57,0,3,2,1,6,5,0,1,0,0
"2011","E00019075","E00019075","Total",119,105,59,46,0,0,0,0,11,11,0,0,0,3
"2011","E00019076","E00019076","Total",119,80,51,29,0,1,1,0,38,36,0,2,0,0
"2011","E00019040","E00019040","Total",87,80,43,37,0,1,1,0,6,6,0,0,0,0
"2011","E00019041","E00019041","Total",117,94,42,52,0,11,9,2,11,10,0,0,1,1
"2011","E00019042","E00019042","Total",112,92,48,44,0,3,3,0,16,15,0,1,0,1
"2011","E00019062","E00019062","Total",144,83,39,44,0,38,1,37,20,19,0,0,1,3
"2011","E00019063","E00019063","Total",84,78,37,41,0,0,0,0,6,6,0,0,0,0
"2011","E00019043","E00019043","Total",141,129,70,59,0,2,1,1,8,8,0,0,0,2
"2011","E00019064","E00019064","Total",57,52,34,18,0,2,0,2,2,2,0,0,0,1
"2011","E00019065","E00019065","Total",118,94,44,50,0,4,3,1,19,18,0,1,0,1
"2011","E00019066","E00019066","Total",117,107,59,48,0,1,0,1,9,8,0,1,0,0
"2011","E00019067","E00019067","Total",123,70,31,39,0,17,15,2,34,32,0,2,0,2
"2011","E00019068","E00019068","Total",121,97,45,52,0,6,3,3,18,16,0,1,1,0
"2011","E00019069","E00019069","Total",137,51,22,29,2,49,47,2,34,33,0,1,0,1
"2011","E00019071","E00019071","Total",117,108,55,53,0,3,2,1,5,5,0,0,0,1
"2011","E00019072","E00019072","Total",140,125,64,61,0,3,1,2,10,9,0,1,0,2
"2011","E00018470","E00018470","Total",175,128,53,75,2,12,9,3,30,28,0,2,0,3
"2011","E00018471","E00018471","Total",177,130,55,75,6,23,1,22,18,17,0,1,0,0
"2011","E00018473","E00018473","Total",147,114,47,67,0,14,9,5,16,16,0,0,0,3
"2011","E00018474","E00018474","Total",152,131,53,78,1,6,6,0,10,9,0,1,0,4
"2011","E00018443","E00018443","Total",119,103,44,59,0,2,1,1,13,13,0,0,0,1
"2011","E00018444","E00018444","Total",120,33,9,24,0,10,3,7,76,73,0,3,0,1
"2011","E00018445","E00018445","Total",133,54,9,45,0,11,4,7,66,62,0,4,0,2
"2011","E00018446","E00018446","Total",120,76,34,42,1,9,3,6,33,31,0,1,1,1
"2011","E00018475","E00018475","Total",116,61,30,31,1,7,2,5,44,43,0,0,1,3
"2011","E00018476","E00018476","Total",133,70,27,43,0,31,14,17,29,29,0,0,0,3
"2011","E00018448","E00018448","Total",139,112,59,53,0,8,5,3,18,17,0,0,1,1
"2011","E00018450","E00018450","Total",114,78,35,43,0,22,6,16,13,13,0,0,0,1
"2011","E00018451","E00018451","Total",132,117,75,42,0,2,2,0,11,10,0,1,0,2
"2011","E00018452","E00018452","Total",142,123,61,62,0,6,2,4,12,12,0,0,0,1
"2011","E00018456","E00018456","Total",135,117,78,39,1,3,1,2,11,11,0,0,0,3
"2011","E00018453","E00018453","Total",113,90,39,51,0,18,4,14,5,5,0,0,0,0
"2011","E00018454","E00018454","Total",126,90,49,41,0,13,4,9,22,21,0,1,0,1
"2011","E00018455","E00018455","Total",104,70,26,44,2,15,14,1,17,14,0,2,1,0
"2011","E00018457","E00018457","Total",116,98,35,63,0,6,4,2,9,7,0,2,0,3
"2011","E00018460","E00018460","Total",116,98,34,64,1,3,3,0,14,14,0,0,0,0
"2011","E00018458","E00018458","Total",131,109,39,70,1,3,0,3,17,16,0,1,0,1
"2011","E00018459","E00018459","Total",139,116,34,82,2,6,4,2,15,15,0,0,0,0
"2011","E00018465","E00018465","Total",126,110,54,56,0,3,1,2,12,12,0,0,0,1
"2011","E00018468","E00018468","Total",133,117,43,74,1,3,2,1,12,12,0,0,0,0
"2011","E00018442","E00018442","Total",125,65,23,42,2,26,3,23,28,27,0,1,0,4
"2011","E00018447","E00018447","Total",143,54,12,42,1,25,10,15,60,58,0,2,0,3
"2011","E00018462","E00018462","Total",231,113,34,79,10,38,11,27,67,65,0,1,1,3
"2011","E00018467","E00018467","Total",107,51,14,37,0,24,4,20,30,29,0,0,1,2
"2011","E00018469","E00018469","Total",141,61,13,48,3,19,7,12,57,56,0,1,0,1
"2011","E00018472","E00018472","Total",188,114,26,88,2,20,3,17,49,46,0,3,0,3
"2011","E00175141","E00175141","Total",158,43,5,38,31,22,7,15,59,57,1,0,1,3
"2011","E00175142","E00175142","Total",132,40,3,37,8,17,6,11,65,61,0,4,0,2
"2011","E00175170","E00175170","Total",52,29,17,12,0,7,0,7,16,14,0,1,1,0
"2011","E00175179","E00175179","Total",92,35,10,25,0,40,2,38,17,16,0,0,1,0
"2011","E00018449","E00018449","Total",195,107,34,73,11,10,4,6,65,60,0,4,1,2
"2011","E00018463","E00018463","Total",134,98,41,57,2,6,1,5,28,27,0,1,0,0
"2011","E00018464","E00018464","Total",175,102,44,58,27,22,2,20,23,21,0,1,1,1
"2011","E00018466","E00018466","Total",129,111,42,69,0,4,2,2,12,12,0,0,0,2
"2011","E00018878","E00018878","Total",118,69,34,35,0,5,3,2,41,37,0,3,1,3
"2011","E00018879","E00018879","Total",128,90,33,57,1,3,2,1,32,29,0,0,3,2
"2011","E00018880","E00018880","Total",122,109,40,69,0,2,1,1,7,7,0,0,0,4
"2011","E00018881","E00018881","Total",128,60,26,34,0,28,26,2,36,34,0,1,1,4
"2011","E00018884","E00018884","Total",115,89,50,39,2,4,2,2,20,18,0,2,0,0
"2011","E00018857","E00018857","Total",130,25,4,21,0,10,7,3,95,93,0,0,2,0
"2011","E00018859","E00018859","Total",131,97,56,41,1,0,0,0,33,29,0,4,0,0
"2011","E00018861","E00018861","Total",128,68,24,44,1,6,4,2,53,50,0,3,0,0
"2011","E00018885","E00018885","Total",139,104,44,60,1,2,2,0,32,29,0,3,0,0
"2011","E00018887","E00018887","Total",131,83,40,43,1,4,4,0,42,42,0,0,0,1
"2011","E00018860","E00018860","Total",135,114,74,40,0,1,1,0,19,18,0,1,0,1
"2011","E00018862","E00018862","Total",138,71,32,39,0,36,5,31,29,28,0,0,1,2
"2011","E00018864","E00018864","Total",142,122,52,70,1,4,4,0,15,15,0,0,0,0
"2011","E00018891","E00018891","Total",118,89,34,55,3,2,1,1,21,20,0,1,0,3
"2011","E00018866","E00018866","Total",132,53,20,33,0,12,6,6,66,66,0,0,0,1
"2011","E00018868","E00018868","Total",120,90,35,55,0,4,1,3,25,24,0,1,0,1
"2011","E00018869","E00018869","Total",130,80,28,52,3,11,2,9,35,33,1,0,1,1
"2011","E00018872","E00018872","Total",125,73,24,49,0,14,9,5,37,32,0,3,2,1
"2011","E00018873","E00018873","Total",115,35,14,21,0,16,9,7,62,59,0,2,1,2
"2011","E00018928","E00018928","Total",125,38,20,18,0,7,6,1,77,75,0,2,0,3
"2011","E00018929","E00018929","Total",109,66,25,41,0,9,5,4,32,32,0,0,0,2
"2011","E00018936","E00018936","Total",143,90,35,55,0,4,3,1,47,46,0,1,0,2
"2011","E00018939","E00018939","Total",180,49,25,24,0,13,5,8,115,110,0,4,1,3
"2011","E00018943","E00018943","Total",139,111,41,70,1,1,0,1,26,25,0,1,0,0
"2011","E00175129","E00175129","Total",115,57,22,35,5,14,4,10,36,34,0,1,1,3
"2011","E00175130","E00175130","Total",118,15,7,8,1,70,2,68,32,30,1,0,1,0
"2011","E00175143","E00175143","Total",122,60,12,48,1,32,4,28,29,25,0,4,0,0
"2011","E00175166","E00175166","Total",122,102,40,62,0,2,1,1,18,14,1,3,0,0
"2011","E00175168","E00175168","Total",126,53,2,51,5,33,3,30,34,34,0,0,0,1
"2011","E00175169","E00175169","Total",106,81,36,45,1,9,1,8,14,14,0,0,0,1
"2011","E00018944","E00018944","Total",102,54,25,29,0,9,3,6,37,36,0,1,0,2
"2011","E00018950","E00018950","Total",120,90,31,59,1,5,5,0,23,21,0,2,0,1
"2011","E00018952","E00018952","Total",156,68,33,35,11,26,25,1,48,47,0,1,0,3
"2011","E00018953","E00018953","Total",116,77,30,47,1,5,2,3,30,27,0,2,1,3
"2011","E00018954","E00018954","Total",87,39,10,29,1,13,3,10,34,32,1,1,0,0
"2011","E00018930","E00018930","Total",107,86,29,57,0,5,2,3,16,16,0,0,0,0
"2011","E00018948","E00018948","Total",126,63,28,35,0,20,3,17,39,37,0,1,1,4
"2011","E00018949","E00018949","Total",125,106,39,67,0,2,1,1,17,16,0,0,1,0
"2011","E00018956","E00018956","Total",114,95,36,59,2,3,2,1,14,14,0,0,0,0
"2011","E00018958","E00018958","Total",107,52,23,29,1,5,3,2,46,42,0,2,2,3
"2011","E00018855","E00018855","Total",116,94,49,45,1,3,2,1,17,17,0,0,0,1
"2011","E00018883","E00018883","Total",125,98,45,53,0,5,1,4,22,21,1,0,0,0
"2011","E00018886","E00018886","Total",121,89,32,57,0,3,0,3,25,24,0,1,0,4
"2011","E00018889","E00018889","Total",120,85,30,55,0,5,1,4,30,27,0,0,3,0
"2011","E00175173","E00175173","Total",221,79,12,67,26,38,3,35,77,77,0,0,0,1
"2011","E00175174","E00175174","Total",135,100,44,56,8,12,2,10,15,15,0,0,0,0
"2011","E00018858","E00018858","Total",173,145,45,100,0,2,1,1,24,22,1,0,1,2
"2011","E00018863","E00018863","Total",160,102,42,60,3,13,4,9,39,36,0,2,1,3
"2011","E00018888","E00018888","Total",125,108,40,68,0,1,1,0,15,15,0,0,0,1
"2011","E00018890","E00018890","Total",113,73,24,49,0,8,1,7,31,30,0,1,0,1
"2011","E00018865","E00018865","Total",113,84,35,49,0,5,2,3,24,22,0,1,1,0
"2011","E00018867","E00018867","Total",122,93,48,45,1,9,8,1,18,18,0,0,0,1
"2011","E00018870","E00018870","Total",130,78,27,51,0,8,6,2,44,41,0,2,1,0
"2011","E00018871","E00018871","Total",126,87,42,45,0,6,4,2,33,32,0,1,0,0
"2011","E00018874","E00018874","Total",109,91,35,56,1,2,0,2,15,14,0,1,0,0
"2011","E00018875","E00018875","Total",141,80,37,43,3,13,10,3,44,44,0,0,0,1
"2011","E00018876","E00018876","Total",105,56,24,32,2,9,5,4,37,35,2,0,0,1
"2011","E00018877","E00018877","Total",157,16,1,15,15,102,6,96,22,21,0,0,1,2
"2011","E00175135","E00175135","Total",123,20,3,17,12,54,6,48,36,35,0,1,0,1
"2011","E00175136","E00175136","Total",155,77,23,54,2,24,2,22,48,47,0,1,0,4
"2011","E00175139","E00175139","Total",129,19,5,14,2,37,10,27,69,68,1,0,0,2
"2011","E00018957","E00018957","Total",125,70,26,44,1,9,4,5,44,42,0,1,1,1
"2011","E00018959","E00018959","Total",128,89,46,43,1,2,2,0,35,35,0,0,0,1
"2011","E00018960","E00018960","Total",153,113,43,70,0,5,4,1,35,33,0,2,0,0
"2011","E00018961","E00018961","Total",142,95,43,52,0,4,4,0,40,36,0,3,1,3
"2011","E00018932","E00018932","Total",132,87,40,47,1,5,3,2,37,36,0,0,1,2
"2011","E00018933","E00018933","Total",130,68,27,41,0,4,3,1,55,52,0,3,0,3
"2011","E00018937","E00018937","Total",128,61,29,32,0,7,7,0,59,57,0,1,1,1
"2011","E00018938","E00018938","Total",177,74,26,48,0,7,4,3,94,86,1,5,2,2
"2011","E00018931","E00018931","Total",117,50,21,29,0,12,7,5,52,51,0,1,0,3
"2011","E00018934","E00018934","Total",150,60,26,34,0,10,3,7,79,76,0,3,0,1
"2011","E00018935","E00018935","Total",165,72,36,36,0,16,8,8,76,74,0,2,0,1
"2011","E00018951","E00018951","Total",137,68,31,37,0,14,3,11,52,52,0,0,0,3
"2011","E00018945","E00018945","Total",138,90,46,44,1,3,2,1,41,38,0,3,0,3
"2011","E00018946","E00018946","Total",132,106,57,49,0,3,1,2,22,18,0,3,1,1
"2011","E00018947","E00018947","Total",124,86,35,51,1,1,0,1,32,29,0,3,0,4
"2011","E00018955","E00018955","Total",130,83,39,44,0,2,0,2,42,40,0,2,0,3
"2011","E00019007","E00019007","Total",107,44,22,22,0,0,0,0,61,59,0,2,0,2
"2011","E00019011","E00019011","Total",148,94,49,45,1,10,1,9,40,38,0,2,0,3
"2011","E00019013","E00019013","Total",106,22,16,6,0,24,2,22,57,54,0,2,1,3
"2011","E00019031","E00019031","Total",120,65,26,39,0,3,3,0,52,51,0,1,0,0
"2011","E00019034","E00019034","Total",121,74,41,33,1,6,1,5,40,38,0,2,0,0
"2011","E00019009","E00019009","Total",157,58,28,30,2,13,5,8,81,78,0,2,1,3
"2011","E00019010","E00019010","Total",110,49,28,21,0,5,3,2,53,48,0,4,1,3
"2011","E00019016","E00019016","Total",128,68,32,36,2,6,1,5,50,48,0,2,0,2
"2011","E00019039","E00019039","Total",123,65,36,29,0,11,6,5,45,43,0,2,0,2
"2011","E00019026","E00019026","Total",106,86,26,60,0,1,0,1,19,19,0,0,0,0
"2011","E00019027","E00019027","Total",115,90,48,42,0,3,2,1,19,17,0,1,1,3
"2011","E00019028","E00019028","Total",125,96,40,56,0,7,5,2,20,19,0,1,0,2
"2011","E00019029","E00019029","Total",96,66,27,39,0,3,0,3,27,26,0,1,0,0
"2011","E00019032","E00019032","Total",125,81,47,34,1,3,3,0,38,37,0,1,0,2
"2011","E00019033","E00019033","Total",107,74,40,34,0,2,1,1,30,29,0,0,1,1
"2011","E00019035","E00019035","Total",109,75,38,37,0,3,1,2,30,28,1,0,1,1
"2011","E00019037","E00019037","Total",128,82,38,44,2,9,8,1,32,29,1,2,0,3
"2011","E00019047","E00019047","Total",140,60,24,36,3,49,33,16,27,25,0,2,0,1
"2011","E00019049","E00019049","Total",123,108,57,51,0,7,1,6,7,6,1,0,0,1
"2011","E00019050","E00019050","Total",117,106,45,61,0,1,0,1,10,10,0,0,0,0
"2011","E00019054","E00019054","Total",177,90,38,52,3,60,21,39,22,18,0,2,2,2
"2011","E00019044","E00019044","Total",122,82,37,45,0,13,12,1,23,23,0,0,0,4
"2011","E00019046","E00019046","Total",159,152,92,60,0,2,0,2,5,4,0,1,0,0
"2011","E00019052","E00019052","Total",149,135,71,64,1,1,0,1,10,8,1,1,0,2
"2011","E00019056","E00019056","Total",110,105,55,50,0,1,1,0,4,4,0,0,0,0
"2011","E00019055","E00019055","Total",122,106,43,63,0,1,1,0,15,15,0,0,0,0
"2011","E00019058","E00019058","Total",125,115,48,67,0,5,1,4,5,5,0,0,0,0
"2011","E00019059","E00019059","Total",139,113,47,66,0,1,1,0,22,22,0,0,0,3
"2011","E00019061","E00019061","Total",122,87,37,50,0,12,2,10,22,20,0,0,2,1
"2011","E00019045","E00019045","Total",113,12,6,6,1,89,87,2,10,9,0,1,0,1
"2011","E00019048","E00019048","Total",110,71,31,40,0,2,2,0,35,31,0,4,0,2
"2011","E00019051","E00019051","Total",145,117,51,66,0,4,0,4,22,20,0,2,0,2
"2011","E00019053","E00019053","Total",117,70,22,48,0,7,5,2,38,34,0,4,0,2
"2011","E00019057","E00019057","Total",139,56,23,33,1,54,49,5,28,28,0,0,0,0
"2011","E00019060","E00019060","Total",136,50,15,35,0,74,38,36,12,11,0,1,0,0
"2011","E00019006","E00019006","Total",177,91,60,31,1,18,3,15,61,58,0,2,1,6
"2011","E00019018","E00019018","Total",106,55,27,28,0,5,2,3,43,41,0,2,0,3
"2011","E00019022","E00019022","Total",150,23,5,18,2,20,5,15,104,104,0,0,0,1
"2011","E00019025","E00019025","Total",137,24,9,15,0,22,6,16,90,88,2,0,0,1
"2011","E00175156","E00175156","Total",130,15,6,9,4,63,41,22,48,48,0,0,0,0
"2011","E00175171","E00175171","Total",158,46,23,23,3,32,27,5,75,74,0,1,0,2
"2011","E00019005","E00019005","Total",166,81,27,54,1,18,10,8,64,62,0,2,0,2
"2011","E00019015","E00019015","Total",114,81,31,50,1,4,3,1,25,24,0,1,0,3
"2011","E00019017","E00019017","Total",129,74,31,43,1,11,6,5,41,41,0,0,0,2
"2011","E00019024","E00019024","Total",137,87,36,51,0,7,4,3,41,41,0,0,0,2
"2011","E00019004","E00019004","Total",142,55,25,30,0,12,4,8,73,71,1,1,0,2
"2011","E00019014","E00019014","Total",132,41,13,28,0,17,11,6,74,72,0,2,0,0
"2011","E00019019","E00019019","Total",152,52,24,28,0,21,13,8,77,76,0,1,0,2
"2011","E00019020","E00019020","Total",168,56,25,31,0,10,4,6,93,92,0,1,0,9
"2011","E00019023","E00019023","Total",110,41,15,26,0,6,3,3,62,60,0,2,0,1
"2011","E00019008","E00019008","Total",120,35,15,20,0,14,4,10,69,66,0,2,1,2
"2011","E00019012","E00019012","Total",132,39,19,20,1,4,2,2,87,86,0,1,0,1
"2011","E00019030","E00019030","Total",124,43,18,25,0,11,8,3,70,67,0,2,1,0
"2011","E00019036","E00019036","Total",133,46,25,21,0,20,19,1,65,63,0,2,0,2
"2011","E00019038","E00019038","Total",136,69,36,33,0,3,1,2,63,63,0,0,0,1
"2011","E00018557","E00018557","Total",109,69,30,39,2,7,5,2,30,29,0,0,1,1
"2011","E00018561","E00018561","Total",118,63,31,32,2,12,9,3,39,37,1,1,0,2
"2011","E00018564","E00018564","Total",105,54,19,35,0,6,3,3,45,43,1,1,0,0
"2011","E00018565","E00018565","Total",128,66,26,40,1,9,3,6,50,50,0,0,0,2
"2011","E00018567","E00018567","Total",116,67,26,41,0,8,3,5,40,39,0,1,0,1
"2011","E00018566","E00018566","Total",120,59,27,32,2,20,9,11,38,37,0,1,0,1
"2011","E00018568","E00018568","Total",120,82,40,42,0,13,10,3,23,20,0,3,0,2
"2011","E00018570","E00018570","Total",123,76,30,46,0,11,5,6,35,32,0,3,0,1
"2011","E00018571","E00018571","Total",133,89,39,50,1,5,2,3,37,36,0,1,0,1
"2011","E00018559","E00018559","Total",122,73,36,37,0,4,3,1,42,39,0,2,1,3
"2011","E00018562","E00018562","Total",145,70,27,43,0,9,7,2,63,61,0,2,0,3
"2011","E00018563","E00018563","Total",112,66,31,35,0,8,4,4,37,36,0,1,0,1
"2011","E00018569","E00018569","Total",129,73,37,36,0,6,3,3,45,45,0,0,0,5
"2011","E00018548","E00018548","Total",147,61,31,30,0,20,9,11,66,64,0,2,0,0
"2011","E00018551","E00018551","Total",119,81,37,44,1,5,2,3,30,28,0,1,1,2
"2011","E00018553","E00018553","Total",136,65,31,34,0,7,4,3,62,61,0,1,0,2
"2011","E00018555","E00018555","Total",131,78,31,47,0,11,6,5,39,35,0,4,0,3
"2011","E00018549","E00018549","Total",136,42,21,21,7,19,19,0,66,63,0,1,2,2
"2011","E00018550","E00018550","Total",147,82,41,41,0,16,9,7,48,45,0,2,1,1
"2011","E00018552","E00018552","Total",121,78,41,37,0,7,6,1,31,30,0,1,0,5
"2011","E00018556","E00018556","Total",128,53,28,25,14,13,8,5,47,44,0,2,1,1
"2011","E00018544","E00018544","Total",140,19,4,15,0,59,55,4,61,59,0,2,0,1
"2011","E00018554","E00018554","Total",122,86,47,39,0,6,4,2,26,22,0,3,1,4
"2011","E00018558","E00018558","Total",127,68,30,38,0,10,7,3,48,46,0,2,0,1
"2011","E00018560","E00018560","Total",119,61,28,33,2,11,9,2,45,45,0,0,0,0
"2011","E00175132","E00175132","Total",116,12,4,8,1,29,17,12,72,70,1,0,1,2
"2011","E00175133","E00175133","Total",121,15,7,8,2,29,9,20,71,66,0,3,2,4
"2011","E00175134","E00175134","Total",158,20,2,18,0,6,3,3,132,125,1,6,0,0
"2011","E00175137","E00175137","Total",149,19,6,13,9,4,1,3,117,116,0,1,0,0
"2011","E00175140","E00175140","Total",116,12,4,8,27,15,3,12,62,57,0,3,2,0
"2011","E00018543","E00018543","Total",161,53,19,34,0,29,22,7,77,72,1,3,1,2
"2011","E00018545","E00018545","Total",151,79,25,54,1,16,8,8,51,49,0,1,1,4
"2011","E00018546","E00018546","Total",160,66,30,36,0,21,10,11,71,68,0,3,0,2
"2011","E00018572","E00018572","Total",158,56,25,31,1,26,10,16,74,72,0,1,1,1
"2011","E00018805","E00018805","Total",103,48,21,27,0,26,18,8,26,25,0,0,1,3
"2011","E00018808","E00018808","Total",126,115,61,54,0,2,0,2,9,8,0,0,1,0
"2011","E00018811","E00018811","Total",130,118,61,57,0,2,1,1,10,10,0,0,0,0
"2011","E00018815","E00018815","Total",114,71,33,38,0,30,4,26,12,11,0,0,1,1
"2011","E00018820","E00018820","Total",102,93,55,38,0,0,0,0,9,8,0,1,0,0
"2011","E00018790","E00018790","Total",126,104,40,64,1,1,1,0,19,18,0,0,1,1
"2011","E00018791","E00018791","Total",132,94,43,51,0,3,3,0,33,28,0,4,1,2
"2011","E00018795","E00018795","Total",127,112,46,66,0,1,1,0,14,13,0,1,0,0
"2011","E00018797","E00018797","Total",128,105,52,53,0,4,3,1,16,12,0,4,0,3
"2011","E00018798","E00018798","Total",133,106,43,63,0,8,3,5,18,15,0,3,0,1
"2011","E00018792","E00018792","Total",122,104,39,65,0,2,1,1,16,16,0,0,0,0
"2011","E00018796","E00018796","Total",165,109,37,72,10,9,3,6,37,33,0,3,1,0
"2011","E00018803","E00018803","Total",118,103,57,46,1,1,1,0,13,13,0,0,0,0
"2011","E00175131","E00175131","Total",126,56,3,53,19,39,3,36,9,8,1,0,0,3
"2011","E00175150","E00175150","Total",127,86,27,59,4,9,6,3,28,25,0,2,1,0
"2011","E00018789","E00018789","Total",125,90,32,58,2,5,4,1,28,27,0,1,0,0
"2011","E00018793","E00018793","Total",119,101,42,59,0,3,1,2,14,12,0,2,0,1
"2011","E00018812","E00018812","Total",121,71,34,37,0,30,27,3,19,19,0,0,0,1
"2011","E00018814","E00018814","Total",125,101,39,62,1,4,2,2,19,19,0,0,0,0
"2011","E00018819","E00018819","Total",131,108,54,54,0,12,1,11,7,6,0,1,0,4
"2011","E00018799","E00018799","Total",136,118,49,69,0,2,0,2,16,15,0,1,0,0
"2011","E00018800","E00018800","Total",117,98,44,54,0,3,0,3,16,15,0,0,1,0
"2011","E00018801","E00018801","Total",123,77,33,44,0,28,28,0,18,18,0,0,0,0
"2011","E00018802","E00018802","Total",125,107,53,54,0,3,1,2,14,14,0,0,0,1
"2011","E00018804","E00018804","Total",142,70,57,13,0,43,35,8,26,25,0,1,0,3
"2011","E00018806","E00018806","Total",136,47,14,33,1,12,8,4,74,72,0,1,1,2
"2011","E00018807","E00018807","Total",125,68,19,49,0,5,3,2,52,48,0,3,1,0
"2011","E00018809","E00018809","Total",116,73,21,52,0,6,2,4,37,31,0,2,4,0
"2011","E00018810","E00018810","Total",126,96,35,61,0,7,6,1,23,22,0,1,0,0
"2011","E00018816","E00018816","Total",115,84,32,52,2,3,0,3,23,23,0,0,0,3
"2011","E00018813","E00018813","Total",114,66,21,45,1,7,1,6,35,34,1,0,0,5
"2011","E00018817","E00018817","Total",133,88,39,49,0,2,0,2,40,40,0,0,0,3
"2011","E00018818","E00018818","Total",128,87,31,56,0,7,5,2,32,29,0,3,0,2
"2011","E00018821","E00018821","Total",121,76,35,41,1,6,5,1,37,33,0,4,0,1
"2011","E00018784","E00018784","Total",126,65,29,36,2,6,2,4,52,51,0,1,0,1
"2011","E00018786","E00018786","Total",131,77,35,42,1,6,4,2,46,42,0,4,0,1
"2011","E00175144","E00175144","Total",129,59,23,36,0,11,6,5,56,55,0,1,0,3
"2011","E00175154","E00175154","Total",204,11,2,9,47,126,7,119,17,16,0,0,1,3
"2011","E00175157","E00175157","Total",146,7,3,4,6,13,3,10,118,116,0,2,0,2
"2011","E00175158","E00175158","Total",74,40,30,10,2,7,5,2,23,22,0,1,0,2
"2011","E00018753","E00018753","Total",150,67,29,38,0,21,13,8,60,56,0,2,2,2
"2011","E00018755","E00018755","Total",121,40,13,27,0,28,22,6,50,48,1,1,0,3
"2011","E00018762","E00018762","Total",130,73,39,34,0,11,6,5,46,45,0,1,0,0
"2011","E00018785","E00018785","Total",125,38,18,20,8,37,33,4,39,37,0,0,2,3
"2011","E00018754","E00018754","Total",109,72,37,35,0,4,2,2,32,29,0,2,1,1
"2011","E00018761","E00018761","Total",106,67,32,35,0,5,4,1,34,32,0,2,0,0
"2011","E00018787","E00018787","Total",78,47,19,28,0,5,3,2,26,26,0,0,0,0
"2011","E00018788","E00018788","Total",123,61,29,32,0,16,6,10,46,43,1,2,0,0
"2011","E00018752","E00018752","Total",122,21,5,16,2,65,28,37,30,27,0,1,2,4
"2011","E00018766","E00018766","Total",131,37,12,25,10,41,10,31,43,43,0,0,0,0
"2011","E00018770","E00018770","Total",134,12,2,10,1,69,11,58,51,49,0,0,2,1
"2011","E00018771","E00018771","Total",86,32,16,16,3,27,7,20,23,22,0,0,1,1
"2011","E00018780","E00018780","Total",119,21,3,18,0,23,10,13,67,65,0,2,0,8
"2011","E00018758","E00018758","Total",113,54,17,37,1,17,6,11,39,39,0,0,0,2
"2011","E00018759","E00018759","Total",117,62,20,42,1,8,4,4,45,42,0,3,0,1
"2011","E00018763","E00018763","Total",140,84,30,54,1,3,2,1,50,47,0,1,2,2
"2011","E00018765","E00018765","Total",137,90,36,54,2,10,5,5,33,32,0,0,1,2
"2011","E00018756","E00018756","Total",120,74,30,44,1,7,4,3,38,34,2,1,1,0
"2011","E00018757","E00018757","Total",77,18,11,7,0,42,36,6,12,12,0,0,0,5
"2011","E00018760","E00018760","Total",120,41,19,22,0,22,6,16,56,54,1,1,0,1
"2011","E00018764","E00018764","Total",130,96,36,60,0,5,1,4,27,23,1,3,0,2
"2011","E00018767","E00018767","Total",137,88,41,47,0,9,8,1,37,33,0,3,1,3
"2011","E00018769","E00018769","Total",119,58,23,35,0,12,7,5,49,44,0,4,1,0
"2011","E00018775","E00018775","Total",130,83,32,51,0,8,8,0,38,34,0,3,1,1
"2011","E00018777","E00018777","Total",131,63,22,41,4,17,6,11,47,45,0,2,0,0
"2011","E00018768","E00018768","Total",109,28,12,16,1,57,32,25,15,14,0,1,0,8
"2011","E00018773","E00018773","Total",94,16,8,8,0,69,2,67,7,4,0,2,1,2
"2011","E00018774","E00018774","Total",120,41,31,10,0,38,7,31,41,37,0,3,1,0
"2011","E00018776","E00018776","Total",105,27,7,20,0,40,9,31,38,38,0,0,0,0
"2011","E00175151","E00175151","Total",130,19,6,13,11,84,20,64,16,15,0,0,1,0
"2011","E00175152","E00175152","Total",130,24,1,23,2,46,25,21,57,52,0,2,3,1
"2011","E00175153","E00175153","Total",123,25,2,23,0,63,27,36,34,34,0,0,0,1
"2011","E00018751","E00018751","Total",140,67,18,49,0,38,12,26,35,34,0,1,0,0
"2011","E00018778","E00018778","Total",100,50,16,34,0,15,8,7,35,33,1,1,0,0
"2011","E00018779","E00018779","Total",123,65,25,40,1,21,8,13,34,31,0,2,1,2
"2011","E00018781","E00018781","Total",112,76,27,49,0,9,3,6,25,23,0,2,0,2
"2011","E00018686","E00018686","Total",113,88,42,46,0,1,0,1,23,23,0,0,0,1
"2011","E00018689","E00018689","Total",116,77,39,38,0,7,5,2,30,30,0,0,0,2
"2011","E00018693","E00018693","Total",121,75,38,37,0,8,7,1,37,34,0,3,0,1
"2011","E00018695","E00018695","Total",131,97,39,58,1,4,3,1,26,23,1,2,0,3
"2011","E00018684","E00018684","Total",136,70,25,45,0,10,2,8,53,50,0,1,2,3
"2011","E00018688","E00018688","Total",134,86,44,42,3,7,3,4,38,37,0,1,0,0
"2011","E00018690","E00018690","Total",134,80,30,50,3,9,7,2,40,37,0,3,0,2
"2011","E00018691","E00018691","Total",114,76,39,37,0,5,1,4,31,30,0,1,0,2
"2011","E00018694","E00018694","Total",124,78,25,53,1,3,1,2,42,41,1,0,0,0
"2011","E00018683","E00018683","Total",108,71,31,40,1,1,1,0,32,31,0,1,0,3
"2011","E00018692","E00018692","Total",133,57,30,27,0,5,2,3,71,70,0,1,0,0
"2011","E00018696","E00018696","Total",88,52,24,28,0,3,2,1,30,28,0,2,0,3
"2011","E00018709","E00018709","Total",106,66,28,38,0,10,7,3,29,26,1,2,0,1
"2011","E00018710","E00018710","Total",129,79,37,42,1,8,4,4,39,37,0,2,0,2
"2011","E00018680","E00018680","Total",133,86,35,51,0,5,3,2,39,38,0,1,0,3
"2011","E00018685","E00018685","Total",128,85,30,55,0,4,3,1,37,35,0,2,0,2
"2011","E00018698","E00018698","Total",113,85,37,48,1,1,1,0,24,24,0,0,0,2
"2011","E00018699","E00018699","Total",147,64,25,39,0,59,32,27,23,21,0,0,2,1
"2011","E00018679","E00018679","Total",150,44,7,37,1,9,5,4,95,88,0,4,3,1
"2011","E00018703","E00018703","Total",121,54,12,42,1,12,5,7,54,54,0,0,0,0
"2011","E00018704","E00018704","Total",104,45,9,36,7,9,4,5,42,39,0,3,0,1
"2011","E00018705","E00018705","Total",116,88,41,47,1,5,3,2,21,20,0,1,0,1
"2011","E00018708","E00018708","Total",139,94,44,50,1,4,3,1,37,37,0,0,0,3
"2011","E00018681","E00018681","Total",121,84,46,38,0,0,0,0,37,35,0,2,0,0
"2011","E00018687","E00018687","Total",165,95,51,44,0,12,10,2,56,54,0,2,0,2
"2011","E00018697","E00018697","Total",106,75,33,42,0,6,5,1,23,22,0,1,0,2
"2011","E00018706","E00018706","Total",120,72,26,46,0,4,3,1,42,40,0,1,1,2
"2011","E00018707","E00018707","Total",121,22,11,11,0,10,7,3,86,80,1,4,1,3
"2011","E00018678","E00018678","Total",149,83,31,52,2,20,3,17,43,41,0,2,0,1
"2011","E00018700","E00018700","Total",143,71,18,53,7,25,12,13,39,32,0,7,0,1
"2011","E00018701","E00018701","Total",139,75,26,49,0,20,10,10,44,43,0,1,0,0
"2011","E00018702","E00018702","Total",153,83,29,54,3,21,8,13,45,43,0,1,1,1
"2011","E00165806","E00165806","Total",115,31,10,21,0,48,23,25,30,25,1,1,3,6
"2011","E00018578","E00018578","Total",104,93,47,46,0,3,0,3,8,8,0,0,0,0
"2011","E00018592","E00018592","Total",124,89,44,45,0,22,0,22,11,11,0,0,0,2
"2011","E00018598","E00018598","Total",117,69,37,32,1,13,0,13,32,29,0,2,1,2
"2011","E00175127","E00175127","Total",104,27,17,10,0,6,3,3,71,71,0,0,0,0
"2011","E00175138","E00175138","Total",159,38,12,26,1,6,1,5,113,112,1,0,0,1
"2011","E00018585","E00018585","Total",127,82,35,47,0,3,0,3,41,41,0,0,0,1
"2011","E00018586","E00018586","Total",105,84,33,51,0,1,0,1,16,16,0,0,0,4
"2011","E00018590","E00018590","Total",91,73,25,48,1,3,1,2,14,12,0,2,0,0
"2011","E00018591","E00018591","Total",90,56,19,37,0,9,4,5,24,24,0,0,0,1
"2011","E00018574","E00018574","Total",123,85,42,43,1,4,3,1,30,26,0,1,3,3
"2011","E00018577","E00018577","Total",125,77,34,43,1,5,4,1,40,38,0,1,1,2
"2011","E00018581","E00018581","Total",126,76,22,54,0,3,3,0,45,45,0,0,0,2
"2011","E00018603","E00018603","Total",127,108,51,57,0,2,1,1,16,16,0,0,0,1
"2011","E00018576","E00018576","Total",109,86,34,52,0,3,1,2,20,19,0,1,0,0
"2011","E00018580","E00018580","Total",113,98,49,49,0,1,1,0,13,12,0,1,0,1
"2011","E00018604","E00018604","Total",112,97,47,50,0,5,3,2,10,9,0,1,0,0
"2011","E00018605","E00018605","Total",97,79,41,38,0,1,0,1,17,16,0,1,0,0
"2011","E00018573","E00018573","Total",117,103,57,46,1,1,0,1,11,11,0,0,0,1
"2011","E00018575","E00018575","Total",116,93,43,50,0,2,0,2,19,15,1,2,1,2
"2011","E00018579","E00018579","Total",113,84,40,44,0,2,1,1,25,22,0,2,1,2
"2011","E00018584","E00018584","Total",102,48,28,20,0,41,1,40,13,12,0,1,0,0
"2011","E00018582","E00018582","Total",109,67,26,41,0,0,0,0,42,42,0,0,0,0
"2011","E00018583","E00018583","Total",105,49,23,26,0,6,6,0,49,48,0,0,1,1
"2011","E00018587","E00018587","Total",117,48,19,29,0,13,12,1,55,55,0,0,0,1
"2011","E00018588","E00018588","Total",110,60,34,26,0,3,3,0,41,41,0,0,0,6
"2011","E00018589","E00018589","Total",93,45,20,25,0,2,2,0,46,46,0,0,0,0
"2011","E00018594","E00018594","Total",114,88,52,36,0,13,0,13,10,10,0,0,0,3
"2011","E00018595","E00018595","Total",181,136,35,101,0,16,15,1,26,24,0,1,1,3
"2011","E00018597","E00018597","Total",145,123,48,75,0,1,1,0,20,18,0,2,0,1
"2011","E00018600","E00018600","Total",153,112,54,58,0,1,0,1,40,39,0,1,0,0
"2011","E00018596","E00018596","Total",114,84,30,54,0,2,0,2,26,23,0,3,0,2
"2011","E00018599","E00018599","Total",145,101,43,58,1,3,2,1,39,35,0,3,1,1
"2011","E00018601","E00018601","Total",123,115,46,69,0,0,0,0,7,7,0,0,0,1
"2011","E00018602","E00018602","Total",110,75,29,46,0,17,17,0,17,16,0,1,0,1
"2011","E00018510","E00018510","Total",124,84,46,38,0,9,8,1,29,27,0,2,0,2
"2011","E00018537","E00018537","Total",120,108,65,43,1,2,2,0,9,9,0,0,0,0
"2011","E00018538","E00018538","Total",127,106,44,62,4,3,0,3,14,11,0,3,0,0
"2011","E00018540","E00018540","Total",119,59,33,26,1,7,5,2,51,51,0,0,0,1
"2011","E00018511","E00018511","Total",123,111,52,59,0,0,0,0,11,10,0,1,0,1
"2011","E00018539","E00018539","Total",131,118,50,68,0,1,1,0,12,10,0,2,0,0
"2011","E00018541","E00018541","Total",110,62,27,35,0,26,26,0,19,17,0,2,0,3
"2011","E00018542","E00018542","Total",131,107,41,66,0,4,1,3,18,14,0,4,0,2
"2011","E00018526","E00018526","Total",125,111,60,51,0,1,1,0,11,11,0,0,0,2
"2011","E00018530","E00018530","Total",112,101,64,37,0,2,2,0,8,8,0,0,0,1
"2011","E00018534","E00018534","Total",130,117,62,55,0,0,0,0,10,9,0,1,0,3
"2011","E00018536","E00018536","Total",127,104,38,66,0,3,3,0,17,17,0,0,0,3
"2011","E00018518","E00018518","Total",109,76,36,40,0,10,10,0,22,20,0,2,0,1
"2011","E00018519","E00018519","Total",120,109,46,63,0,1,1,0,8,8,0,0,0,2
"2011","E00018520","E00018520","Total",135,117,39,78,0,7,7,0,6,4,0,2,0,5
"2011","E00018521","E00018521","Total",115,101,47,54,0,2,1,1,12,10,0,2,0,0
"2011","E00018512","E00018512","Total",127,116,46,70,0,0,0,0,9,9,0,0,0,2
"2011","E00018513","E00018513","Total",121,113,52,61,0,1,1,0,6,6,0,0,0,1
"2011","E00018514","E00018514","Total",125,111,55,56,0,2,0,2,11,10,0,1,0,1
"2011","E00018517","E00018517","Total",120,113,52,61,0,0,0,0,5,3,0,1,1,2
"2011","E00018516","E00018516","Total",122,105,38,67,0,0,0,0,17,16,0,1,0,0
"2011","E00018522","E00018522","Total",117,112,43,69,1,0,0,0,4,4,0,0,0,0
"2011","E00018523","E00018523","Total",119,99,41,58,0,2,1,1,18,17,0,1,0,0
"2011","E00018524","E00018524","Total",117,106,42,64,0,1,1,0,10,10,0,0,0,0
"2011","E00018515","E00018515","Total",203,79,44,35,0,79,21,58,40,32,0,8,0,5
"2011","E00018525","E00018525","Total",108,36,23,13,0,11,6,5,59,58,0,1,0,2
"2011","E00018527","E00018527","Total",124,114,51,63,0,1,1,0,6,6,0,0,0,3
"2011","E00018528","E00018528","Total",110,85,26,59,0,17,17,0,8,7,0,1,0,0
"2011","E00018532","E00018532","Total",138,105,45,60,2,1,1,0,27,26,0,1,0,3
"2011","E00018529","E00018529","Total",139,117,52,65,0,4,3,1,17,15,0,1,1,1
"2011","E00018531","E00018531","Total",114,103,39,64,0,1,0,1,8,7,0,0,1,2
"2011","E00018533","E00018533","Total",126,111,53,58,0,0,0,0,15,15,0,0,0,0
"2011","E00018535","E00018535","Total",114,97,49,48,0,1,1,0,15,12,0,3,0,1
"2011","E00019096","E00019096","Total",148,107,63,44,0,20,1,19,18,15,1,1,1,3
"2011","E00019097","E00019097","Total",129,97,59,38,0,13,1,12,19,19,0,0,0,0
"2011","E00019099","E00019099","Total",125,101,64,37,0,16,0,16,8,8,0,0,0,0
"2011","E00019100","E00019100","Total",121,111,61,50,0,2,2,0,8,8,0,0,0,0
"2011","E00019093","E00019093","Total",112,18,13,5,2,80,6,74,11,10,0,0,1,1
"2011","E00019098","E00019098","Total",127,112,69,43,0,3,0,3,12,12,0,0,0,0
"2011","E00019102","E00019102","Total",144,88,56,32,0,12,0,12,42,41,0,1,0,2
"2011","E00019103","E00019103","Total",169,94,55,39,1,22,4,18,50,46,1,2,1,2
"2011","E00019105","E00019105","Total",139,86,37,49,0,12,0,12,37,33,1,3,0,4
"2011","E00019092","E00019092","Total",120,43,21,22,1,19,14,5,54,53,0,0,1,3
"2011","E00019101","E00019101","Total",127,82,46,36,0,1,0,1,42,42,0,0,0,2
"2011","E00019104","E00019104","Total",159,80,31,49,0,13,8,5,65,63,0,2,0,1
"2011","E00019106","E00019106","Total",121,98,49,49,0,1,1,0,19,19,0,0,0,3
"2011","E00019107","E00019107","Total",126,109,56,53,0,3,0,3,13,12,1,0,0,1
"2011","E00019087","E00019087","Total",148,97,60,37,0,11,1,10,37,36,1,0,0,3
"2011","E00019088","E00019088","Total",117,52,31,21,1,43,16,27,20,18,1,1,0,1
"2011","E00019090","E00019090","Total",115,49,27,22,1,53,17,36,11,11,0,0,0,1
"2011","E00019094","E00019094","Total",136,78,43,35,0,18,7,11,38,37,0,1,0,2
"2011","E00019095","E00019095","Total",124,68,42,26,0,41,9,32,13,13,0,0,0,2
"2011","E00019078","E00019078","Total",154,84,51,33,0,8,2,6,60,53,2,5,0,2
"2011","E00019081","E00019081","Total",125,77,38,39,0,2,0,2,43,42,0,1,0,3
"2011","E00019108","E00019108","Total",129,95,54,41,2,2,1,1,28,20,5,3,0,2
"2011","E00019109","E00019109","Total",126,86,40,46,0,1,0,1,37,37,0,0,0,2
"2011","E00019079","E00019079","Total",128,66,26,40,0,2,2,0,58,53,0,5,0,2
"2011","E00019083","E00019083","Total",137,89,53,36,1,20,3,17,26,26,0,0,0,1
"2011","E00019084","E00019084","Total",120,70,39,31,2,3,1,2,41,39,1,0,1,4
"2011","E00019089","E00019089","Total",115,76,48,28,1,2,0,2,32,31,1,0,0,4
"2011","E00019091","E00019091","Total",123,64,39,25,0,3,2,1,54,52,0,2,0,2
"2011","E00019077","E00019077","Total",131,51,28,23,0,54,16,38,22,21,1,0,0,4
"2011","E00019080","E00019080","Total",125,30,16,14,0,79,32,47,12,12,0,0,0,4
"2011","E00019082","E00019082","Total",135,36,17,19,0,85,30,55,12,11,0,1,0,2
"2011","E00019085","E00019085","Total",112,39,22,17,0,54,23,31,16,16,0,0,0,3
"2011","E00019086","E00019086","Total",129,37,12,25,0,73,31,42,17,15,0,1,1,2
"2011","E00019342","E00019342","Total",122,100,50,50,1,3,0,3,18,17,0,1,0,0
"2011","E00019344","E00019344","Total",123,94,49,45,0,4,0,4,24,24,0,0,0,1
"2011","E00019346","E00019346","Total",126,98,51,47,0,0,0,0,28,28,0,0,0,0
"2011","E00019349","E00019349","Total",129,111,56,55,0,0,0,0,16,16,0,0,0,2
"2011","E00019354","E00019354","Total",128,102,58,44,0,7,3,4,17,17,0,0,0,2
"2011","E00019343","E00019343","Total",113,63,44,19,2,12,0,12,34,33,0,1,0,2
"2011","E00019345","E00019345","Total",150,63,33,30,1,23,5,18,62,59,0,2,1,1
"2011","E00019348","E00019348","Total",117,61,39,22,1,0,0,0,52,48,0,4,0,3
"2011","E00019350","E00019350","Total",92,32,15,17,0,3,1,2,56,53,1,2,0,1
"2011","E00019352","E00019352","Total",126,65,28,37,0,1,0,1,59,59,0,0,0,1
"2011","E00019365","E00019365","Total",122,74,44,30,1,3,0,3,42,33,7,1,1,2
"2011","E00019369","E00019369","Total",122,68,47,21,1,0,0,0,51,50,0,1,0,2
"2011","E00019351","E00019351","Total",133,84,48,36,0,16,1,15,33,32,0,1,0,0
"2011","E00019353","E00019353","Total",124,85,41,44,0,6,0,6,31,30,0,1,0,2
"2011","E00019355","E00019355","Total",129,99,56,43,1,6,0,6,23,23,0,0,0,0
"2011","E00019358","E00019358","Total",140,113,67,46,0,5,1,4,22,22,0,0,0,0
"2011","E00019360","E00019360","Total",127,91,39,52,0,11,3,8,23,20,0,3,0,2
"2011","E00019340","E00019340","Total",125,102,57,45,1,0,0,0,22,22,0,0,0,0
"2011","E00019341","E00019341","Total",115,68,37,31,0,4,0,4,41,41,0,0,0,2
"2011","E00019364","E00019364","Total",129,93,57,36,0,0,0,0,35,35,0,0,0,1
"2011","E00019366","E00019366","Total",110,74,44,30,0,2,0,2,31,31,0,0,0,3
"2011","E00019367","E00019367","Total",106,90,44,46,0,2,0,2,13,13,0,0,0,1
"2011","E00019368","E00019368","Total",106,81,41,40,0,1,0,1,24,22,0,2,0,0
"2011","E00019417","E00019417","Total",124,60,30,30,0,18,1,17,45,45,0,0,0,1
"2011","E00019420","E00019420","Total",122,90,40,50,0,4,0,4,24,24,0,0,0,4
"2011","E00019423","E00019423","Total",138,108,55,53,0,5,1,4,25,25,0,0,0,0
"2011","E00019425","E00019425","Total",125,40,20,20,0,53,2,51,30,28,1,1,0,2
"2011","E00019432","E00019432","Total",164,61,23,38,0,2,0,2,94,86,2,5,1,7
"2011","E00019435","E00019435","Total",146,54,23,31,0,16,2,14,74,71,0,2,1,2
"2011","E00019413","E00019413","Total",118,81,55,26,1,3,1,2,33,32,0,1,0,0
"2011","E00019416","E00019416","Total",168,72,39,33,0,48,16,32,47,46,0,1,0,1
"2011","E00019441","E00019441","Total",120,77,49,28,0,0,0,0,40,40,0,0,0,3
"2011","E00019442","E00019442","Total",121,79,42,37,1,12,4,8,29,27,2,0,0,0
"2011","E00019443","E00019443","Total",144,115,62,53,0,1,0,1,28,28,0,0,0,0
"2011","E00019392","E00019392","Total",104,86,42,44,1,6,1,5,11,9,0,2,0,0
"2011","E00019396","E00019396","Total",128,76,42,34,1,1,0,1,48,46,0,2,0,2
"2011","E00019397","E00019397","Total",140,73,43,30,0,4,2,2,60,56,0,3,1,3
"2011","E00019398","E00019398","Total",133,69,37,32,0,45,9,36,17,15,0,2,0,2
"2011","E00019404","E00019404","Total",147,76,39,37,0,32,3,29,34,34,0,0,0,5
"2011","E00019372","E00019372","Total",129,93,50,43,0,23,5,18,10,8,0,2,0,3
"2011","E00019374","E00019374","Total",133,106,66,40,0,2,0,2,23,22,0,0,1,2
"2011","E00019387","E00019387","Total",112,50,29,21,1,44,11,33,16,16,0,0,0,1
"2011","E00019391","E00019391","Total",118,39,7,32,2,65,20,45,11,10,0,1,0,1
"2011","E00019400","E00019400","Total",130,100,64,36,0,4,0,4,23,22,0,1,0,3
"2011","E00019399","E00019399","Total",142,50,27,23,1,41,16,25,47,43,1,3,0,3
"2011","E00019401","E00019401","Total",128,77,34,43,1,18,9,9,32,30,0,2,0,0
"2011","E00019402","E00019402","Total",141,91,55,36,0,29,16,13,21,21,0,0,0,0
"2011","E00019403","E00019403","Total",119,79,45,34,0,2,0,2,35,33,0,1,1,3
"2011","E00019406","E00019406","Total",123,94,48,46,0,1,0,1,27,27,0,0,0,1
"2011","E00019376","E00019376","Total",127,70,24,46,1,10,5,5,44,39,0,5,0,2
"2011","E00019381","E00019381","Total",125,31,10,21,0,80,29,51,12,11,0,1,0,2
"2011","E00019384","E00019384","Total",122,11,1,10,0,95,15,80,13,12,0,1,0,3
"2011","E00019385","E00019385","Total",164,94,51,43,0,18,4,14,51,50,0,1,0,1
"2011","E00019388","E00019388","Total",118,52,25,27,0,41,5,36,24,21,0,2,1,1
"2011","E00019407","E00019407","Total",175,83,33,50,6,31,5,26,54,52,0,2,0,1
"2011","E00019378","E00019378","Total",124,59,14,45,0,7,2,5,57,56,0,1,0,1
"2011","E00019379","E00019379","Total",103,66,21,45,0,2,0,2,35,31,0,4,0,0
"2011","E00019380","E00019380","Total",137,77,22,55,0,2,0,2,58,54,1,3,0,0
"2011","E00019382","E00019382","Total",131,82,30,52,0,10,5,5,37,35,1,0,1,2
"2011","E00019383","E00019383","Total",142,56,20,36,0,45,15,30,40,37,0,3,0,1
"2011","E00019390","E00019390","Total",112,60,24,36,8,25,7,18,18,15,0,3,0,1
"2011","E00019370","E00019370","Total",113,83,42,41,0,0,0,0,28,25,0,2,1,2
"2011","E00019377","E00019377","Total",137,100,41,59,0,4,2,2,29,27,0,1,1,4
"2011","E00019389","E00019389","Total",124,94,39,55,0,3,0,3,27,23,1,2,1,0
"2011","E00019393","E00019393","Total",122,52,20,32,1,36,9,27,32,28,0,3,1,1
"2011","E00019394","E00019394","Total",129,81,39,42,0,4,1,3,44,41,0,3,0,0
"2011","E00019405","E00019405","Total",131,72,29,43,1,28,8,20,28,26,0,2,0,2
"2011","E00019371","E00019371","Total",120,92,40,52,0,1,0,1,26,25,0,1,0,1
"2011","E00019373","E00019373","Total",142,101,38,63,1,1,1,0,39,38,0,1,0,0
"2011","E00019375","E00019375","Total",140,114,40,74,1,1,0,1,23,21,0,2,0,1
"2011","E00019386","E00019386","Total",128,82,40,42,0,1,0,1,44,43,0,0,1,1
"2011","E00019395","E00019395","Total",148,99,37,62,0,28,7,21,21,19,0,2,0,0
"2011","E00019337","E00019337","Total",148,82,40,42,0,38,8,30,28,27,1,0,0,0
"2011","E00019338","E00019338","Total",146,84,23,61,1,13,5,8,47,46,0,0,1,1
"2011","E00019339","E00019339","Total",135,95,42,53,0,4,0,4,34,32,0,2,0,2
"2011","E00019359","E00019359","Total",129,82,28,54,1,10,1,9,35,33,1,1,0,1
"2011","E00019362","E00019362","Total",126,57,16,41,1,37,14,23,31,31,0,0,0,0
"2011","E00019363","E00019363","Total",133,68,24,44,0,4,0,4,61,60,0,1,0,0
"2011","E00019408","E00019408","Total",176,93,31,62,0,7,4,3,76,71,0,4,1,0
"2011","E00019410","E00019410","Total",131,66,17,49,0,5,1,4,59,56,0,2,1,1
"2011","E00019415","E00019415","Total",170,88,23,65,2,29,10,19,47,45,0,1,1,4
"2011","E00019422","E00019422","Total",137,78,39,39,0,37,1,36,21,21,0,0,0,1
"2011","E00019427","E00019427","Total",113,73,31,42,0,3,1,2,36,36,0,0,0,1
"2011","E00019433","E00019433","Total",128,52,16,36,13,19,9,10,40,37,0,3,0,4
"2011","E00019418","E00019418","Total",127,82,50,32,0,29,5,24,13,13,0,0,0,3
"2011","E00019419","E00019419","Total",116,60,33,27,0,23,1,22,31,28,1,2,0,2
"2011","E00019426","E00019426","Total",120,44,15,29,1,60,25,35,14,14,0,0,0,1
"2011","E00019434","E00019434","Total",118,88,52,36,0,4,0,4,24,23,1,0,0,2
"2011","E00019438","E00019438","Total",146,69,37,32,2,11,4,7,62,60,0,2,0,2
"2011","E00019409","E00019409","Total",132,55,19,36,1,56,16,40,17,15,1,1,0,3
"2011","E00019436","E00019436","Total",128,102,36,66,0,12,2,10,13,12,0,0,1,1
"2011","E00019437","E00019437","Total",124,43,20,23,0,58,3,55,14,9,0,0,5,9
"2011","E00019439","E00019439","Total",123,19,10,9,0,86,29,57,14,13,0,1,0,4
"2011","E00019440","E00019440","Total",132,69,32,37,1,27,1,26,35,35,0,0,0,0
"2011","E00019411","E00019411","Total",129,40,11,29,0,78,8,70,10,7,0,2,1,1
"2011","E00019412","E00019412","Total",126,101,54,47,1,5,0,5,16,14,1,1,0,3
"2011","E00019414","E00019414","Total",139,102,38,64,0,5,1,4,30,30,0,0,0,2
"2011","E00019421","E00019421","Total",135,72,32,40,1,35,10,25,25,24,1,0,0,2
"2011","E00174880","E00174880","Total",115,24,4,20,0,57,7,50,31,31,0,0,0,3
"2011","E00174881","E00174881","Total",117,27,4,23,37,13,3,10,38,35,0,3,0,2
"2011","E00174882","E00174882","Total",127,57,24,33,1,5,1,4,62,61,0,1,0,2
"2011","E00174883","E00174883","Total",118,44,15,29,2,6,1,5,65,62,2,1,0,1
"2011","E00174886","E00174886","Total",116,18,3,15,20,23,4,19,54,54,0,0,0,1
"2011","E00174888","E00174888","Total",116,68,26,42,0,11,4,7,34,34,0,0,0,3
"2011","E00019336","E00019336","Total",131,80,41,39,0,40,2,38,11,10,0,1,0,0
"2011","E00019347","E00019347","Total",100,26,7,19,0,46,11,35,23,20,0,3,0,5
"2011","E00019356","E00019356","Total",139,127,79,48,0,1,1,0,11,11,0,0,0,0
"2011","E00019361","E00019361","Total",141,70,30,40,0,59,14,45,10,9,1,0,0,2
"2011","E00174887","E00174887","Total",113,67,31,36,2,14,7,7,27,26,0,1,0,3
"2011","E00019111","E00019111","Total",123,93,39,54,0,13,6,7,15,13,0,2,0,2
"2011","E00019129","E00019129","Total",131,78,44,34,0,0,0,0,52,48,0,4,0,1
"2011","E00019130","E00019130","Total",131,89,37,52,0,7,1,6,33,33,0,0,0,2
"2011","E00019131","E00019131","Total",132,89,39,50,0,1,0,1,40,39,0,1,0,2
"2011","E00019132","E00019132","Total",128,68,40,28,0,28,1,27,29,28,1,0,0,3
"2011","E00019133","E00019133","Total",123,68,27,41,0,4,4,0,46,45,0,1,0,5
"2011","E00019113","E00019113","Total",145,51,23,28,0,48,10,38,42,40,0,2,0,4
"2011","E00019115","E00019115","Total",125,66,30,36,0,12,4,8,46,44,0,2,0,1
"2011","E00019116","E00019116","Total",124,96,47,49,0,6,0,6,22,19,0,3,0,0
"2011","E00019119","E00019119","Total",135,87,44,43,0,24,0,24,24,22,0,2,0,0
"2011","E00019125","E00019125","Total",134,57,21,36,0,13,0,13,60,60,0,0,0,4
"2011","E00019126","E00019126","Total",154,68,19,49,0,4,0,4,80,71,0,6,3,2
"2011","E00019114","E00019114","Total",141,69,25,44,0,52,22,30,18,16,0,2,0,2
"2011","E00019117","E00019117","Total",137,100,55,45,0,9,0,9,26,26,0,0,0,2
"2011","E00019118","E00019118","Total",136,118,55,63,0,1,0,1,16,15,0,1,0,1
"2011","E00019120","E00019120","Total",133,102,39,63,1,3,1,2,27,25,1,1,0,0
"2011","E00019121","E00019121","Total",136,99,40,59,0,6,3,3,30,29,0,1,0,1
"2011","E00019122","E00019122","Total",110,57,22,35,0,4,0,4,47,46,0,1,0,2
"2011","E00019110","E00019110","Total",129,114,71,43,0,8,0,8,5,5,0,0,0,2
"2011","E00019123","E00019123","Total",139,102,52,50,1,8,0,8,28,28,0,0,0,0
"2011","E00019124","E00019124","Total",121,105,53,52,0,6,6,0,10,9,0,1,0,0
"2011","E00019127","E00019127","Total",133,101,46,55,0,2,0,2,29,29,0,0,0,1
"2011","E00019128","E00019128","Total",135,98,40,58,0,15,1,14,22,22,0,0,0,0
"2011","E00019424","E00019424","Total",105,97,43,54,0,1,1,0,7,5,0,2,0,0
"2011","E00019428","E00019428","Total",129,74,27,47,1,16,0,16,37,33,1,3,0,1
"2011","E00019429","E00019429","Total",157,90,41,49,2,28,6,22,35,35,0,0,0,2
"2011","E00019430","E00019430","Total",130,110,49,61,0,4,3,1,15,14,0,1,0,1
"2011","E00019431","E00019431","Total",110,93,55,38,0,4,0,4,11,9,1,1,0,2
"2011","E00019479","E00019479","Total",153,63,45,18,0,25,0,25,63,59,1,2,1,2
"2011","E00019484","E00019484","Total",101,76,49,27,0,2,0,2,23,23,0,0,0,0
"2011","E00019505","E00019505","Total",114,68,27,41,0,3,0,3,41,40,0,0,1,2
"2011","E00019507","E00019507","Total",111,71,29,42,0,9,0,9,31,31,0,0,0,0
"2011","E00019512","E00019512","Total",142,66,38,28,0,5,0,5,67,65,0,2,0,4
"2011","E00019514","E00019514","Total",114,59,28,31,0,12,0,12,41,41,0,0,0,2
"2011","E00019516","E00019516","Total",115,41,14,27,0,31,2,29,42,41,0,1,0,1
"2011","E00019478","E00019478","Total",134,77,34,43,0,13,0,13,42,42,0,0,0,2
"2011","E00019483","E00019483","Total",134,61,32,29,1,4,1,3,68,64,0,4,0,0
"2011","E00019486","E00019486","Total",133,90,52,38,0,3,1,2,38,37,1,0,0,2
"2011","E00019509","E00019509","Total",144,60,23,37,0,11,0,11,71,69,0,0,2,2
"2011","E00019510","E00019510","Total",112,59,33,26,0,0,0,0,49,48,0,1,0,4
"2011","E00019513","E00019513","Total",130,73,37,36,0,21,1,20,36,34,0,1,1,0
"2011","E00019504","E00019504","Total",132,84,39,45,1,17,2,15,29,27,0,0,2,1
"2011","E00019506","E00019506","Total",122,114,79,35,0,1,0,1,7,7,0,0,0,0
"2011","E00019511","E00019511","Total",126,56,32,24,2,40,6,34,26,22,0,4,0,2
"2011","E00019515","E00019515","Total",144,97,62,35,0,1,0,1,45,44,0,1,0,1
"2011","E00019518","E00019518","Total",157,100,43,57,2,11,0,11,40,37,0,1,2,4
"2011","E00019480","E00019480","Total",133,15,6,9,0,108,5,103,9,9,0,0,0,1
"2011","E00019493","E00019493","Total",130,23,12,11,0,101,6,95,5,5,0,0,0,1
"2011","E00019495","E00019495","Total",131,76,39,37,0,6,2,4,49,46,1,2,0,0
"2011","E00019502","E00019502","Total",127,37,20,17,0,65,3,62,22,22,0,0,0,3
"2011","E00019503","E00019503","Total",127,23,4,19,1,94,3,91,9,8,1,0,0,0
"2011","E00019446","E00019446","Total",125,100,43,57,0,1,0,1,22,21,0,1,0,2
"2011","E00019449","E00019449","Total",147,121,49,72,0,2,0,2,22,20,0,2,0,2
"2011","E00019452","E00019452","Total",118,99,39,60,0,1,0,1,14,12,1,1,0,4
"2011","E00019457","E00019457","Total",135,85,37,48,0,2,0,2,48,48,0,0,0,0
"2011","E00019458","E00019458","Total",117,99,37,62,0,3,1,2,14,14,0,0,0,1
"2011","E00019459","E00019459","Total",147,78,24,54,0,2,1,1,65,65,0,0,0,2
"2011","E00019461","E00019461","Total",120,70,26,44,1,0,0,0,47,46,0,1,0,2
"2011","E00019462","E00019462","Total",141,84,28,56,0,6,2,4,47,45,0,2,0,4
"2011","E00019463","E00019463","Total",127,84,34,50,1,3,3,0,37,35,0,2,0,2
"2011","E00019468","E00019468","Total",104,92,38,54,0,2,0,2,9,8,0,1,0,1
"2011","E00019444","E00019444","Total",154,117,43,74,2,0,0,0,35,29,0,5,1,0
"2011","E00019474","E00019474","Total",250,124,63,61,20,52,0,52,50,48,0,2,0,4
"2011","E00019475","E00019475","Total",115,88,34,54,0,3,1,2,23,22,0,1,0,1
"2011","E00019477","E00019477","Total",123,105,46,59,0,2,0,2,14,14,0,0,0,2
"2011","E00019450","E00019450","Total",137,74,28,46,0,4,0,4,56,52,0,4,0,3
"2011","E00019451","E00019451","Total",127,73,32,41,2,5,0,5,46,45,0,1,0,1
"2011","E00019453","E00019453","Total",134,71,34,37,2,3,1,2,55,54,0,1,0,3
"2011","E00019454","E00019454","Total",147,80,33,47,1,13,1,12,52,48,0,4,0,1
"2011","E00019476","E00019476","Total",141,118,77,41,0,0,0,0,22,21,0,1,0,1
"2011","E00019175","E00019175","Total",129,49,17,32,1,15,1,14,62,59,1,2,0,2
"2011","E00019176","E00019176","Total",109,49,27,22,2,9,1,8,47,44,1,2,0,2
"2011","E00019193","E00019193","Total",133,67,40,27,0,8,3,5,57,53,1,2,1,1
"2011","E00019194","E00019194","Total",119,69,41,28,0,1,0,1,46,45,1,0,0,3
"2011","E00019195","E00019195","Total",158,61,31,30,0,20,1,19,74,68,1,4,1,3
"2011","E00019196","E00019196","Total",136,39,28,11,0,32,0,32,63,60,1,1,1,2
"2011","E00019485","E00019485","Total",153,64,27,37,0,16,1,15,71,67,3,1,0,2
"2011","E00019488","E00019488","Total",124,78,42,36,0,0,0,0,44,41,0,3,0,2
"2011","E00019489","E00019489","Total",112,58,37,21,0,9,3,6,41,35,1,1,4,4
"2011","E00019492","E00019492","Total",132,54,19,35,0,11,3,8,63,58,2,2,1,4
"2011","E00019494","E00019494","Total",114,37,19,18,0,2,1,1,71,68,1,2,0,4
"2011","E00019508","E00019508","Total",131,57,33,24,1,8,0,8,56,55,0,1,0,9
"2011","E00019517","E00019517","Total",99,69,54,15,0,3,0,3,21,17,1,2,1,6
"2011","E00019481","E00019481","Total",125,82,52,30,4,18,0,18,20,20,0,0,0,1
"2011","E00019487","E00019487","Total",111,73,44,29,2,3,0,3,32,30,0,2,0,1
"2011","E00019490","E00019490","Total",118,39,19,20,1,10,0,10,67,65,1,0,1,1
"2011","E00019491","E00019491","Total",122,69,44,25,0,16,0,16,34,33,0,0,1,3
"2011","E00019496","E00019496","Total",119,65,29,36,0,0,0,0,52,52,0,0,0,2
"2011","E00019497","E00019497","Total",129,82,47,35,0,16,0,16,29,28,0,1,0,2
"2011","E00019482","E00019482","Total",113,70,34,36,0,1,0,1,40,39,1,0,0,2
"2011","E00019498","E00019498","Total",108,57,31,26,2,10,0,10,37,37,0,0,0,2
"2011","E00019499","E00019499","Total",141,80,42,38,1,6,0,6,52,52,0,0,0,2
"2011","E00019500","E00019500","Total",138,91,63,28,1,0,0,0,46,45,0,1,0,0
"2011","E00019501","E00019501","Total",113,47,25,22,0,4,0,4,62,62,0,0,0,0
"2011","E00019588","E00019588","Total",129,85,57,28,0,3,0,3,41,41,0,0,0,0
"2011","E00019589","E00019589","Total",129,79,41,38,1,1,0,1,46,46,0,0,0,2
"2011","E00019592","E00019592","Total",146,85,46,39,0,4,0,4,56,56,0,0,0,1
"2011","E00019609","E00019609","Total",129,59,28,31,0,5,1,4,62,61,0,1,0,3
"2011","E00019614","E00019614","Total",134,86,38,48,0,3,0,3,44,44,0,0,0,1
"2011","E00019616","E00019616","Total",126,75,53,22,0,0,0,0,49,48,1,0,0,2
"2011","E00019617","E00019617","Total",131,102,50,52,0,2,1,1,26,23,1,2,0,1
"2011","E00019586","E00019586","Total",137,81,42,39,1,1,0,1,52,52,0,0,0,2
"2011","E00019608","E00019608","Total",122,74,48,26,1,22,0,22,21,20,0,0,1,4
"2011","E00019610","E00019610","Total",129,60,34,26,0,13,1,12,49,48,0,1,0,7
"2011","E00019612","E00019612","Total",137,61,23,38,1,1,0,1,74,69,0,4,1,0
"2011","E00019613","E00019613","Total",119,78,34,44,0,1,0,1,37,35,1,1,0,3
"2011","E00019615","E00019615","Total",115,57,20,37,0,0,0,0,57,56,0,1,0,1
"2011","E00019587","E00019587","Total",132,69,29,40,0,18,1,17,42,40,0,2,0,3
"2011","E00019591","E00019591","Total",121,95,46,49,0,1,0,1,25,24,0,1,0,0
"2011","E00019611","E00019611","Total",152,81,31,50,0,7,0,7,63,61,0,2,0,1
"2011","E00019618","E00019618","Total",124,53,16,37,0,11,3,8,58,58,0,0,0,2
"2011","E00019619","E00019619","Total",118,67,18,49,0,0,0,0,49,48,0,1,0,2
"2011","E00019621","E00019621","Total",113,70,32,38,2,3,0,3,34,31,0,2,1,4
"2011","E00019590","E00019590","Total",125,81,41,40,0,0,0,0,41,38,2,1,0,3
"2011","E00019593","E00019593","Total",121,66,27,39,0,30,7,23,24,23,0,1,0,1
"2011","E00019594","E00019594","Total",143,113,55,58,0,9,4,5,18,14,0,3,1,3
"2011","E00019595","E00019595","Total",134,77,25,52,0,12,2,10,44,42,0,1,1,1
"2011","E00019596","E00019596","Total",114,48,21,27,0,33,8,25,32,30,1,0,1,1
"2011","E00019620","E00019620","Total",129,85,20,65,0,3,0,3,40,40,0,0,0,1
"2011","E00019660","E00019660","Total",140,112,54,58,1,6,1,5,20,18,1,1,0,1
"2011","E00019662","E00019662","Total",139,70,27,43,1,2,0,2,65,29,20,1,15,1
"2011","E00019677","E00019677","Total",136,111,50,61,0,4,2,2,20,20,0,0,0,1
"2011","E00019684","E00019684","Total",133,110,49,61,0,6,2,4,17,16,0,1,0,0
"2011","E00019656","E00019656","Total",134,84,31,53,0,13,5,8,36,34,0,2,0,1
"2011","E00019659","E00019659","Total",130,99,46,53,0,5,1,4,25,24,1,0,0,1
"2011","E00019678","E00019678","Total",113,85,30,55,0,8,3,5,19,17,0,2,0,1
"2011","E00019681","E00019681","Total",135,100,43,57,0,7,3,4,27,26,0,1,0,1
"2011","E00019683","E00019683","Total",137,98,41,57,0,22,4,18,15,15,0,0,0,2
"2011","E00019658","E00019658","Total",128,45,16,29,2,67,18,49,9,8,0,0,1,5
"2011","E00019661","E00019661","Total",130,97,57,40,0,13,4,9,20,19,0,0,1,0
"2011","E00019664","E00019664","Total",157,60,20,40,16,54,23,31,23,21,0,2,0,4
"2011","E00019671","E00019671","Total",130,108,43,65,3,2,1,1,17,17,0,0,0,0
"2011","E00019672","E00019672","Total",128,24,4,20,0,95,3,92,8,6,0,2,0,1
"2011","E00019657","E00019657","Total",135,110,65,45,1,6,0,6,13,12,1,0,0,5
"2011","E00019673","E00019673","Total",132,123,63,60,0,3,3,0,4,3,0,1,0,2
"2011","E00019679","E00019679","Total",137,121,49,72,0,2,1,1,14,12,0,2,0,0
"2011","E00019680","E00019680","Total",132,114,47,67,0,1,0,1,15,11,1,1,2,2
"2011","E00019682","E00019682","Total",132,105,50,55,1,6,2,4,19,18,0,1,0,1
"2011","E00019665","E00019665","Total",116,80,39,41,0,20,4,16,14,12,1,1,0,2
"2011","E00019669","E00019669","Total",120,24,9,15,1,15,4,11,79,74,0,5,0,1
"2011","E00019670","E00019670","Total",133,122,64,58,0,5,2,3,5,5,0,0,0,1
"2011","E00019674","E00019674","Total",120,107,60,47,0,2,0,2,11,9,0,2,0,0
"2011","E00019676","E00019676","Total",117,107,67,40,0,0,0,0,10,8,0,2,0,0
"2011","E00019447","E00019447","Total",132,109,46,63,3,1,0,1,19,19,0,0,0,0
"2011","E00019455","E00019455","Total",128,72,28,44,1,33,9,24,20,18,0,2,0,2
"2011","E00019464","E00019464","Total",110,69,25,44,0,1,0,1,40,39,0,1,0,0
"2011","E00019466","E00019466","Total",90,63,29,34,0,3,0,3,23,21,1,0,1,1
"2011","E00019467","E00019467","Total",116,84,33,51,0,3,1,2,28,26,0,2,0,1
"2011","E00019445","E00019445","Total",145,104,48,56,0,5,1,4,35,33,0,2,0,1
"2011","E00019456","E00019456","Total",141,95,45,50,1,3,0,3,41,36,0,5,0,1
"2011","E00019460","E00019460","Total",146,81,27,54,0,2,0,2,63,63,0,0,0,0
"2011","E00019465","E00019465","Total",117,100,61,39,0,1,0,1,12,11,0,1,0,4
"2011","E00019472","E00019472","Total",144,66,27,39,13,2,0,2,59,55,0,3,1,4
"2011","E00019448","E00019448","Total",141,101,25,76,2,1,1,0,36,36,0,0,0,1
"2011","E00019469","E00019469","Total",126,93,31,62,0,7,2,5,26,25,1,0,0,0
"2011","E00019470","E00019470","Total",184,110,33,77,6,18,4,14,50,47,1,2,0,0
"2011","E00019471","E00019471","Total",129,102,44,58,1,1,0,1,23,22,0,1,0,2
"2011","E00019473","E00019473","Total",141,130,53,77,0,0,0,0,10,8,0,1,1,1
"2011","E00019663","E00019663","Total",116,102,54,48,0,2,1,1,12,10,1,0,1,0
"2011","E00019666","E00019666","Total",152,134,63,71,0,2,0,2,14,14,0,0,0,2
"2011","E00019667","E00019667","Total",119,108,54,54,2,1,1,0,6,5,0,1,0,2
"2011","E00019668","E00019668","Total",118,109,72,37,0,2,1,1,6,6,0,0,0,1
"2011","E00019675","E00019675","Total",165,139,70,69,2,3,2,1,19,18,0,1,0,2
"2011","E00019135","E00019135","Total",128,107,39,68,0,3,3,0,17,16,0,1,0,1
"2011","E00019137","E00019137","Total",120,108,65,43,0,6,1,5,6,5,0,1,0,0
"2011","E00019138","E00019138","Total",109,93,53,40,0,0,0,0,15,14,0,1,0,1
"2011","E00019139","E00019139","Total",124,104,67,37,0,8,4,4,10,10,0,0,0,2
"2011","E00019140","E00019140","Total",112,96,68,28,0,2,0,2,10,10,0,0,0,4
"2011","E00019112","E00019112","Total",131,111,65,46,0,5,1,4,15,13,1,0,1,0
"2011","E00019134","E00019134","Total",124,112,60,52,0,5,0,5,7,6,0,1,0,0
"2011","E00019136","E00019136","Total",148,107,55,52,0,8,0,8,31,30,0,1,0,2
"2011","E00019141","E00019141","Total",120,102,66,36,0,3,0,3,15,14,1,0,0,0
"2011","E00019197","E00019197","Total",137,72,36,36,0,52,16,36,12,10,0,0,2,1
"2011","E00019198","E00019198","Total",119,69,32,37,0,35,11,24,15,15,0,0,0,0
"2011","E00019199","E00019199","Total",143,98,63,35,1,15,0,15,23,20,1,1,1,6
"2011","E00019202","E00019202","Total",119,98,55,43,1,4,0,4,16,15,0,0,1,0
"2011","E00019205","E00019205","Total",122,97,61,36,0,2,0,2,22,21,1,0,0,1
"2011","E00019178","E00019178","Total",131,69,45,24,2,17,5,12,37,34,0,1,2,6
"2011","E00019181","E00019181","Total",149,125,91,34,1,4,0,4,17,13,2,0,2,2
"2011","E00019183","E00019183","Total",113,82,49,33,0,0,0,0,22,21,0,0,1,9
"2011","E00019186","E00019186","Total",167,113,56,57,2,29,4,25,16,15,1,0,0,7
"2011","E00019187","E00019187","Total",149,107,55,52,3,1,1,0,37,36,1,0,0,1
"2011","E00019192","E00019192","Total",158,96,39,57,3,43,10,33,11,11,0,0,0,5
"2011","E00019314","E00019314","Total",103,81,32,49,1,4,2,2,17,15,0,1,1,0
"2011","E00019315","E00019315","Total",109,75,30,45,0,3,1,2,30,27,0,2,1,1
"2011","E00019316","E00019316","Total",126,101,47,54,0,7,2,5,18,17,0,1,0,0
"2011","E00019317","E00019317","Total",109,52,16,36,0,39,16,23,18,18,0,0,0,0
"2011","E00019318","E00019318","Total",113,76,33,43,0,7,1,6,27,26,1,0,0,3
"2011","E00019313","E00019313","Total",135,25,5,20,0,94,46,48,11,11,0,0,0,5
"2011","E00019319","E00019319","Total",83,6,3,3,0,70,22,48,6,5,0,0,1,1
"2011","E00019320","E00019320","Total",176,34,14,20,1,124,39,85,10,10,0,0,0,7
"2011","E00019321","E00019321","Total",122,74,35,39,3,19,4,15,26,25,0,1,0,0
"2011","E00019323","E00019323","Total",139,95,45,50,1,14,2,12,28,25,0,3,0,1
"2011","E00019325","E00019325","Total",156,84,30,54,2,39,9,30,30,29,0,1,0,1
"2011","E00019307","E00019307","Total",117,44,14,30,1,60,15,45,11,11,0,0,0,1
"2011","E00019308","E00019308","Total",114,61,24,37,0,40,15,25,10,10,0,0,0,3
"2011","E00019324","E00019324","Total",131,79,32,47,0,35,11,24,14,14,0,0,0,3
"2011","E00019327","E00019327","Total",131,113,57,56,0,6,3,3,11,10,0,1,0,1
"2011","E00019332","E00019332","Total",126,74,33,41,1,43,14,29,7,6,0,1,0,1
"2011","E00019322","E00019322","Total",144,111,67,44,0,14,3,11,19,17,0,2,0,0
"2011","E00019329","E00019329","Total",205,58,18,40,19,101,26,75,23,21,0,2,0,4
"2011","E00019331","E00019331","Total",138,132,72,60,0,2,0,2,3,3,0,0,0,1
"2011","E00019333","E00019333","Total",140,123,72,51,0,4,2,2,13,12,0,1,0,0
"2011","E00019334","E00019334","Total",126,56,20,36,2,42,16,26,22,22,0,0,0,4
"2011","E00019306","E00019306","Total",137,129,75,54,0,3,0,3,5,3,1,0,1,0
"2011","E00019326","E00019326","Total",137,93,45,48,1,12,0,12,31,28,0,2,1,0
"2011","E00019328","E00019328","Total",128,118,72,46,1,3,0,3,5,5,0,0,0,1
"2011","E00019330","E00019330","Total",151,108,57,51,0,32,13,19,9,9,0,0,0,2
"2011","E00019309","E00019309","Total",127,111,75,36,1,3,2,1,9,8,0,1,0,3
"2011","E00019310","E00019310","Total",127,109,59,50,0,3,0,3,14,12,0,2,0,1
"2011","E00019311","E00019311","Total",125,117,61,56,1,0,0,0,7,6,0,1,0,0
"2011","E00019312","E00019312","Total",130,119,62,57,0,5,1,4,5,5,0,0,0,1
"2011","E00019335","E00019335","Total",113,102,46,56,1,2,2,0,7,7,0,0,0,1
"2011","E00019521","E00019521","Total",129,118,54,64,0,2,1,1,9,9,0,0,0,0
"2011","E00019526","E00019526","Total",131,107,40,67,0,10,3,7,14,14,0,0,0,0
"2011","E00019527","E00019527","Total",126,99,33,66,0,0,0,0,27,24,0,3,0,0
"2011","E00019529","E00019529","Total",168,31,4,27,6,9,0,9,121,117,1,3,0,1
"2011","E00019531","E00019531","Total",108,87,37,50,0,0,0,0,21,18,0,3,0,0
"2011","E00019532","E00019532","Total",131,108,52,56,0,1,0,1,22,22,0,0,0,0
"2011","E00019519","E00019519","Total",114,82,28,54,5,10,1,9,17,16,0,1,0,0
"2011","E00019520","E00019520","Total",160,119,38,81,4,11,0,11,22,19,0,3,0,4
"2011","E00019524","E00019524","Total",138,86,23,63,0,2,0,2,48,47,1,0,0,2
"2011","E00019525","E00019525","Total",120,91,31,60,0,2,0,2,27,27,0,0,0,0
"2011","E00019528","E00019528","Total",147,113,38,75,0,3,0,3,30,29,0,0,1,1
"2011","E00019533","E00019533","Total",157,86,24,62,1,30,5,25,38,32,1,4,1,2
"2011","E00019597","E00019597","Total",137,99,35,64,0,5,0,5,32,32,0,0,0,1
"2011","E00019598","E00019598","Total",142,77,23,54,2,5,1,4,58,54,0,3,1,0
"2011","E00019599","E00019599","Total",118,80,60,20,8,5,0,5,21,21,0,0,0,4
"2011","E00019602","E00019602","Total",135,83,43,40,2,2,0,2,46,44,0,2,0,2
"2011","E00019604","E00019604","Total",170,44,5,39,0,6,1,5,117,110,5,1,1,3
"2011","E00019607","E00019607","Total",94,48,23,25,1,1,0,1,41,40,0,1,0,3
"2011","E00019585","E00019585","Total",146,80,30,50,0,27,4,23,34,28,1,5,0,5
"2011","E00019600","E00019600","Total",140,84,27,57,0,1,0,1,53,52,0,1,0,2
"2011","E00019601","E00019601","Total",159,59,11,48,1,32,14,18,65,61,1,3,0,2
"2011","E00019603","E00019603","Total",129,80,33,47,0,11,0,11,37,34,0,3,0,1
"2011","E00019605","E00019605","Total",137,94,32,62,0,0,0,0,43,43,0,0,0,0
"2011","E00019606","E00019606","Total",137,78,33,45,1,22,0,22,32,30,0,2,0,4
"2011","E00019623","E00019623","Total",137,100,44,56,0,1,1,0,35,33,0,2,0,1
"2011","E00019625","E00019625","Total",131,80,28,52,1,16,0,16,34,34,0,0,0,0
"2011","E00019626","E00019626","Total",142,95,23,72,0,2,0,2,44,44,0,0,0,1
"2011","E00019629","E00019629","Total",124,94,36,58,0,1,1,0,27,27,0,0,0,2
"2011","E00019654","E00019654","Total",141,84,14,70,0,8,1,7,48,46,0,2,0,1
"2011","E00019627","E00019627","Total",121,85,32,53,2,2,0,2,32,31,0,1,0,0
"2011","E00019628","E00019628","Total",120,85,37,48,0,6,1,5,28,21,1,5,1,1
"2011","E00019630","E00019630","Total",109,71,23,48,0,6,0,6,31,30,0,1,0,1
"2011","E00019632","E00019632","Total",139,113,44,69,3,1,0,1,22,18,0,2,2,0
"2011","E00019636","E00019636","Total",143,118,52,66,0,3,1,2,22,22,0,0,0,0
"2011","E00019624","E00019624","Total",127,65,39,26,1,37,12,25,20,19,0,1,0,4
"2011","E00019637","E00019637","Total",128,72,26,46,0,37,19,18,13,12,1,0,0,6
"2011","E00019640","E00019640","Total",118,70,29,41,0,35,15,20,10,7,2,0,1,3
"2011","E00019641","E00019641","Total",110,70,30,40,0,30,9,21,9,7,2,0,0,1
"2011","E00019645","E00019645","Total",131,51,16,35,1,65,27,38,12,12,0,0,0,2
"2011","E00019646","E00019646","Total",135,116,50,66,2,3,1,2,13,13,0,0,0,1
"2011","E00019650","E00019650","Total",116,105,44,61,1,4,3,1,6,6,0,0,0,0
"2011","E00019651","E00019651","Total",118,86,38,48,0,20,6,14,12,12,0,0,0,0
"2011","E00019653","E00019653","Total",109,96,36,60,1,2,0,2,10,9,0,1,0,0
"2011","E00019655","E00019655","Total",127,112,38,74,1,2,0,2,11,10,0,1,0,1
"2011","E00019631","E00019631","Total",124,98,58,40,0,8,2,6,17,16,0,1,0,1
"2011","E00019634","E00019634","Total",113,99,43,56,1,4,0,4,9,8,0,1,0,0
"2011","E00019635","E00019635","Total",127,118,42,76,1,2,2,0,5,4,0,1,0,1
"2011","E00019638","E00019638","Total",139,121,41,80,0,2,0,2,15,14,0,1,0,1
"2011","E00019633","E00019633","Total",120,98,40,58,0,8,0,8,11,10,0,1,0,3
"2011","E00019639","E00019639","Total",119,108,46,62,0,2,1,1,8,5,0,3,0,1
"2011","E00019642","E00019642","Total",117,104,48,56,0,1,0,1,12,11,0,1,0,0
"2011","E00019643","E00019643","Total",113,41,8,33,0,61,25,36,8,6,0,2,0,3
"2011","E00019644","E00019644","Total",111,72,34,38,0,16,8,8,23,23,0,0,0,0
"2011","E00019622","E00019622","Total",149,105,28,77,0,20,5,15,21,21,0,0,0,3
"2011","E00019647","E00019647","Total",126,108,46,62,1,3,0,3,13,11,1,1,0,1
"2011","E00019648","E00019648","Total",134,76,34,42,1,28,6,22,24,21,0,2,1,5
"2011","E00019649","E00019649","Total",116,55,14,41,0,45,13,32,15,14,0,1,0,1
"2011","E00019652","E00019652","Total",146,97,31,66,1,12,3,9,36,36,0,0,0,0
"2011","E00019522","E00019522","Total",108,86,46,40,0,0,0,0,21,21,0,0,0,1
"2011","E00019534","E00019534","Total",131,102,45,57,0,11,5,6,16,13,0,3,0,2
"2011","E00019536","E00019536","Total",109,90,42,48,0,6,0,6,12,11,0,1,0,1
"2011","E00019538","E00019538","Total",102,72,26,46,0,12,5,7,16,16,0,0,0,2
"2011","E00019542","E00019542","Total",131,109,59,50,1,1,1,0,20,17,0,3,0,0
"2011","E00019547","E00019547","Total",129,95,56,39,0,1,0,1,33,30,0,3,0,0
"2011","E00019548","E00019548","Total",115,92,47,45,0,2,1,1,20,18,1,1,0,1
"2011","E00019549","E00019549","Total",132,89,44,45,1,15,1,14,25,25,0,0,0,2
"2011","E00174884","E00174884","Total",63,43,27,16,0,5,0,5,9,8,0,1,0,6
"2011","E00174885","E00174885","Total",53,41,19,22,0,6,1,5,6,6,0,0,0,0
"2011","E00019530","E00019530","Total",144,75,28,47,0,31,7,24,36,33,0,2,1,2
"2011","E00019535","E00019535","Total",154,104,48,56,0,28,6,22,19,19,0,0,0,3
"2011","E00019539","E00019539","Total",131,101,52,49,0,15,7,8,15,15,0,0,0,0
"2011","E00019540","E00019540","Total",124,112,62,50,0,1,0,1,11,11,0,0,0,0
"2011","E00019543","E00019543","Total",145,78,38,40,1,13,3,10,51,45,0,4,2,2
"2011","E00019523","E00019523","Total",127,81,33,48,0,15,5,10,29,27,0,2,0,2
"2011","E00019537","E00019537","Total",158,105,46,59,0,5,0,5,46,43,0,2,1,2
"2011","E00019544","E00019544","Total",117,42,17,25,0,16,9,7,53,47,0,5,1,6
"2011","E00019545","E00019545","Total",115,106,42,64,0,0,0,0,9,9,0,0,0,0
"2011","E00019546","E00019546","Total",130,107,33,74,1,3,2,1,19,19,0,0,0,0
"2011","E00019180","E00019180","Total",123,68,32,36,13,32,12,20,10,10,0,0,0,0
"2011","E00019182","E00019182","Total",151,117,70,47,1,10,1,9,22,22,0,0,0,1
"2011","E00019184","E00019184","Total",133,102,47,55,0,6,0,6,24,23,0,0,1,1
"2011","E00019203","E00019203","Total",117,91,55,36,0,6,1,5,20,18,0,2,0,0
"2011","E00019206","E00019206","Total",137,108,63,45,0,8,2,6,19,17,0,2,0,2
"2011","E00019177","E00019177","Total",119,45,22,23,0,62,18,44,9,8,0,0,1,3
"2011","E00019200","E00019200","Total",115,71,27,44,0,32,11,21,9,9,0,0,0,3
"2011","E00019201","E00019201","Total",123,49,21,28,3,62,22,40,8,6,0,2,0,1
"2011","E00019204","E00019204","Total",126,52,16,36,1,57,22,35,15,13,0,1,1,1
"2011","E00019207","E00019207","Total",139,70,32,38,2,39,17,22,20,19,0,0,1,8
"2011","E00019208","E00019208","Total",125,43,11,32,1,62,29,33,16,13,0,1,2,3
"2011","E00019179","E00019179","Total",123,82,36,46,1,26,10,16,13,12,1,0,0,1
"2011","E00019185","E00019185","Total",136,102,48,54,0,13,3,10,20,19,0,1,0,1
"2011","E00019188","E00019188","Total",122,97,56,41,0,6,5,1,16,15,0,1,0,3
"2011","E00019189","E00019189","Total",133,73,24,49,0,37,16,21,21,20,1,0,0,2
"2011","E00019190","E00019190","Total",112,61,26,35,0,29,9,20,17,16,1,0,0,5
"2011","E00019191","E00019191","Total",125,67,27,40,0,48,18,30,8,8,0,0,0,2
"2011","E00019145","E00019145","Total",116,92,43,49,1,0,0,0,22,21,0,1,0,1
"2011","E00019146","E00019146","Total",146,104,41,63,1,14,4,10,27,25,0,2,0,0
"2011","E00019151","E00019151","Total",109,97,42,55,1,1,0,1,10,10,0,0,0,0
"2011","E00019165","E00019165","Total",131,108,42,66,0,1,0,1,22,21,0,1,0,0
"2011","E00019173","E00019173","Total",138,116,37,79,1,4,1,3,15,15,0,0,0,2
"2011","E00019144","E00019144","Total",130,91,33,58,0,16,1,15,23,23,0,0,0,0
"2011","E00019164","E00019164","Total",118,81,27,54,1,7,0,7,27,26,1,0,0,2
"2011","E00019166","E00019166","Total",131,58,20,38,2,42,15,27,26,23,0,3,0,3
"2011","E00019167","E00019167","Total",119,86,30,56,0,4,0,4,29,25,0,2,2,0
"2011","E00019169","E00019169","Total",129,97,28,69,0,11,1,10,21,21,0,0,0,0
"2011","E00019171","E00019171","Total",145,87,26,61,1,0,0,0,56,52,0,3,1,1
"2011","E00019571","E00019571","Total",133,104,55,49,1,4,0,4,22,19,1,2,0,2
"2011","E00019572","E00019572","Total",128,74,33,41,1,6,2,4,45,43,1,1,0,2
"2011","E00019573","E00019573","Total",126,112,45,67,0,1,0,1,13,13,0,0,0,0
"2011","E00019575","E00019575","Total",127,97,51,46,3,3,1,2,24,24,0,0,0,0
"2011","E00019582","E00019582","Total",128,84,29,55,0,6,1,5,37,35,0,1,1,1
"2011","E00019554","E00019554","Total",151,96,47,49,18,5,0,5,32,30,0,1,1,0
"2011","E00019570","E00019570","Total",146,117,55,62,0,0,0,0,27,26,0,1,0,2
"2011","E00019574","E00019574","Total",125,93,36,57,0,2,0,2,29,25,0,4,0,1
"2011","E00019576","E00019576","Total",131,99,62,37,0,0,0,0,30,30,0,0,0,2
"2011","E00019578","E00019578","Total",135,113,59,54,0,3,1,2,19,19,0,0,0,0
"2011","E00019579","E00019579","Total",138,85,47,38,0,8,0,8,42,39,0,3,0,3
"2011","E00019142","E00019142","Total",109,87,29,58,1,3,0,3,18,17,1,0,0,0
"2011","E00019143","E00019143","Total",122,88,34,54,0,19,4,15,14,13,0,1,0,1
"2011","E00019156","E00019156","Total",128,112,57,55,1,3,0,3,12,12,0,0,0,0
"2011","E00019168","E00019168","Total",139,110,41,69,0,5,1,4,24,22,0,2,0,0
"2011","E00019172","E00019172","Total",115,86,29,57,0,14,3,11,15,12,0,1,2,0
"2011","E00019148","E00019148","Total",119,110,49,61,0,3,0,3,6,6,0,0,0,0
"2011","E00019149","E00019149","Total",154,116,59,57,0,11,3,8,25,21,0,2,2,2
"2011","E00019152","E00019152","Total",120,109,57,52,0,0,0,0,11,11,0,0,0,0
"2011","E00019170","E00019170","Total",123,107,60,47,0,2,1,1,14,13,1,0,0,0
"2011","E00019174","E00019174","Total",127,109,61,48,0,2,0,2,15,15,0,0,0,1
"2011","E00019147","E00019147","Total",135,107,49,58,0,9,2,7,17,16,0,0,1,2
"2011","E00019153","E00019153","Total",135,112,55,57,1,2,0,2,18,17,0,1,0,2
"2011","E00019154","E00019154","Total",135,88,39,49,0,14,0,14,33,30,0,2,1,0
"2011","E00019155","E00019155","Total",129,66,35,31,0,14,2,12,48,46,0,2,0,1
"2011","E00019157","E00019157","Total",127,88,36,52,0,11,5,6,27,27,0,0,0,1
"2011","E00019161","E00019161","Total",99,66,32,34,0,19,1,18,13,11,0,1,1,1
"2011","E00019150","E00019150","Total",124,75,26,49,1,23,5,18,23,21,0,2,0,2
"2011","E00019158","E00019158","Total",106,23,10,13,0,47,5,42,34,32,0,1,1,2
"2011","E00019159","E00019159","Total",130,70,24,46,0,26,7,19,32,31,0,1,0,2
"2011","E00019160","E00019160","Total",135,110,36,74,0,3,1,2,21,21,0,0,0,1
"2011","E00019162","E00019162","Total",148,125,54,71,0,3,0,3,20,18,0,2,0,0
"2011","E00019163","E00019163","Total",181,63,18,45,0,8,6,2,109,97,5,2,5,1
"2011","E00019261","E00019261","Total",115,91,57,34,2,7,2,5,15,12,0,3,0,0
"2011","E00019264","E00019264","Total",134,104,60,44,1,14,1,13,13,12,0,1,0,2
"2011","E00019265","E00019265","Total",121,115,79,36,0,3,1,2,2,2,0,0,0,1
"2011","E00019270","E00019270","Total",128,101,30,71,4,8,1,7,15,14,0,1,0,0
"2011","E00019271","E00019271","Total",132,99,47,52,1,13,1,12,19,18,0,1,0,0
"2011","E00019241","E00019241","Total",146,29,5,24,1,102,35,67,11,9,0,0,2,3
"2011","E00019243","E00019243","Total",148,123,68,55,0,18,8,10,7,6,1,0,0,0
"2011","E00019246","E00019246","Total",120,46,19,27,1,51,22,29,19,17,1,0,1,3
"2011","E00019247","E00019247","Total",113,71,23,48,2,37,16,21,3,3,0,0,0,0
"2011","E00019248","E00019248","Total",159,94,44,50,5,42,8,34,18,18,0,0,0,0
"2011","E00019249","E00019249","Total",120,82,38,44,0,13,8,5,23,18,0,3,2,2
"2011","E00019251","E00019251","Total",124,60,25,35,0,5,3,2,55,54,1,0,0,4
"2011","E00019256","E00019256","Total",131,121,78,43,0,5,0,5,4,3,1,0,0,1
"2011","E00019257","E00019257","Total",115,64,25,39,1,26,7,19,24,21,1,2,0,0
"2011","E00019262","E00019262","Total",119,77,39,38,0,23,11,12,14,11,0,2,1,5
"2011","E00019263","E00019263","Total",125,93,55,38,0,18,4,14,12,11,0,1,0,2
"2011","E00019244","E00019244","Total",151,102,45,57,1,11,3,8,36,34,0,2,0,1
"2011","E00019245","E00019245","Total",130,109,48,61,2,4,1,3,14,14,0,0,0,1
"2011","E00019250","E00019250","Total",140,110,64,46,2,5,0,5,23,21,0,2,0,0
"2011","E00019252","E00019252","Total",122,90,41,49,4,12,4,8,16,13,0,2,1,0
"2011","E00019272","E00019272","Total",154,119,52,67,4,14,0,14,15,13,0,2,0,2
"2011","E00019242","E00019242","Total",112,88,30,58,1,6,0,6,16,16,0,0,0,1
"2011","E00019253","E00019253","Total",107,15,8,7,0,89,3,86,2,2,0,0,0,1
"2011","E00019255","E00019255","Total",139,11,5,6,1,117,16,101,5,5,0,0,0,5
"2011","E00019258","E00019258","Total",102,48,13,35,4,38,14,24,11,11,0,0,0,1
"2011","E00019266","E00019266","Total",119,48,25,23,19,44,13,31,6,5,0,1,0,2
"2011","E00019267","E00019267","Total",102,40,14,26,0,57,21,36,5,4,1,0,0,0
"2011","E00019254","E00019254","Total",136,75,28,47,0,29,5,24,30,27,0,3,0,2
"2011","E00019259","E00019259","Total",135,98,49,49,2,6,2,4,28,25,0,3,0,1
"2011","E00019260","E00019260","Total",116,29,9,20,0,76,30,46,8,7,0,1,0,3
"2011","E00019268","E00019268","Total",138,107,55,52,3,7,3,4,19,19,0,0,0,2
"2011","E00019269","E00019269","Total",133,78,27,51,17,18,2,16,18,17,0,1,0,2
"2011","E00019558","E00019558","Total",146,105,39,66,1,4,3,1,36,34,1,1,0,0
"2011","E00019577","E00019577","Total",130,110,51,59,0,8,0,8,10,9,0,1,0,2
"2011","E00019580","E00019580","Total",123,92,37,55,0,6,0,6,23,22,0,1,0,2
"2011","E00019583","E00019583","Total",131,63,26,37,1,18,2,16,46,43,0,3,0,3
"2011","E00019584","E00019584","Total",154,97,37,60,0,3,2,1,52,50,0,2,0,2
"2011","E00019550","E00019550","Total",155,70,29,41,0,3,0,3,81,77,3,1,0,1
"2011","E00019551","E00019551","Total",137,108,37,71,0,3,1,2,24,24,0,0,0,2
"2011","E00019552","E00019552","Total",130,91,41,50,5,6,3,3,27,26,0,1,0,1
"2011","E00019559","E00019559","Total",120,82,38,44,0,7,1,6,30,26,1,1,2,1
"2011","E00019560","E00019560","Total",125,105,50,55,1,0,0,0,18,17,0,1,0,1
"2011","E00019564","E00019564","Total",122,95,48,47,1,11,0,11,15,13,0,2,0,0
"2011","E00019555","E00019555","Total",144,35,10,25,2,83,32,51,24,24,0,0,0,0
"2011","E00019556","E00019556","Total",161,67,25,42,2,16,0,16,75,70,1,2,2,1
"2011","E00019557","E00019557","Total",118,91,43,48,0,4,0,4,23,22,0,1,0,0
"2011","E00019561","E00019561","Total",146,84,30,54,1,20,6,14,40,40,0,0,0,1
"2011","E00019563","E00019563","Total",98,26,12,14,1,51,17,34,19,18,0,1,0,1
"2011","E00019566","E00019566","Total",106,53,34,19,0,37,1,36,12,11,0,1,0,4
"2011","E00019581","E00019581","Total",123,46,21,25,1,52,16,36,24,24,0,0,0,0
"2011","E00019553","E00019553","Total",160,121,58,63,0,5,0,5,34,33,0,0,1,0
"2011","E00019562","E00019562","Total",119,97,55,42,0,9,0,9,13,13,0,0,0,0
"2011","E00019565","E00019565","Total",128,119,61,58,0,3,0,3,6,5,0,1,0,0
"2011","E00019567","E00019567","Total",110,79,43,36,0,0,0,0,31,29,1,0,1,0
"2011","E00019568","E00019568","Total",130,67,43,24,1,3,1,2,59,59,0,0,0,0
"2011","E00019569","E00019569","Total",132,84,47,37,0,2,0,2,45,43,0,2,0,1
"2011","E00019273","E00019273","Total",163,99,68,31,0,15,2,13,41,41,0,0,0,8
"2011","E00019276","E00019276","Total",153,96,42,54,2,10,1,9,43,40,1,1,1,2
"2011","E00019277","E00019277","Total",224,102,61,41,5,44,3,41,72,63,1,3,5,1
"2011","E00019303","E00019303","Total",134,61,23,38,0,26,1,25,47,40,0,1,6,0
"2011","E00019305","E00019305","Total",155,61,22,39,0,20,0,20,70,46,2,2,20,4
"2011","E00019278","E00019278","Total",94,73,20,53,0,5,1,4,16,15,0,1,0,0
"2011","E00019282","E00019282","Total",106,87,49,38,0,1,0,1,18,16,1,0,1,0
"2011","E00019283","E00019283","Total",97,84,36,48,0,4,0,4,8,6,0,2,0,1
"2011","E00019288","E00019288","Total",114,100,44,56,0,6,3,3,7,7,0,0,0,1
"2011","E00019291","E00019291","Total",126,115,49,66,1,3,0,3,6,5,0,1,0,1
"2011","E00019281","E00019281","Total",114,93,39,54,2,3,1,2,14,12,0,2,0,2
"2011","E00019285","E00019285","Total",115,73,57,16,1,30,11,19,10,7,1,0,2,1
"2011","E00019286","E00019286","Total",108,96,50,46,0,5,5,0,7,7,0,0,0,0
"2011","E00019287","E00019287","Total",143,58,22,36,0,72,15,57,12,10,0,1,1,1
"2011","E00019293","E00019293","Total",133,41,16,25,1,71,30,41,17,16,0,0,1,3
"2011","E00019279","E00019279","Total",126,51,20,31,1,55,23,32,18,15,1,2,0,1
"2011","E00019280","E00019280","Total",100,79,48,31,0,0,0,0,20,18,0,2,0,1
"2011","E00019284","E00019284","Total",120,105,68,37,0,1,0,1,13,13,0,0,0,1
"2011","E00019292","E00019292","Total",197,144,77,67,0,11,3,8,42,41,0,1,0,0
"2011","E00019297","E00019297","Total",131,103,71,32,0,0,0,0,24,22,0,2,0,4
"2011","E00019298","E00019298","Total",128,103,62,41,1,3,1,2,20,18,0,1,1,1
"2011","E00019289","E00019289","Total",142,101,32,69,0,2,0,2,37,35,0,2,0,2
"2011","E00019290","E00019290","Total",133,81,37,44,6,3,0,3,39,36,1,1,1,4
"2011","E00019294","E00019294","Total",134,105,55,50,1,8,4,4,11,11,0,0,0,9
"2011","E00019295","E00019295","Total",122,63,31,32,0,16,3,13,42,40,0,2,0,1
"2011","E00019296","E00019296","Total",227,118,40,78,1,59,1,58,47,44,0,2,1,2
"2011","E00019274","E00019274","Total",127,29,5,24,3,59,21,38,33,33,0,0,0,3
"2011","E00019275","E00019275","Total",145,58,34,24,2,56,15,41,28,25,0,3,0,1
"2011","E00019299","E00019299","Total",125,83,38,45,1,10,2,8,31,29,0,2,0,0
"2011","E00019300","E00019300","Total",127,107,41,66,0,2,0,2,18,18,0,0,0,0
"2011","E00019301","E00019301","Total",61,33,19,14,0,4,1,3,24,22,0,2,0,0
"2011","E00019302","E00019302","Total",199,85,22,63,18,64,13,51,28,23,0,2,3,4
"2011","E00019304","E00019304","Total",132,91,35,56,0,3,1,2,35,32,0,2,1,3
"2011","E00019213","E00019213","Total",126,115,57,58,0,1,1,0,10,9,0,1,0,0
"2011","E00019223","E00019223","Total",140,115,66,49,8,4,3,1,13,13,0,0,0,0
"2011","E00019226","E00019226","Total",120,117,66,51,0,0,0,0,2,2,0,0,0,1
"2011","E00019240","E00019240","Total",130,119,54,65,0,3,2,1,7,5,0,2,0,1
"2011","E00019211","E00019211","Total",142,107,56,51,0,1,0,1,34,33,0,1,0,0
"2011","E00019221","E00019221","Total",113,104,63,41,0,1,0,1,8,7,0,1,0,0
"2011","E00019231","E00019231","Total",128,86,57,29,2,1,1,0,35,33,0,2,0,4
"2011","E00019237","E00019237","Total",126,80,30,50,0,10,8,2,34,31,0,3,0,2
"2011","E00019238","E00019238","Total",148,116,81,35,2,0,0,0,29,26,0,2,1,1
"2011","E00019239","E00019239","Total",139,69,37,32,1,12,0,12,55,35,7,0,13,2
"2011","E00019210","E00019210","Total",131,112,56,56,3,2,0,2,14,12,0,2,0,0
"2011","E00019216","E00019216","Total",134,100,34,66,0,6,2,4,27,25,0,2,0,1
"2011","E00019217","E00019217","Total",126,89,57,32,1,20,4,16,14,13,0,1,0,2
"2011","E00019220","E00019220","Total",139,115,51,64,0,2,1,1,18,18,0,0,0,4
"2011","E00019222","E00019222","Total",119,105,50,55,0,2,0,2,11,10,0,0,1,1
"2011","E00019214","E00019214","Total",128,118,45,73,0,0,0,0,10,9,0,1,0,0
"2011","E00019215","E00019215","Total",138,121,47,74,1,1,0,1,13,12,0,0,1,2
"2011","E00019218","E00019218","Total",143,95,43,52,11,9,1,8,23,23,0,0,0,5
"2011","E00019219","E00019219","Total",128,119,60,59,0,3,1,2,5,4,1,0,0,1
"2011","E00019224","E00019224","Total",116,76,37,39,2,29,13,16,7,5,0,2,0,2
"2011","E00019209","E00019209","Total",112,11,7,4,0,92,27,65,8,8,0,0,0,1
"2011","E00019228","E00019228","Total",123,83,36,47,0,28,10,18,9,8,0,1,0,3
"2011","E00019229","E00019229","Total",135,58,15,43,0,49,11,38,25,24,0,1,0,3
"2011","E00019230","E00019230","Total",113,65,26,39,0,35,19,16,9,9,0,0,0,4
"2011","E00019232","E00019232","Total",141,69,27,42,2,42,8,34,26,26,0,0,0,2
"2011","E00019233","E00019233","Total",136,23,16,7,0,100,23,77,13,12,0,1,0,0
"2011","E00019212","E00019212","Total",113,60,19,41,2,1,0,1,49,47,0,2,0,1
"2011","E00019225","E00019225","Total",130,60,25,35,1,24,0,24,42,41,0,1,0,3
"2011","E00019227","E00019227","Total",138,53,14,39,1,34,7,27,49,46,2,1,0,1
"2011","E00019234","E00019234","Total",143,108,46,62,8,0,0,0,27,23,1,2,1,0
"2011","E00019235","E00019235","Total",145,91,31,60,0,39,13,26,13,12,0,1,0,2
"2011","E00019236","E00019236","Total",131,86,26,60,1,23,9,14,19,19,0,0,0,2
"2011","E00020754","E00020754","Total",188,50,18,32,0,124,108,16,14,12,0,2,0,0
"2011","E00020757","E00020757","Total",198,105,39,66,4,77,69,8,9,7,0,2,0,3
"2011","E00020767","E00020767","Total",131,54,10,44,0,49,47,2,26,24,0,1,1,2
"2011","E00020786","E00020786","Total",113,56,13,43,1,47,43,4,9,9,0,0,0,0
"2011","E00021076","E00021076","Total",121,56,14,42,3,28,26,2,34,33,0,0,1,0
"2011","E00021088","E00021088","Total",138,56,13,43,1,73,62,11,6,6,0,0,0,2
"2011","E00021089","E00021089","Total",138,66,13,53,0,63,58,5,8,7,0,1,0,1
"2011","E00021090","E00021090","Total",134,60,18,42,0,60,47,13,14,13,0,1,0,0
"2011","E00021091","E00021091","Total",132,55,14,41,0,67,61,6,9,9,0,0,0,1
"2011","E00021074","E00021074","Total",125,56,17,39,1,56,53,3,12,10,0,2,0,0
"2011","E00021075","E00021075","Total",111,56,8,48,0,43,39,4,11,9,0,2,0,1
"2011","E00021081","E00021081","Total",139,65,17,48,1,62,60,2,7,4,0,3,0,4
"2011","E00021083","E00021083","Total",126,59,10,49,1,54,47,7,11,10,0,1,0,1
"2011","E00021096","E00021096","Total",97,28,9,19,1,60,28,32,8,6,0,0,2,0
"2011","E00021071","E00021071","Total",103,31,6,25,0,65,15,50,6,6,0,0,0,1
"2011","E00021072","E00021072","Total",123,83,25,58,0,20,7,13,20,19,0,1,0,0
"2011","E00021092","E00021092","Total",86,2,0,2,2,75,11,64,6,6,0,0,0,1
"2011","E00021093","E00021093","Total",167,50,7,43,0,73,64,9,41,41,0,0,0,3
"2011","E00021095","E00021095","Total",86,11,4,7,8,67,9,58,0,0,0,0,0,0
"2011","E00021080","E00021080","Total",175,107,40,67,0,51,48,3,15,15,0,0,0,2
"2011","E00021082","E00021082","Total",123,59,13,46,0,52,48,4,11,11,0,0,0,1
"2011","E00021084","E00021084","Total",123,54,12,42,1,55,51,4,11,10,0,0,1,2
"2011","E00021085","E00021085","Total",117,63,12,51,1,43,37,6,9,9,0,0,0,1
"2011","E00021086","E00021086","Total",87,14,7,7,0,69,52,17,3,3,0,0,0,1
"2011","E00021087","E00021087","Total",125,57,14,43,0,64,54,10,2,2,0,0,0,2
"2011","E00020753","E00020753","Total",132,73,21,52,1,41,38,3,17,17,0,0,0,0
"2011","E00020759","E00020759","Total",117,51,9,42,0,58,55,3,8,8,0,0,0,0
"2011","E00020760","E00020760","Total",80,16,7,9,0,12,8,4,52,48,0,3,1,0
"2011","E00020765","E00020765","Total",108,40,9,31,2,57,54,3,9,6,0,2,1,0
"2011","E00020785","E00020785","Total",141,62,18,44,5,63,44,19,10,8,0,2,0,1
"2011","E00166819","E00166819","Total",206,47,6,41,14,47,11,36,94,94,0,0,0,4
"2011","E00166826","E00166826","Total",54,41,13,28,0,2,2,0,11,11,0,0,0,0
"2011","E00020755","E00020755","Total",126,71,26,45,0,45,41,4,10,9,0,0,1,0
"2011","E00020761","E00020761","Total",128,64,14,50,2,50,46,4,11,10,0,1,0,1
"2011","E00020781","E00020781","Total",144,99,32,67,1,35,31,4,8,7,0,1,0,1
"2011","E00020783","E00020783","Total",141,67,15,52,0,51,48,3,22,21,0,1,0,1
"2011","E00020784","E00020784","Total",116,60,15,45,11,33,28,5,11,10,0,0,1,1
"2011","E00020756","E00020756","Total",128,71,21,50,0,49,43,6,8,6,0,2,0,0
"2011","E00020758","E00020758","Total",199,74,21,53,2,100,92,8,21,21,0,0,0,2
"2011","E00020764","E00020764","Total",111,49,11,38,3,52,48,4,7,7,0,0,0,0
"2011","E00020766","E00020766","Total",126,49,8,41,1,61,60,1,15,14,0,1,0,0
"2011","E00020769","E00020769","Total",84,47,16,31,0,31,28,3,6,5,0,1,0,0
"2011","E00020772","E00020772","Total",122,57,16,41,0,52,46,6,13,13,0,0,0,0
"2011","E00020773","E00020773","Total",113,46,15,31,2,56,50,6,9,9,0,0,0,0
"2011","E00020774","E00020774","Total",96,42,10,32,0,45,44,1,8,8,0,0,0,1
"2011","E00020775","E00020775","Total",113,51,21,30,3,49,47,2,9,8,0,1,0,1
"2011","E00020768","E00020768","Total",129,61,15,46,0,58,50,8,10,10,0,0,0,0
"2011","E00020778","E00020778","Total",157,63,23,40,1,71,65,6,20,19,0,1,0,2
"2011","E00020779","E00020779","Total",131,22,5,17,0,98,90,8,10,9,0,1,0,1
"2011","E00020780","E00020780","Total",195,45,17,28,15,119,82,37,15,14,0,0,1,1
"2011","E00020782","E00020782","Total",138,74,27,47,1,51,48,3,12,11,0,0,1,0
"2011","E00020790","E00020790","Total",124,109,52,57,0,7,7,0,6,6,0,0,0,2
"2011","E00020795","E00020795","Total",133,111,46,65,1,0,0,0,20,20,0,0,0,1
"2011","E00020801","E00020801","Total",137,117,57,60,0,3,3,0,15,14,1,0,0,2
"2011","E00020810","E00020810","Total",133,91,45,46,0,32,0,32,10,9,0,0,1,0
"2011","E00020812","E00020812","Total",117,102,48,54,2,5,5,0,8,8,0,0,0,0
"2011","E00020811","E00020811","Total",124,79,32,47,2,21,6,15,21,20,0,1,0,1
"2011","E00020813","E00020813","Total",119,105,48,57,0,0,0,0,14,11,0,3,0,0
"2011","E00020814","E00020814","Total",136,108,48,60,1,5,5,0,15,14,0,1,0,7
"2011","E00020815","E00020815","Total",104,88,44,44,0,0,0,0,13,12,0,1,0,3
"2011","E00020817","E00020817","Total",130,118,37,81,0,2,1,1,9,9,0,0,0,1
"2011","E00020797","E00020797","Total",83,49,25,24,1,16,2,14,17,17,0,0,0,0
"2011","E00020799","E00020799","Total",129,109,55,54,0,10,0,10,10,8,0,2,0,0
"2011","E00020802","E00020802","Total",109,77,32,45,0,1,0,1,31,28,0,3,0,0
"2011","E00020803","E00020803","Total",98,93,60,33,0,0,0,0,5,5,0,0,0,0
"2011","E00020808","E00020808","Total",136,109,41,68,0,4,4,0,22,21,0,1,0,1
"2011","E00020798","E00020798","Total",118,87,42,45,0,2,1,1,29,25,0,4,0,0
"2011","E00020800","E00020800","Total",126,112,63,49,2,0,0,0,12,12,0,0,0,0
"2011","E00020804","E00020804","Total",134,127,54,73,0,2,0,2,5,5,0,0,0,0
"2011","E00020807","E00020807","Total",139,118,55,63,2,1,1,0,17,16,0,1,0,1
"2011","E00020787","E00020787","Total",135,123,52,71,0,1,1,0,10,9,0,1,0,1
"2011","E00020805","E00020805","Total",128,120,51,69,0,0,0,0,8,7,0,1,0,0
"2011","E00020806","E00020806","Total",139,128,68,60,0,2,2,0,8,7,0,1,0,1
"2011","E00020809","E00020809","Total",148,110,42,68,2,24,15,9,10,10,0,0,0,2
"2011","E00020971","E00020971","Total",126,106,42,64,1,10,10,0,8,8,0,0,0,1
"2011","E00020974","E00020974","Total",126,95,32,63,1,1,0,1,29,27,0,2,0,0
"2011","E00020976","E00020976","Total",135,115,48,67,0,3,3,0,16,15,0,1,0,1
"2011","E00020981","E00020981","Total",123,103,50,53,1,14,13,1,5,4,0,1,0,0
"2011","E00020986","E00020986","Total",129,75,34,41,2,23,20,3,29,29,0,0,0,0
"2011","E00020967","E00020967","Total",115,90,30,60,0,8,7,1,15,14,0,0,1,2
"2011","E00020977","E00020977","Total",121,115,55,60,1,1,1,0,4,4,0,0,0,0
"2011","E00020984","E00020984","Total",126,116,44,72,0,3,1,2,6,6,0,0,0,1
"2011","E00020989","E00020989","Total",138,50,22,28,0,72,68,4,14,14,0,0,0,2
"2011","E00020994","E00020994","Total",158,100,34,66,1,0,0,0,56,56,0,0,0,1
"2011","E00020997","E00020997","Total",119,100,30,70,1,6,6,0,12,11,0,1,0,0
"2011","E00020998","E00020998","Total",137,105,22,83,1,2,1,1,28,27,0,1,0,1
"2011","E00021000","E00021000","Total",124,67,23,44,0,37,36,1,17,15,0,2,0,3
"2011","E00166827","E00166827","Total",80,4,0,4,0,74,69,5,2,1,0,0,1,0
"2011","E00021073","E00021073","Total",173,125,35,90,0,25,14,11,21,20,0,1,0,2
"2011","E00021078","E00021078","Total",199,87,17,70,19,28,7,21,64,57,1,6,0,1
"2011","E00021094","E00021094","Total",143,88,24,64,0,6,3,3,47,42,0,5,0,2
"2011","E00021099","E00021099","Total",147,83,9,74,1,32,29,3,30,29,0,1,0,1
"2011","E00021101","E00021101","Total",128,71,12,59,0,3,2,1,54,51,0,3,0,0
"2011","E00021079","E00021079","Total",144,79,16,63,5,8,1,7,52,50,2,0,0,0
"2011","E00021103","E00021103","Total",122,73,16,57,0,5,1,4,44,41,0,1,2,0
"2011","E00021104","E00021104","Total",176,90,29,61,11,28,9,19,46,42,1,3,0,1
"2011","E00021106","E00021106","Total",120,50,20,30,1,58,54,4,11,11,0,0,0,0
"2011","E00021107","E00021107","Total",162,129,59,70,0,17,4,13,16,14,0,2,0,0
"2011","E00020763","E00020763","Total",135,93,39,54,1,33,29,4,8,6,0,2,0,0
"2011","E00020770","E00020770","Total",120,64,26,38,1,40,36,4,15,12,0,1,2,0
"2011","E00020771","E00020771","Total",114,61,19,42,0,43,37,6,10,10,0,0,0,0
"2011","E00020776","E00020776","Total",125,58,16,42,2,53,49,4,11,9,1,1,0,1
"2011","E00020777","E00020777","Total",136,112,21,91,0,10,6,4,13,12,0,1,0,1
"2011","E00020969","E00020969","Total",120,107,40,67,0,2,0,2,8,8,0,0,0,3
"2011","E00020970","E00020970","Total",129,116,49,67,2,3,2,1,7,7,0,0,0,1
"2011","E00020972","E00020972","Total",124,98,37,61,0,9,0,9,16,16,0,0,0,1
"2011","E00020975","E00020975","Total",119,101,31,70,0,12,10,2,5,5,0,0,0,1
"2011","E00020999","E00020999","Total",123,114,45,69,0,5,3,2,4,2,0,2,0,0
"2011","E00020982","E00020982","Total",165,94,33,61,3,51,19,32,16,16,0,0,0,1
"2011","E00020985","E00020985","Total",155,87,35,52,0,30,22,8,37,33,0,3,1,1
"2011","E00020987","E00020987","Total",134,82,14,68,1,16,7,9,35,34,0,1,0,0
"2011","E00020990","E00020990","Total",132,103,40,63,1,4,2,2,23,18,0,3,2,1
"2011","E00020993","E00020993","Total",119,88,33,55,0,8,1,7,22,22,0,0,0,1
"2011","E00020973","E00020973","Total",111,20,6,14,1,87,28,59,3,3,0,0,0,0
"2011","E00020979","E00020979","Total",157,123,49,74,0,10,7,3,23,22,0,1,0,1
"2011","E00020980","E00020980","Total",137,43,10,33,0,88,86,2,6,4,0,1,1,0
"2011","E00020983","E00020983","Total",122,75,30,45,1,14,10,4,31,29,0,1,1,1
"2011","E00021077","E00021077","Total",126,50,8,42,1,62,51,11,9,9,0,0,0,4
"2011","E00021097","E00021097","Total",90,61,17,44,0,22,19,3,7,7,0,0,0,0
"2011","E00021098","E00021098","Total",99,58,14,44,1,35,30,5,5,4,0,1,0,0
"2011","E00021100","E00021100","Total",108,94,41,53,0,3,2,1,9,8,0,1,0,2
"2011","E00021102","E00021102","Total",104,49,12,37,0,52,17,35,2,2,0,0,0,1
"2011","E00021105","E00021105","Total",113,95,33,62,0,4,3,1,14,12,0,2,0,0
"2011","E00020734","E00020734","Total",125,112,50,62,1,0,0,0,9,8,0,1,0,3
"2011","E00020738","E00020738","Total",125,119,50,69,0,2,0,2,4,4,0,0,0,0
"2011","E00020739","E00020739","Total",133,128,51,77,0,2,0,2,2,2,0,0,0,1
"2011","E00020749","E00020749","Total",125,114,44,70,0,4,0,4,7,7,0,0,0,0
"2011","E00020723","E00020723","Total",132,119,55,64,0,0,0,0,12,11,0,1,0,1
"2011","E00020724","E00020724","Total",118,80,45,35,0,4,1,3,34,33,0,1,0,0
"2011","E00020726","E00020726","Total",122,107,64,43,0,1,0,1,14,12,0,2,0,0
"2011","E00020730","E00020730","Total",111,104,36,68,0,0,0,0,7,6,0,1,0,0
"2011","E00020752","E00020752","Total",144,55,26,29,2,19,1,18,66,62,0,3,1,2
"2011","E00021122","E00021122","Total",220,124,40,84,8,34,1,33,53,50,0,2,1,1
"2011","E00021123","E00021123","Total",170,134,43,91,1,9,3,6,24,22,0,2,0,2
"2011","E00021129","E00021129","Total",129,77,23,54,0,37,35,2,12,12,0,0,0,3
"2011","E00021132","E00021132","Total",96,65,12,53,2,12,9,3,16,16,0,0,0,1
"2011","E00021134","E00021134","Total",138,116,42,74,0,0,0,0,20,19,0,1,0,2
"2011","E00021110","E00021110","Total",139,99,26,73,0,3,1,2,37,34,0,3,0,0
"2011","E00021130","E00021130","Total",105,91,29,62,1,0,0,0,12,12,0,0,0,1
"2011","E00021131","E00021131","Total",112,103,34,69,1,2,0,2,5,5,0,0,0,1
"2011","E00021140","E00021140","Total",136,112,32,80,1,4,2,2,19,16,0,2,1,0
"2011","E00166816","E00166816","Total",104,20,6,14,0,81,3,78,3,3,0,0,0,0
"2011","E00166817","E00166817","Total",142,84,10,74,1,4,0,4,53,53,0,0,0,0
"2011","E00166818","E00166818","Total",185,157,38,119,0,3,2,1,25,25,0,0,0,0
"2011","E00021109","E00021109","Total",127,74,39,35,1,8,4,4,41,39,1,1,0,3
"2011","E00021127","E00021127","Total",115,44,23,21,0,3,0,3,68,64,1,3,0,0
"2011","E00021128","E00021128","Total",129,107,53,54,0,2,0,2,19,17,0,2,0,1
"2011","E00021135","E00021135","Total",140,91,36,55,0,22,21,1,26,24,0,2,0,1
"2011","E00021139","E00021139","Total",150,109,31,78,1,2,0,2,38,36,0,2,0,0
"2011","E00020858","E00020858","Total",125,76,36,40,0,2,1,1,47,42,4,1,0,0
"2011","E00020860","E00020860","Total",125,114,55,59,0,1,0,1,9,8,0,1,0,1
"2011","E00020865","E00020865","Total",128,121,58,63,0,1,1,0,6,6,0,0,0,0
"2011","E00020871","E00020871","Total",129,110,51,59,0,4,2,2,15,13,0,2,0,0
"2011","E00020874","E00020874","Total",126,111,50,61,0,4,3,1,8,5,1,2,0,3
"2011","E00020866","E00020866","Total",130,114,49,65,0,8,8,0,8,8,0,0,0,0
"2011","E00020867","E00020867","Total",132,91,38,53,0,22,17,5,19,16,0,3,0,0
"2011","E00020868","E00020868","Total",126,110,53,57,2,2,1,1,12,10,0,2,0,0
"2011","E00020869","E00020869","Total",143,112,47,65,9,8,8,0,13,12,0,1,0,1
"2011","E00020872","E00020872","Total",133,96,27,69,1,12,10,2,24,23,0,1,0,0
"2011","E00020873","E00020873","Total",122,101,37,64,0,4,4,0,16,16,0,0,0,1
"2011","E00020861","E00020861","Total",124,102,23,79,1,4,2,2,16,14,0,2,0,1
"2011","E00020878","E00020878","Total",156,99,35,64,0,39,2,37,17,14,2,0,1,1
"2011","E00020879","E00020879","Total",141,106,46,60,0,8,8,0,24,21,0,3,0,3
"2011","E00020883","E00020883","Total",147,72,23,49,0,27,10,17,44,36,3,3,2,4
"2011","E00020887","E00020887","Total",118,96,34,62,1,0,0,0,19,16,0,3,0,2
"2011","E00020859","E00020859","Total",118,100,48,52,0,13,13,0,5,4,0,1,0,0
"2011","E00020870","E00020870","Total",121,111,57,54,0,2,2,0,7,6,0,1,0,1
"2011","E00020875","E00020875","Total",113,107,69,38,0,0,0,0,4,2,0,2,0,2
"2011","E00020876","E00020876","Total",129,85,26,59,0,33,3,30,10,10,0,0,0,1
"2011","E00020881","E00020881","Total",122,110,45,65,0,2,2,0,10,10,0,0,0,0
"2011","E00020722","E00020722","Total",125,123,62,61,0,2,1,1,0,0,0,0,0,0
"2011","E00020733","E00020733","Total",126,79,44,35,0,39,1,38,8,7,0,1,0,0
"2011","E00020735","E00020735","Total",124,120,63,57,0,0,0,0,2,1,0,1,0,2
"2011","E00020744","E00020744","Total",131,110,76,34,0,1,0,1,19,19,0,0,0,1
"2011","E00020745","E00020745","Total",134,128,71,57,0,1,1,0,5,5,0,0,0,0
"2011","E00020728","E00020728","Total",102,60,33,27,0,32,3,29,8,8,0,0,0,2
"2011","E00020729","E00020729","Total",138,124,73,51,0,4,3,1,8,8,0,0,0,2
"2011","E00020731","E00020731","Total",136,122,50,72,1,2,2,0,10,9,0,1,0,1
"2011","E00020732","E00020732","Total",141,134,68,66,0,1,1,0,5,5,0,0,0,1
"2011","E00021111","E00021111","Total",119,114,61,53,1,0,0,0,4,4,0,0,0,0
"2011","E00021115","E00021115","Total",141,131,73,58,0,0,0,0,10,9,0,1,0,0
"2011","E00021116","E00021116","Total",113,95,55,40,0,2,1,1,15,15,0,0,0,1
"2011","E00021138","E00021138","Total",126,112,43,69,1,1,0,1,10,8,0,2,0,2
"2011","E00021117","E00021117","Total",126,102,56,46,1,2,1,1,21,17,2,2,0,0
"2011","E00021118","E00021118","Total",126,117,62,55,0,1,1,0,7,7,0,0,0,1
"2011","E00021119","E00021119","Total",139,112,61,51,2,4,2,2,19,17,0,2,0,2
"2011","E00021120","E00021120","Total",140,91,29,62,2,3,0,3,44,40,0,4,0,0
"2011","E00021121","E00021121","Total",126,109,55,54,1,0,0,0,15,12,0,3,0,1
"2011","E00021124","E00021124","Total",115,99,40,59,0,3,1,2,12,9,0,3,0,1
"2011","E00021125","E00021125","Total",103,95,27,68,0,1,0,1,7,7,0,0,0,0
"2011","E00021126","E00021126","Total",141,120,46,74,1,5,1,4,15,13,0,2,0,0
"2011","E00021133","E00021133","Total",130,108,60,48,4,1,0,1,17,13,0,4,0,0
"2011","E00021137","E00021137","Total",120,65,25,40,0,42,0,42,10,10,0,0,0,3
"2011","E00021112","E00021112","Total",161,131,61,70,0,6,2,4,24,23,0,1,0,0
"2011","E00021113","E00021113","Total",134,116,47,69,0,2,0,2,15,13,0,2,0,1
"2011","E00021114","E00021114","Total",139,134,75,59,0,0,0,0,5,5,0,0,0,0
"2011","E00021136","E00021136","Total",133,118,53,65,1,1,1,0,11,8,0,3,0,2
"2011","E00020692","E00020692","Total",144,118,33,85,0,0,0,0,25,24,0,1,0,1
"2011","E00020708","E00020708","Total",135,131,63,68,0,0,0,0,4,4,0,0,0,0
"2011","E00020709","E00020709","Total",130,103,44,59,0,2,1,1,25,21,1,3,0,0
"2011","E00020710","E00020710","Total",129,122,45,77,0,1,0,1,5,3,0,2,0,1
"2011","E00020711","E00020711","Total",126,118,56,62,0,0,0,0,6,6,0,0,0,2
"2011","E00020740","E00020740","Total",116,103,51,52,1,0,0,0,12,10,1,1,0,0
"2011","E00020741","E00020741","Total",141,94,51,43,1,9,8,1,34,32,0,1,1,3
"2011","E00020742","E00020742","Total",168,95,42,53,1,13,2,11,59,56,0,2,1,0
"2011","E00020746","E00020746","Total",140,124,58,66,0,1,0,1,14,14,0,0,0,1
"2011","E00020747","E00020747","Total",104,98,55,43,0,1,0,1,5,5,0,0,0,0
"2011","E00020727","E00020727","Total",126,114,40,74,0,0,0,0,12,11,1,0,0,0
"2011","E00020736","E00020736","Total",125,120,55,65,0,0,0,0,5,5,0,0,0,0
"2011","E00020737","E00020737","Total",129,118,51,67,1,2,1,1,7,6,0,1,0,1
"2011","E00020743","E00020743","Total",126,119,45,74,0,0,0,0,6,6,0,0,0,1
"2011","E00020791","E00020791","Total",133,124,57,67,1,1,0,1,7,7,0,0,0,0
"2011","E00020793","E00020793","Total",126,112,50,62,0,2,2,0,10,9,0,1,0,2
"2011","E00020796","E00020796","Total",136,128,42,86,0,0,0,0,8,8,0,0,0,0
"2011","E00020816","E00020816","Total",119,106,48,58,0,1,1,0,12,10,0,2,0,0
"2011","E00020788","E00020788","Total",134,127,49,78,0,0,0,0,6,4,0,2,0,1
"2011","E00020789","E00020789","Total",132,120,49,71,0,3,1,2,9,8,0,1,0,0
"2011","E00020792","E00020792","Total",126,122,55,67,0,0,0,0,4,3,0,1,0,0
"2011","E00020794","E00020794","Total",141,128,50,78,0,1,0,1,10,10,0,0,0,2
"2011","E00021008","E00021008","Total",128,112,44,68,0,1,1,0,15,12,0,3,0,0
"2011","E00021012","E00021012","Total",107,93,45,48,0,2,1,1,11,11,0,0,0,1
"2011","E00021013","E00021013","Total",95,71,28,43,5,8,1,7,11,9,0,2,0,0
"2011","E00021033","E00021033","Total",114,102,47,55,0,1,1,0,10,7,2,1,0,1
"2011","E00021034","E00021034","Total",114,84,41,43,0,26,5,21,4,4,0,0,0,0
"2011","E00021014","E00021014","Total",125,98,44,54,0,5,2,3,21,21,0,0,0,1
"2011","E00021017","E00021017","Total",105,66,32,34,1,3,1,2,34,32,0,2,0,1
"2011","E00021018","E00021018","Total",117,57,21,36,0,23,12,11,37,37,0,0,0,0
"2011","E00021020","E00021020","Total",131,44,8,36,1,72,39,33,13,13,0,0,0,1
"2011","E00021024","E00021024","Total",133,45,18,27,0,60,37,23,28,25,0,2,1,0
"2011","E00021025","E00021025","Total",137,74,25,49,0,27,26,1,34,32,0,2,0,2
"2011","E00021016","E00021016","Total",125,67,36,31,0,53,8,45,3,3,0,0,0,2
"2011","E00021019","E00021019","Total",127,102,37,65,0,14,11,3,10,9,0,1,0,1
"2011","E00021022","E00021022","Total",121,82,29,53,0,34,31,3,5,4,0,1,0,0
"2011","E00021027","E00021027","Total",147,129,61,68,0,5,4,1,12,12,0,0,0,1
"2011","E00021006","E00021006","Total",132,106,42,64,1,3,3,0,22,22,0,0,0,0
"2011","E00021007","E00021007","Total",168,136,45,91,0,11,2,9,21,19,0,2,0,0
"2011","E00021030","E00021030","Total",131,59,20,39,4,51,35,16,17,17,0,0,0,0
"2011","E00021031","E00021031","Total",130,108,46,62,0,17,14,3,4,3,0,0,1,1
"2011","E00021032","E00021032","Total",129,101,36,65,2,2,2,0,20,19,0,1,0,4
"2011","E00021009","E00021009","Total",108,31,9,22,20,47,32,15,9,7,0,1,1,1
"2011","E00021015","E00021015","Total",121,101,33,68,0,3,1,2,17,14,0,2,1,0
"2011","E00021021","E00021021","Total",133,94,22,72,0,3,1,2,36,34,0,2,0,0
"2011","E00021023","E00021023","Total",114,93,42,51,0,5,4,1,14,14,0,0,0,2
"2011","E00021035","E00021035","Total",107,69,12,57,1,7,2,5,30,30,0,0,0,0
"2011","E00020535","E00020535","Total",148,97,24,73,0,30,30,0,21,21,0,0,0,0
"2011","E00020536","E00020536","Total",119,63,21,42,1,45,41,4,9,9,0,0,0,1
"2011","E00020544","E00020544","Total",121,87,34,53,0,10,0,10,23,21,1,0,1,1
"2011","E00020547","E00020547","Total",112,87,29,58,2,4,3,1,17,15,0,1,1,2
"2011","E00020548","E00020548","Total",116,85,36,49,1,23,21,2,6,6,0,0,0,1
"2011","E00020541","E00020541","Total",137,78,29,49,0,37,15,22,22,22,0,0,0,0
"2011","E00020546","E00020546","Total",128,112,39,73,0,4,3,1,12,10,0,2,0,0
"2011","E00020549","E00020549","Total",125,111,62,49,0,3,3,0,10,9,0,1,0,1
"2011","E00020551","E00020551","Total",129,111,54,57,1,8,4,4,7,7,0,0,0,2
"2011","E00020554","E00020554","Total",110,80,34,46,0,4,3,1,23,18,2,3,0,3
"2011","E00020537","E00020537","Total",133,81,19,62,1,29,20,9,20,17,1,2,0,2
"2011","E00020538","E00020538","Total",138,109,30,79,0,7,6,1,19,17,0,2,0,3
"2011","E00020539","E00020539","Total",146,79,18,61,0,45,10,35,22,21,0,1,0,0
"2011","E00020540","E00020540","Total",150,107,34,73,0,27,24,3,16,13,0,3,0,0
"2011","E00020543","E00020543","Total",119,72,15,57,0,18,7,11,29,26,0,2,1,0
"2011","E00020534","E00020534","Total",122,114,58,56,1,2,2,0,4,4,0,0,0,1
"2011","E00020550","E00020550","Total",120,113,45,68,0,1,1,0,6,5,0,1,0,0
"2011","E00020552","E00020552","Total",124,113,44,69,1,0,0,0,10,9,0,1,0,0
"2011","E00020556","E00020556","Total",123,118,60,58,0,2,1,1,2,2,0,0,0,1
"2011","E00020542","E00020542","Total",123,113,49,64,0,1,0,1,7,6,0,1,0,2
"2011","E00020545","E00020545","Total",124,118,67,51,1,1,1,0,4,4,0,0,0,0
"2011","E00020553","E00020553","Total",132,119,62,57,0,0,0,0,12,12,0,0,0,1
"2011","E00020555","E00020555","Total",127,122,56,66,0,0,0,0,5,5,0,0,0,0
"2011","E00020531","E00020531","Total",125,106,46,60,0,1,1,0,17,16,1,0,0,1
"2011","E00020533","E00020533","Total",128,113,28,85,1,1,0,1,13,13,0,0,0,0
"2011","E00020559","E00020559","Total",102,47,21,26,1,45,36,9,7,7,0,0,0,2
"2011","E00020561","E00020561","Total",151,121,40,81,1,10,5,5,19,17,0,2,0,0
"2011","E00020562","E00020562","Total",109,89,25,64,0,2,1,1,18,17,0,0,1,0
"2011","E00020532","E00020532","Total",119,113,48,65,0,1,1,0,4,4,0,0,0,1
"2011","E00020557","E00020557","Total",129,118,50,68,0,1,1,0,10,10,0,0,0,0
"2011","E00020558","E00020558","Total",132,120,50,70,1,2,1,1,9,7,0,2,0,0
"2011","E00020560","E00020560","Total",116,108,40,68,0,1,0,1,6,5,0,1,0,1
"2011","E00020823","E00020823","Total",102,54,18,36,0,12,4,8,36,36,0,0,0,0
"2011","E00020827","E00020827","Total",177,61,27,34,1,4,1,3,107,105,0,2,0,4
"2011","E00020849","E00020849","Total",97,80,38,42,0,5,2,3,12,11,0,1,0,0
"2011","E00020855","E00020855","Total",114,68,28,40,1,3,1,2,42,40,0,1,1,0
"2011","E00020856","E00020856","Total",122,100,36,64,4,3,2,1,15,13,0,2,0,0
"2011","E00020857","E00020857","Total",151,67,19,48,2,1,1,0,80,77,0,3,0,1
"2011","E00020831","E00020831","Total",154,48,9,39,5,71,10,61,29,28,0,0,1,1
"2011","E00020835","E00020835","Total",123,59,14,45,0,1,0,1,62,60,0,1,1,1
"2011","E00020836","E00020836","Total",81,22,4,18,1,37,33,4,20,20,0,0,0,1
"2011","E00020837","E00020837","Total",127,40,18,22,2,49,42,7,34,33,0,1,0,2
"2011","E00020841","E00020841","Total",125,40,10,30,0,73,64,9,11,8,0,3,0,1
"2011","E00020845","E00020845","Total",136,41,13,28,0,85,75,10,10,8,0,1,1,0
"2011","E00020819","E00020819","Total",146,81,24,57,0,19,5,14,46,44,0,2,0,0
"2011","E00020832","E00020832","Total",78,26,12,14,0,41,36,5,11,11,0,0,0,0
"2011","E00020833","E00020833","Total",128,85,16,69,1,18,18,0,23,20,2,1,0,1
"2011","E00020839","E00020839","Total",120,101,68,33,1,4,3,1,9,8,0,1,0,5
"2011","E00020840","E00020840","Total",106,58,19,39,0,35,30,5,12,12,0,0,0,1
"2011","E00020847","E00020847","Total",146,63,20,43,1,65,54,11,17,15,0,2,0,0
"2011","E00020821","E00020821","Total",117,73,28,45,0,27,25,2,16,16,0,0,0,1
"2011","E00020838","E00020838","Total",116,13,4,9,2,91,76,15,10,10,0,0,0,0
"2011","E00020843","E00020843","Total",123,21,6,15,0,97,85,12,4,4,0,0,0,1
"2011","E00020848","E00020848","Total",136,57,17,40,14,15,13,2,49,46,1,0,2,1
"2011","E00020850","E00020850","Total",119,23,6,17,0,82,58,24,14,13,0,1,0,0
"2011","E00166822","E00166822","Total",68,4,0,4,1,10,3,7,46,42,3,0,1,7
"2011","E00166823","E00166823","Total",105,11,3,8,1,67,47,20,23,22,0,1,0,3
"2011","E00166824","E00166824","Total",158,48,10,38,6,41,5,36,62,62,0,0,0,1
"2011","E00166825","E00166825","Total",110,12,3,9,69,23,2,21,5,4,0,0,1,1
"2011","E00020862","E00020862","Total",137,120,84,36,0,10,9,1,6,6,0,0,0,1
"2011","E00020877","E00020877","Total",155,124,61,63,0,2,1,1,28,28,0,0,0,1
"2011","E00020882","E00020882","Total",127,93,48,45,0,17,1,16,17,16,0,1,0,0
"2011","E00020885","E00020885","Total",127,63,23,40,0,4,2,2,59,59,0,0,0,1
"2011","E00020888","E00020888","Total",135,108,61,47,0,3,1,2,24,24,0,0,0,0
"2011","E00020889","E00020889","Total",132,80,30,50,0,32,16,16,17,16,0,0,1,3
"2011","E00020634","E00020634","Total",138,118,52,66,0,3,0,3,16,14,0,1,1,1
"2011","E00020656","E00020656","Total",120,103,56,47,0,3,1,2,14,12,0,2,0,0
"2011","E00020658","E00020658","Total",139,121,47,74,0,4,3,1,13,12,0,1,0,1
"2011","E00020661","E00020661","Total",134,125,72,53,0,3,1,2,4,4,0,0,0,2
"2011","E00020636","E00020636","Total",117,88,28,60,0,12,2,10,17,15,0,0,2,0
"2011","E00020639","E00020639","Total",139,104,34,70,1,4,1,3,30,28,0,2,0,0
"2011","E00020640","E00020640","Total",126,100,42,58,1,1,1,0,24,24,0,0,0,0
"2011","E00020641","E00020641","Total",120,86,34,52,1,2,1,1,31,27,0,4,0,0
"2011","E00020642","E00020642","Total",114,58,19,39,0,15,1,14,39,32,0,7,0,2
"2011","E00020645","E00020645","Total",118,79,21,58,1,1,0,1,36,34,0,2,0,1
"2011","E00020820","E00020820","Total",123,86,30,56,0,22,15,7,14,13,0,1,0,1
"2011","E00020826","E00020826","Total",125,86,28,58,3,9,5,4,27,26,0,1,0,0
"2011","E00020834","E00020834","Total",101,37,9,28,0,51,0,51,13,12,0,1,0,0
"2011","E00020842","E00020842","Total",113,97,34,63,1,2,0,2,12,12,0,0,0,1
"2011","E00020846","E00020846","Total",122,75,19,56,0,3,2,1,44,41,0,3,0,0
"2011","E00020854","E00020854","Total",113,74,11,63,0,8,3,5,31,30,0,0,1,0
"2011","E00020818","E00020818","Total",118,70,26,44,0,25,12,13,23,21,0,2,0,0
"2011","E00020822","E00020822","Total",125,79,24,55,1,4,2,2,39,36,0,3,0,2
"2011","E00020825","E00020825","Total",107,100,39,61,0,1,1,0,6,6,0,0,0,0
"2011","E00020828","E00020828","Total",126,62,18,44,0,3,2,1,61,60,0,1,0,0
"2011","E00020830","E00020830","Total",119,96,34,62,2,0,0,0,20,18,0,2,0,1
"2011","E00020978","E00020978","Total",137,123,49,74,0,2,2,0,12,10,1,0,1,0
"2011","E00020988","E00020988","Total",106,73,25,48,2,18,2,16,13,10,0,3,0,0
"2011","E00020991","E00020991","Total",113,106,51,55,0,0,0,0,7,6,0,0,1,0
"2011","E00020992","E00020992","Total",105,99,56,43,1,2,1,1,3,3,0,0,0,0
"2011","E00020995","E00020995","Total",118,98,34,64,2,0,0,0,18,18,0,0,0,0
"2011","E00020824","E00020824","Total",128,77,24,53,0,16,3,13,35,33,0,2,0,0
"2011","E00020844","E00020844","Total",121,77,22,55,2,18,2,16,24,22,0,2,0,0
"2011","E00020851","E00020851","Total",123,75,22,53,0,34,2,32,14,14,0,0,0,0
"2011","E00020852","E00020852","Total",128,109,34,75,2,1,1,0,14,12,0,2,0,2
"2011","E00020853","E00020853","Total",126,98,39,59,0,6,2,4,22,22,0,0,0,0
"2011","E00020863","E00020863","Total",125,82,28,54,1,15,11,4,27,26,0,1,0,0
"2011","E00020864","E00020864","Total",140,6,2,4,0,124,112,12,9,9,0,0,0,1
"2011","E00020880","E00020880","Total",117,96,35,61,0,8,6,2,13,10,0,2,1,0
"2011","E00020884","E00020884","Total",144,115,35,80,0,9,3,6,19,18,0,1,0,1
"2011","E00020886","E00020886","Total",117,59,21,38,2,42,40,2,13,13,0,0,0,1
"2011","E00020929","E00020929","Total",128,107,40,67,0,8,7,1,12,11,0,0,1,1
"2011","E00020944","E00020944","Total",115,87,38,49,1,13,13,0,13,11,0,2,0,1
"2011","E00020945","E00020945","Total",131,113,55,58,0,1,0,1,17,15,0,2,0,0
"2011","E00020946","E00020946","Total",117,84,40,44,5,2,1,1,24,24,0,0,0,2
"2011","E00020947","E00020947","Total",138,117,47,70,0,4,2,2,15,14,0,1,0,2
"2011","E00020949","E00020949","Total",134,111,43,68,0,1,1,0,22,20,0,2,0,0
"2011","E00020950","E00020950","Total",152,95,34,61,1,2,2,0,52,51,0,1,0,2
"2011","E00020951","E00020951","Total",146,97,26,71,0,2,1,1,47,44,0,3,0,0
"2011","E00020954","E00020954","Total",126,65,20,45,0,6,0,6,55,53,0,2,0,0
"2011","E00020959","E00020959","Total",114,97,43,54,0,9,6,3,8,8,0,0,0,0
"2011","E00020930","E00020930","Total",119,102,27,75,0,3,3,0,13,13,0,0,0,1
"2011","E00020931","E00020931","Total",126,112,43,69,1,2,1,1,11,9,0,1,1,0
"2011","E00020948","E00020948","Total",120,108,34,74,0,2,1,1,10,7,0,3,0,0
"2011","E00020955","E00020955","Total",108,82,23,59,0,1,0,1,25,22,0,3,0,0
"2011","E00020957","E00020957","Total",121,98,37,61,0,4,4,0,19,19,0,0,0,0
"2011","E00020647","E00020647","Total",118,104,36,68,0,1,1,0,13,13,0,0,0,0
"2011","E00020648","E00020648","Total",147,72,22,50,1,6,2,4,68,67,0,1,0,0
"2011","E00020652","E00020652","Total",121,111,48,63,0,1,0,1,8,8,0,0,0,1
"2011","E00020653","E00020653","Total",119,113,59,54,0,2,1,1,4,3,1,0,0,0
"2011","E00020654","E00020654","Total",120,98,35,63,1,3,1,2,17,16,0,1,0,1
"2011","E00020649","E00020649","Total",124,108,58,50,0,1,0,1,13,12,0,1,0,2
"2011","E00020650","E00020650","Total",124,79,30,49,0,6,3,3,38,37,0,1,0,1
"2011","E00020651","E00020651","Total",120,102,55,47,0,4,0,4,14,13,0,0,1,0
"2011","E00020655","E00020655","Total",136,110,44,66,0,7,7,0,19,17,0,2,0,0
"2011","E00020632","E00020632","Total",92,9,1,8,1,67,2,65,12,11,1,0,0,3
"2011","E00020633","E00020633","Total",119,73,22,51,0,26,22,4,17,16,0,1,0,3
"2011","E00020635","E00020635","Total",128,69,38,31,0,15,6,9,42,40,0,2,0,2
"2011","E00020657","E00020657","Total",123,93,24,69,0,12,10,2,18,15,0,3,0,0
"2011","E00020659","E00020659","Total",127,73,25,48,0,26,16,10,28,27,0,1,0,0
"2011","E00020663","E00020663","Total",122,96,43,53,0,0,0,0,26,24,0,2,0,0
"2011","E00020638","E00020638","Total",133,120,52,68,0,0,0,0,13,10,0,3,0,0
"2011","E00020646","E00020646","Total",123,89,35,54,0,15,8,7,19,19,0,0,0,0
"2011","E00020660","E00020660","Total",139,131,76,55,0,1,0,1,7,7,0,0,0,0
"2011","E00020662","E00020662","Total",141,111,66,45,0,7,2,5,22,20,0,2,0,1
"2011","E00020631","E00020631","Total",112,105,59,46,1,2,0,2,4,4,0,0,0,0
"2011","E00020637","E00020637","Total",152,89,35,54,1,28,17,11,32,29,2,1,0,2
"2011","E00020643","E00020643","Total",141,108,42,66,0,5,1,4,27,25,1,1,0,1
"2011","E00020644","E00020644","Total",151,123,52,71,0,11,0,11,15,13,1,0,1,2
"2011","E00020694","E00020694","Total",148,69,27,42,0,2,0,2,75,66,2,7,0,2
"2011","E00020716","E00020716","Total",137,131,61,70,0,2,2,0,4,4,0,0,0,0
"2011","E00020717","E00020717","Total",204,82,35,47,0,14,1,13,104,99,4,1,0,4
"2011","E00020718","E00020718","Total",162,106,60,46,1,27,19,8,25,23,0,2,0,3
"2011","E00020720","E00020720","Total",139,94,46,48,0,2,0,2,41,40,0,1,0,2
"2011","E00020712","E00020712","Total",120,112,37,75,0,1,0,1,5,5,0,0,0,2
"2011","E00020713","E00020713","Total",114,103,33,70,0,2,2,0,9,9,0,0,0,0
"2011","E00020714","E00020714","Total",145,112,56,56,0,2,1,1,29,27,0,2,0,2
"2011","E00020715","E00020715","Total",136,123,49,74,2,4,2,2,7,4,0,3,0,0
"2011","E00020719","E00020719","Total",63,22,19,3,0,31,26,5,7,6,0,1,0,3
"2011","E00020693","E00020693","Total",143,104,57,47,1,1,0,1,35,33,0,2,0,2
"2011","E00020695","E00020695","Total",137,119,82,37,0,0,0,0,17,15,0,2,0,1
"2011","E00020696","E00020696","Total",129,121,71,50,0,0,0,0,7,7,0,0,0,1
"2011","E00020699","E00020699","Total",122,116,54,62,0,1,1,0,4,4,0,0,0,1
"2011","E00020721","E00020721","Total",137,118,53,65,0,0,0,0,17,17,0,0,0,2
"2011","E00020725","E00020725","Total",127,107,45,62,0,0,0,0,17,16,0,1,0,3
"2011","E00020748","E00020748","Total",125,122,54,68,0,1,0,1,2,2,0,0,0,0
"2011","E00020750","E00020750","Total",149,140,72,68,0,3,3,0,5,5,0,0,0,1
"2011","E00020751","E00020751","Total",146,141,71,70,0,1,0,1,3,3,0,0,0,1
"2011","E00020936","E00020936","Total",113,108,51,57,0,2,2,0,3,3,0,0,0,0
"2011","E00020938","E00020938","Total",106,101,53,48,0,1,0,1,4,4,0,0,0,0
"2011","E00020963","E00020963","Total",107,102,41,61,0,0,0,0,5,4,0,1,0,0
"2011","E00020965","E00020965","Total",126,114,57,57,0,1,0,1,11,10,0,1,0,0
"2011","E00020572","E00020572","Total",126,116,56,60,0,2,1,1,8,8,0,0,0,0
"2011","E00020576","E00020576","Total",142,134,69,65,0,0,0,0,6,6,0,0,0,2
"2011","E00020583","E00020583","Total",115,113,62,51,0,2,1,1,0,0,0,0,0,0
"2011","E00020586","E00020586","Total",139,133,71,62,0,0,0,0,6,6,0,0,0,0
"2011","E00021003","E00021003","Total",128,90,47,43,0,20,17,3,17,17,0,0,0,1
"2011","E00021004","E00021004","Total",213,99,34,65,9,7,5,2,97,90,0,4,3,1
"2011","E00021005","E00021005","Total",148,116,48,68,0,9,6,3,22,21,0,1,0,1
"2011","E00021010","E00021010","Total",150,112,42,70,1,3,0,3,32,32,0,0,0,2
"2011","E00021026","E00021026","Total",112,93,31,62,0,2,2,0,16,16,0,0,0,1
"2011","E00021001","E00021001","Total",136,121,44,77,2,0,0,0,11,10,0,1,0,2
"2011","E00021002","E00021002","Total",131,57,24,33,1,11,5,6,61,60,0,0,1,1
"2011","E00021011","E00021011","Total",123,69,29,40,0,21,1,20,31,30,0,1,0,2
"2011","E00021028","E00021028","Total",141,107,44,63,1,7,1,6,25,22,0,2,1,1
"2011","E00021029","E00021029","Total",133,77,22,55,0,20,15,5,36,35,0,1,0,0
"2011","E00021042","E00021042","Total",128,91,35,56,0,0,0,0,34,32,0,2,0,3
"2011","E00021046","E00021046","Total",143,83,41,42,1,1,0,1,56,51,0,5,0,2
"2011","E00021049","E00021049","Total",114,86,23,63,1,2,0,2,25,23,0,2,0,0
"2011","E00021065","E00021065","Total",148,61,21,40,1,63,2,61,23,23,0,0,0,0
"2011","E00021066","E00021066","Total",143,62,15,47,2,28,4,24,50,48,0,1,1,1
"2011","E00021068","E00021068","Total",112,77,33,44,3,0,0,0,32,30,0,2,0,0
"2011","E00021070","E00021070","Total",162,79,28,51,0,9,0,9,73,70,2,1,0,1
"2011","E00021037","E00021037","Total",121,98,40,58,0,0,0,0,23,23,0,0,0,0
"2011","E00021044","E00021044","Total",120,84,37,47,0,2,1,1,34,32,0,2,0,0
"2011","E00021051","E00021051","Total",128,124,54,70,0,2,1,1,1,0,0,1,0,1
"2011","E00021054","E00021054","Total",87,78,28,50,1,5,0,5,3,2,0,1,0,0
"2011","E00021055","E00021055","Total",143,107,38,69,0,6,4,2,29,29,0,0,0,1
"2011","E00020903","E00020903","Total",111,51,28,23,0,19,2,17,40,39,0,1,0,1
"2011","E00020906","E00020906","Total",162,75,44,31,0,40,36,4,47,43,0,4,0,0
"2011","E00020908","E00020908","Total",113,66,31,35,0,9,1,8,38,36,1,1,0,0
"2011","E00020909","E00020909","Total",131,78,37,41,0,2,0,2,51,48,0,3,0,0
"2011","E00020911","E00020911","Total",105,52,24,28,0,15,1,14,37,36,0,0,1,1
"2011","E00020912","E00020912","Total",101,35,10,25,0,42,6,36,23,22,0,1,0,1
"2011","E00020917","E00020917","Total",126,48,28,20,1,26,18,8,50,45,0,4,1,1
"2011","E00020893","E00020893","Total",100,65,27,38,0,0,0,0,35,34,0,0,1,0
"2011","E00020894","E00020894","Total",117,67,24,43,0,3,2,1,47,46,0,1,0,0
"2011","E00020915","E00020915","Total",115,63,31,32,2,1,0,1,48,47,0,1,0,1
"2011","E00020918","E00020918","Total",119,76,45,31,0,2,2,0,40,38,1,1,0,1
"2011","E00020922","E00020922","Total",131,97,44,53,0,2,0,2,32,29,1,2,0,0
"2011","E00020923","E00020923","Total",125,80,21,59,1,9,7,2,34,32,0,1,1,1
"2011","E00020925","E00020925","Total",115,85,29,56,0,0,0,0,30,29,0,1,0,0
"2011","E00020932","E00020932","Total",115,62,27,35,1,0,0,0,52,51,1,0,0,0
"2011","E00020933","E00020933","Total",135,70,36,34,2,0,0,0,63,60,0,3,0,0
"2011","E00020934","E00020934","Total",151,64,29,35,1,3,0,3,82,80,0,2,0,1
"2011","E00020937","E00020937","Total",124,55,25,30,0,31,2,29,38,38,0,0,0,0
"2011","E00020939","E00020939","Total",122,54,24,30,1,3,2,1,64,63,0,1,0,0
"2011","E00020961","E00020961","Total",123,64,34,30,0,2,1,1,54,52,0,2,0,3
"2011","E00020964","E00020964","Total",122,52,35,17,0,2,0,2,66,63,0,3,0,2
"2011","E00020935","E00020935","Total",105,75,36,39,0,2,0,2,27,21,0,6,0,1
"2011","E00020940","E00020940","Total",121,58,28,30,1,1,0,1,59,55,0,4,0,2
"2011","E00020941","E00020941","Total",123,86,45,41,1,2,1,1,34,33,0,1,0,0
"2011","E00020942","E00020942","Total",114,92,56,36,0,1,0,1,21,21,0,0,0,0
"2011","E00020943","E00020943","Total",125,80,41,39,1,7,4,3,36,36,0,0,0,1
"2011","E00020966","E00020966","Total",108,63,16,47,0,9,0,9,33,28,0,5,0,3
"2011","E00020952","E00020952","Total",134,78,36,42,1,2,1,1,53,53,0,0,0,0
"2011","E00020953","E00020953","Total",126,63,29,34,0,23,17,6,37,36,0,1,0,3
"2011","E00020956","E00020956","Total",126,59,20,39,0,24,3,21,42,39,0,2,1,1
"2011","E00020958","E00020958","Total",121,77,20,57,0,5,1,4,39,39,0,0,0,0
"2011","E00020960","E00020960","Total",121,71,42,29,0,0,0,0,48,48,0,0,0,2
"2011","E00020962","E00020962","Total",117,74,22,52,0,0,0,0,42,40,0,2,0,1
"2011","E00020567","E00020567","Total",46,2,0,2,2,40,7,33,2,2,0,0,0,0
"2011","E00020579","E00020579","Total",198,17,5,12,7,165,30,135,7,7,0,0,0,2
"2011","E00020581","E00020581","Total",135,17,5,12,1,110,25,85,6,6,0,0,0,1
"2011","E00020582","E00020582","Total",94,24,11,13,7,60,12,48,2,2,0,0,0,1
"2011","E00020584","E00020584","Total",139,84,42,42,1,38,7,31,14,12,0,2,0,2
"2011","E00020564","E00020564","Total",210,102,38,64,29,64,16,48,12,12,0,0,0,3
"2011","E00020569","E00020569","Total",137,106,60,46,0,6,3,3,24,23,0,1,0,1
"2011","E00020594","E00020594","Total",119,91,35,56,2,8,6,2,18,14,2,2,0,0
"2011","E00020595","E00020595","Total",126,106,48,58,0,3,0,3,17,16,0,1,0,0
"2011","E00020565","E00020565","Total",182,5,2,3,0,174,23,151,1,0,0,1,0,2
"2011","E00020571","E00020571","Total",140,12,3,9,0,120,33,87,4,4,0,0,0,4
"2011","E00020575","E00020575","Total",127,18,2,16,6,94,28,66,9,9,0,0,0,0
"2011","E00020577","E00020577","Total",154,9,1,8,0,140,13,127,3,2,1,0,0,2
"2011","E00020580","E00020580","Total",130,9,1,8,0,112,14,98,2,1,0,0,1,7
"2011","E00020566","E00020566","Total",88,36,9,27,15,29,4,25,8,8,0,0,0,0
"2011","E00020570","E00020570","Total",88,12,2,10,0,74,18,56,2,2,0,0,0,0
"2011","E00020573","E00020573","Total",140,26,6,20,2,104,18,86,8,7,0,1,0,0
"2011","E00020574","E00020574","Total",99,43,24,19,5,45,8,37,5,5,0,0,0,1
"2011","E00020578","E00020578","Total",134,20,7,13,37,69,12,57,8,6,0,2,0,0
"2011","E00021062","E00021062","Total",136,108,27,81,1,8,3,5,19,18,0,1,0,0
"2011","E00021063","E00021063","Total",131,34,6,28,1,79,4,75,15,14,0,1,0,2
"2011","E00021064","E00021064","Total",144,63,20,43,0,67,35,32,14,13,0,1,0,0
"2011","E00021067","E00021067","Total",125,40,11,29,0,80,16,64,4,4,0,0,0,1
"2011","E00021069","E00021069","Total",117,51,24,27,0,32,5,27,33,31,0,2,0,1
"2011","E00020672","E00020672","Total",131,126,64,62,1,1,0,1,3,3,0,0,0,0
"2011","E00020673","E00020673","Total",100,97,53,44,0,1,1,0,2,2,0,0,0,0
"2011","E00020674","E00020674","Total",126,110,46,64,1,1,0,1,13,13,0,0,0,1
"2011","E00020675","E00020675","Total",87,86,47,39,0,1,0,1,0,0,0,0,0,0
"2011","E00020676","E00020676","Total",107,92,62,30,0,4,1,3,10,8,0,2,0,1
"2011","E00020678","E00020678","Total",102,74,30,44,0,16,8,8,10,9,0,1,0,2
"2011","E00020680","E00020680","Total",134,98,34,64,0,28,28,0,8,8,0,0,0,0
"2011","E00020681","E00020681","Total",130,111,47,64,0,7,6,1,10,10,0,0,0,2
"2011","E00020684","E00020684","Total",136,95,36,59,0,30,30,0,11,11,0,0,0,0
"2011","E00020687","E00020687","Total",117,60,10,50,0,36,33,3,21,21,0,0,0,0
"2011","E00021036","E00021036","Total",126,45,17,28,0,59,2,57,22,20,0,1,1,0
"2011","E00021039","E00021039","Total",146,86,39,47,0,33,0,33,27,26,0,1,0,0
"2011","E00021045","E00021045","Total",144,96,74,22,0,26,10,16,19,19,0,0,0,3
"2011","E00021047","E00021047","Total",116,30,17,13,0,40,8,32,46,45,1,0,0,0
"2011","E00021048","E00021048","Total",122,77,54,23,0,15,2,13,26,25,0,1,0,4
"2011","E00021050","E00021050","Total",133,43,15,28,0,55,3,52,32,32,0,0,0,3
"2011","E00021052","E00021052","Total",124,76,31,45,0,16,1,15,28,25,0,3,0,4
"2011","E00021041","E00021041","Total",145,139,82,57,1,1,1,0,4,3,0,1,0,0
"2011","E00021043","E00021043","Total",122,103,57,46,0,0,0,0,16,15,0,0,1,3
"2011","E00021053","E00021053","Total",120,110,44,66,0,4,1,3,5,5,0,0,0,1
"2011","E00021056","E00021056","Total",106,98,59,39,0,1,0,1,5,5,0,0,0,2
"2011","E00021058","E00021058","Total",123,118,75,43,0,2,2,0,3,3,0,0,0,0
"2011","E00021038","E00021038","Total",185,106,42,64,2,34,17,17,42,38,0,4,0,1
"2011","E00021040","E00021040","Total",122,94,42,52,0,13,1,12,15,14,0,0,1,0
"2011","E00021057","E00021057","Total",98,56,19,37,0,27,8,19,12,11,1,0,0,3
"2011","E00021059","E00021059","Total",105,73,38,35,0,12,1,11,20,18,0,2,0,0
"2011","E00021060","E00021060","Total",122,100,59,41,0,1,1,0,19,19,0,0,0,2
"2011","E00021061","E00021061","Total",124,80,49,31,0,14,6,8,27,26,0,1,0,3
"2011","E00020614","E00020614","Total",135,50,13,37,0,60,51,9,25,24,0,1,0,0
"2011","E00020615","E00020615","Total",142,22,4,18,0,112,82,30,7,7,0,0,0,1
"2011","E00020617","E00020617","Total",137,35,10,25,0,88,79,9,14,13,0,1,0,0
"2011","E00020620","E00020620","Total",126,63,24,39,0,42,33,9,19,16,0,0,3,2
"2011","E00020601","E00020601","Total",98,15,8,7,0,63,6,57,20,17,0,2,1,0
"2011","E00020603","E00020603","Total",134,64,16,48,0,5,1,4,65,65,0,0,0,0
"2011","E00020606","E00020606","Total",155,77,12,65,2,2,1,1,74,71,0,1,2,0
"2011","E00020607","E00020607","Total",128,86,45,41,0,1,1,0,39,36,0,3,0,2
"2011","E00020608","E00020608","Total",111,59,28,31,0,5,3,2,45,43,0,2,0,2
"2011","E00020610","E00020610","Total",130,66,19,47,0,1,1,0,62,57,0,3,2,1
"2011","E00020891","E00020891","Total",184,18,8,10,0,130,5,125,33,33,0,0,0,3
"2011","E00020895","E00020895","Total",139,84,73,11,0,9,3,6,40,38,0,2,0,6
"2011","E00020898","E00020898","Total",101,20,6,14,1,5,0,5,75,75,0,0,0,0
"2011","E00020899","E00020899","Total",103,41,11,30,0,1,1,0,60,51,0,9,0,1
"2011","E00020902","E00020902","Total",108,36,25,11,0,43,38,5,27,26,0,1,0,2
"2011","E00020904","E00020904","Total",171,76,37,39,1,49,5,44,44,44,0,0,0,1
"2011","E00020905","E00020905","Total",130,78,32,46,0,14,3,11,38,36,0,2,0,0
"2011","E00020896","E00020896","Total",136,89,45,44,0,0,0,0,46,41,1,3,1,1
"2011","E00020897","E00020897","Total",103,35,11,24,0,2,0,2,65,64,0,1,0,1
"2011","E00020901","E00020901","Total",162,66,23,43,0,32,1,31,62,61,0,1,0,2
"2011","E00020907","E00020907","Total",143,76,32,44,0,8,2,6,59,58,0,1,0,0
"2011","E00020927","E00020927","Total",120,92,35,57,0,3,0,3,25,25,0,0,0,0
"2011","E00020928","E00020928","Total",126,57,22,35,0,3,0,3,66,62,0,4,0,0
"2011","E00020892","E00020892","Total",158,92,64,28,0,3,0,3,61,58,0,3,0,2
"2011","E00020914","E00020914","Total",117,87,37,50,0,1,1,0,28,28,0,0,0,1
"2011","E00020919","E00020919","Total",143,83,43,40,0,4,2,2,56,55,0,1,0,0
"2011","E00020920","E00020920","Total",128,57,31,26,0,2,2,0,67,66,0,1,0,2
"2011","E00020921","E00020921","Total",119,55,26,29,1,1,0,1,59,54,0,5,0,3
"2011","E00020924","E00020924","Total",123,55,26,29,0,18,1,17,48,45,0,3,0,2
"2011","E00020926","E00020926","Total",115,30,11,19,0,66,5,61,18,18,0,0,0,1
"2011","E00020622","E00020622","Total",118,115,61,54,0,1,1,0,1,1,0,0,0,1
"2011","E00020625","E00020625","Total",118,110,62,48,0,2,0,2,6,6,0,0,0,0
"2011","E00020626","E00020626","Total",121,120,60,60,0,0,0,0,0,0,0,0,0,1
"2011","E00020629","E00020629","Total",117,115,57,58,0,1,1,0,1,1,0,0,0,0
"2011","E00020599","E00020599","Total",121,79,29,50,0,3,3,0,37,36,1,0,0,2
"2011","E00020604","E00020604","Total",115,112,61,51,0,0,0,0,3,3,0,0,0,0
"2011","E00020609","E00020609","Total",111,106,64,42,0,1,1,0,3,3,0,0,0,1
"2011","E00020618","E00020618","Total",121,85,49,36,1,4,3,1,29,27,0,2,0,2
"2011","E00020621","E00020621","Total",117,108,63,45,0,1,1,0,7,7,0,0,0,1
"2011","E00020677","E00020677","Total",146,104,39,65,0,3,2,1,37,34,1,2,0,2
"2011","E00020679","E00020679","Total",121,119,45,74,0,0,0,0,1,1,0,0,0,1
"2011","E00020682","E00020682","Total",129,125,62,63,0,1,1,0,2,2,0,0,0,1
"2011","E00020685","E00020685","Total",130,77,33,44,1,37,33,4,13,12,0,0,1,2
"2011","E00020690","E00020690","Total",121,98,44,54,1,14,13,1,6,6,0,0,0,2
"2011","E00020665","E00020665","Total",127,125,77,48,0,1,0,1,1,1,0,0,0,0
"2011","E00020666","E00020666","Total",135,130,59,71,0,0,0,0,5,5,0,0,0,0
"2011","E00020683","E00020683","Total",134,127,71,56,0,0,0,0,7,7,0,0,0,0
"2011","E00020688","E00020688","Total",126,120,60,60,0,0,0,0,4,4,0,0,0,2
"2011","E00020890","E00020890","Total",118,105,57,48,0,1,1,0,11,11,0,0,0,1
"2011","E00020900","E00020900","Total",100,96,53,43,0,1,1,0,3,3,0,0,0,0
"2011","E00020910","E00020910","Total",127,68,34,34,0,12,9,3,47,47,0,0,0,0
"2011","E00020913","E00020913","Total",110,104,62,42,0,2,1,1,4,4,0,0,0,0
"2011","E00020916","E00020916","Total",106,104,54,50,0,0,0,0,1,1,0,0,0,1
"2011","E00020563","E00020563","Total",93,88,52,36,0,1,0,1,4,3,1,0,0,0
"2011","E00020589","E00020589","Total",100,92,48,44,0,2,2,0,6,5,0,1,0,0
"2011","E00020591","E00020591","Total",109,104,58,46,0,0,0,0,4,4,0,0,0,1
"2011","E00020592","E00020592","Total",106,101,45,56,0,0,0,0,5,4,1,0,0,0
"2011","E00020593","E00020593","Total",96,90,51,39,2,0,0,0,3,3,0,0,0,1
"2011","E00020568","E00020568","Total",129,106,45,61,0,3,0,3,20,17,0,3,0,0
"2011","E00020585","E00020585","Total",105,95,43,52,0,1,1,0,9,7,0,0,2,0
"2011","E00020587","E00020587","Total",113,108,60,48,0,1,0,1,4,4,0,0,0,0
"2011","E00020588","E00020588","Total",125,118,57,61,0,1,1,0,6,6,0,0,0,0
"2011","E00020590","E00020590","Total",110,101,53,48,0,2,2,0,6,5,0,0,1,1
"2011","E00020667","E00020667","Total",126,89,47,42,0,19,18,1,16,9,6,0,1,2
"2011","E00020686","E00020686","Total",127,115,48,67,0,2,1,1,10,10,0,0,0,0
"2011","E00020689","E00020689","Total",118,104,39,65,1,6,6,0,7,7,0,0,0,0
"2011","E00166820","E00166820","Total",123,110,36,74,1,3,3,0,8,8,0,0,0,1
"2011","E00166821","E00166821","Total",101,89,37,52,0,4,4,0,6,3,3,0,0,2
"2011","E00020664","E00020664","Total",133,99,31,68,5,20,19,1,8,7,0,1,0,1
"2011","E00020668","E00020668","Total",129,68,28,40,0,51,49,2,10,8,0,2,0,0
"2011","E00020669","E00020669","Total",131,102,47,55,0,21,20,1,7,5,0,1,1,1
"2011","E00020670","E00020670","Total",126,69,27,42,0,46,45,1,10,8,0,2,0,1
"2011","E00020671","E00020671","Total",119,82,33,49,0,25,24,1,12,11,0,1,0,0
"2011","E00020596","E00020596","Total",123,113,67,46,0,1,1,0,9,9,0,0,0,0
"2011","E00020611","E00020611","Total",113,88,33,55,0,1,0,1,24,24,0,0,0,0
"2011","E00020612","E00020612","Total",136,117,65,52,0,11,0,11,5,5,0,0,0,3
"2011","E00020613","E00020613","Total",111,76,20,56,0,1,1,0,32,30,0,2,0,2
"2011","E00020616","E00020616","Total",115,94,40,54,1,0,0,0,18,17,0,1,0,2
"2011","E00020597","E00020597","Total",179,139,78,61,8,10,0,10,22,22,0,0,0,0
"2011","E00020619","E00020619","Total",105,70,28,42,0,0,0,0,34,32,0,2,0,1
"2011","E00020623","E00020623","Total",108,78,30,48,0,1,0,1,29,27,0,2,0,0
"2011","E00020624","E00020624","Total",143,83,31,52,0,12,5,7,41,37,0,0,4,7
"2011","E00020627","E00020627","Total",90,76,26,50,2,0,0,0,11,10,0,1,0,1
"2011","E00020628","E00020628","Total",123,95,37,58,0,2,2,0,25,25,0,0,0,1
"2011","E00020598","E00020598","Total",153,123,56,67,0,0,0,0,29,26,0,3,0,1
"2011","E00020600","E00020600","Total",130,122,79,43,0,1,0,1,6,5,0,1,0,1
"2011","E00020602","E00020602","Total",111,92,44,48,1,2,1,1,16,14,0,2,0,0
"2011","E00020605","E00020605","Total",106,57,20,37,0,1,1,0,47,45,0,2,0,1
"2011","E00020630","E00020630","Total",135,120,66,54,6,0,0,0,8,8,0,0,0,1
"2011","E00020703","E00020703","Total",122,114,65,49,0,1,1,0,6,6,0,0,0,1
"2011","E00020704","E00020704","Total",119,105,66,39,1,3,0,3,10,9,0,1,0,0
"2011","E00020705","E00020705","Total",113,110,67,43,0,0,0,0,2,2,0,0,0,1
"2011","E00020706","E00020706","Total",117,112,56,56,0,0,0,0,4,4,0,0,0,1
"2011","E00020707","E00020707","Total",124,117,67,50,0,0,0,0,5,4,1,0,0,2
"2011","E00020697","E00020697","Total",139,124,65,59,0,0,0,0,15,14,0,1,0,0
"2011","E00020698","E00020698","Total",110,107,66,41,0,1,0,1,2,2,0,0,0,0
"2011","E00020700","E00020700","Total",125,122,85,37,1,0,0,0,2,2,0,0,0,0
"2011","E00020702","E00020702","Total",127,117,69,48,0,1,0,1,7,6,1,0,0,2
"2011","E00165852","E00165852","Total",118,113,65,48,0,1,1,0,4,4,0,0,0,0
"2011","E00021875","E00021875","Total",110,58,19,39,3,39,28,11,9,9,0,0,0,1
"2011","E00021898","E00021898","Total",140,52,19,33,1,77,64,13,8,6,0,1,1,2
"2011","E00021900","E00021900","Total",142,72,39,33,1,57,51,6,11,10,0,1,0,1
"2011","E00021902","E00021902","Total",155,140,77,63,0,5,2,3,8,8,0,0,0,2
"2011","E00021878","E00021878","Total",120,87,40,47,1,14,13,1,18,16,1,0,1,0
"2011","E00021885","E00021885","Total",118,70,29,41,1,25,4,21,18,15,0,3,0,4
"2011","E00021887","E00021887","Total",184,6,4,2,2,168,0,168,8,7,0,0,1,0
"2011","E00021904","E00021904","Total",143,76,49,27,7,42,2,40,18,17,0,0,1,0
"2011","E00021905","E00021905","Total",161,115,52,63,7,16,12,4,21,21,0,0,0,2
"2011","E00021906","E00021906","Total",88,22,16,6,0,56,3,53,10,9,0,1,0,0
"2011","E00021907","E00021907","Total",101,79,57,22,1,2,1,1,17,13,0,3,1,2
"2011","E00021876","E00021876","Total",116,103,67,36,0,6,4,2,4,4,0,0,0,3
"2011","E00021882","E00021882","Total",139,97,46,51,0,32,2,30,9,8,0,1,0,1
"2011","E00021883","E00021883","Total",135,122,66,56,0,3,2,1,9,8,0,1,0,1
"2011","E00021901","E00021901","Total",121,109,51,58,1,1,0,1,10,8,0,2,0,0
"2011","E00021903","E00021903","Total",134,117,58,59,0,7,5,2,9,8,1,0,0,1
"2011","E00021909","E00021909","Total",133,100,44,56,1,7,5,2,24,24,0,0,0,1
"2011","E00021917","E00021917","Total",110,62,19,43,0,35,32,3,11,11,0,0,0,2
"2011","E00021920","E00021920","Total",119,93,48,45,0,19,16,3,6,6,0,0,0,1
"2011","E00021925","E00021925","Total",112,71,43,28,0,34,3,31,5,1,2,0,2,2
"2011","E00021930","E00021930","Total",116,79,26,53,1,21,19,2,14,14,0,0,0,1
"2011","E00021911","E00021911","Total",177,97,35,62,0,64,56,8,13,11,0,2,0,3
"2011","E00021914","E00021914","Total",139,112,61,51,0,4,2,2,21,21,0,0,0,2
"2011","E00021939","E00021939","Total",125,116,64,52,0,3,1,2,5,4,0,1,0,1
"2011","E00021940","E00021940","Total",133,126,82,44,0,1,1,0,4,4,0,0,0,2
"2011","E00021884","E00021884","Total",131,80,40,40,0,5,2,3,44,42,1,1,0,2
"2011","E00021886","E00021886","Total",146,133,69,64,0,3,1,2,10,10,0,0,0,0
"2011","E00021890","E00021890","Total",144,129,77,52,0,1,0,1,13,11,1,1,0,1
"2011","E00021899","E00021899","Total",122,80,51,29,0,5,0,5,31,26,3,2,0,6
"2011","E00171497","E00171497","Total",184,116,55,61,0,21,0,21,45,44,0,1,0,2
"2011","E00171498","E00171498","Total",86,74,39,35,0,2,1,1,8,6,1,1,0,2
"2011","E00021879","E00021879","Total",120,93,51,42,0,5,0,5,22,21,0,1,0,0
"2011","E00021881","E00021881","Total",139,100,58,42,2,6,5,1,28,27,0,1,0,3
"2011","E00021888","E00021888","Total",111,72,46,26,2,13,1,12,24,20,0,4,0,0
"2011","E00021892","E00021892","Total",90,56,24,32,0,22,20,2,12,12,0,0,0,0
"2011","E00021895","E00021895","Total",102,95,48,47,1,0,0,0,5,5,0,0,0,1
"2011","E00021896","E00021896","Total",91,89,51,38,0,1,0,1,1,1,0,0,0,0
"2011","E00021897","E00021897","Total",145,111,78,33,0,22,2,20,12,10,0,2,0,0
"2011","E00021880","E00021880","Total",168,143,68,75,0,2,2,0,22,18,1,3,0,1
"2011","E00021889","E00021889","Total",161,93,52,41,0,5,4,1,63,63,0,0,0,0
"2011","E00021891","E00021891","Total",147,103,40,63,1,4,1,3,39,39,0,0,0,0
"2011","E00021893","E00021893","Total",162,113,47,66,0,7,5,2,41,38,1,2,0,1
"2011","E00021894","E00021894","Total",111,80,37,43,0,16,9,7,15,15,0,0,0,0
"2011","E00021908","E00021908","Total",149,114,51,63,1,14,6,8,18,17,0,0,1,2
"2011","E00021912","E00021912","Total",134,47,32,15,0,80,61,19,6,6,0,0,0,1
"2011","E00021913","E00021913","Total",145,94,47,47,0,14,4,10,35,33,2,0,0,2
"2011","E00021918","E00021918","Total",124,53,30,23,1,50,7,43,17,16,0,1,0,3
"2011","E00021921","E00021921","Total",116,97,36,61,0,0,0,0,16,15,0,1,0,3
"2011","E00021923","E00021923","Total",120,99,38,61,1,4,1,3,15,15,0,0,0,1
"2011","E00021915","E00021915","Total",133,106,49,57,0,6,4,2,21,19,1,1,0,0
"2011","E00021916","E00021916","Total",118,88,33,55,2,18,17,1,9,9,0,0,0,1
"2011","E00021919","E00021919","Total",125,58,29,29,1,52,5,47,11,10,0,1,0,3
"2011","E00021922","E00021922","Total",119,110,57,53,0,5,3,2,2,2,0,0,0,2
"2011","E00021927","E00021927","Total",115,110,51,59,0,2,0,2,3,3,0,0,0,0
"2011","E00022053","E00022053","Total",170,73,34,39,1,56,45,11,38,36,0,1,1,2
"2011","E00022063","E00022063","Total",128,86,34,52,1,33,25,8,7,7,0,0,0,1
"2011","E00022065","E00022065","Total",131,70,29,41,1,52,42,10,7,5,0,2,0,1
"2011","E00022068","E00022068","Total",136,66,25,41,1,54,46,8,15,15,0,0,0,0
"2011","E00022069","E00022069","Total",130,62,19,43,0,48,43,5,20,20,0,0,0,0
"2011","E00022045","E00022045","Total",129,35,19,16,0,83,72,11,9,9,0,0,0,2
"2011","E00022046","E00022046","Total",152,98,36,62,2,41,38,3,8,7,1,0,0,3
"2011","E00022055","E00022055","Total",125,100,57,43,1,0,0,0,22,19,0,2,1,2
"2011","E00022057","E00022057","Total",111,36,14,22,3,60,56,4,11,10,0,1,0,1
"2011","E00022073","E00022073","Total",133,46,28,18,0,70,62,8,15,14,0,1,0,2
"2011","E00022054","E00022054","Total",128,108,47,61,1,6,5,1,12,9,0,3,0,1
"2011","E00022070","E00022070","Total",136,125,71,54,1,2,1,1,6,4,0,2,0,2
"2011","E00022071","E00022071","Total",129,118,63,55,0,3,2,1,6,6,0,0,0,2
"2011","E00022072","E00022072","Total",141,129,67,62,0,4,4,0,7,7,0,0,0,1
"2011","E00022074","E00022074","Total",108,103,58,45,0,1,1,0,4,4,0,0,0,0
"2011","E00022049","E00022049","Total",140,71,24,47,2,54,43,11,11,10,1,0,0,2
"2011","E00022050","E00022050","Total",126,54,28,26,0,68,61,7,4,4,0,0,0,0
"2011","E00022051","E00022051","Total",129,79,26,53,0,38,33,5,11,10,0,1,0,1
"2011","E00022060","E00022060","Total",130,54,19,35,1,53,47,6,22,22,0,0,0,0
"2011","E00022061","E00022061","Total",181,144,78,66,0,3,3,0,33,33,0,0,0,1
"2011","E00022052","E00022052","Total",137,60,27,33,1,67,60,7,8,7,0,1,0,1
"2011","E00022062","E00022062","Total",151,73,37,36,0,68,55,13,9,9,0,0,0,1
"2011","E00022064","E00022064","Total",112,53,19,34,1,47,42,5,10,9,0,0,1,1
"2011","E00022066","E00022066","Total",131,65,25,40,0,59,37,22,4,4,0,0,0,3
"2011","E00022067","E00022067","Total",121,78,35,43,0,27,19,8,15,12,0,3,0,1
"2011","E00021910","E00021910","Total",161,97,36,61,0,39,24,15,24,23,0,1,0,1
"2011","E00021926","E00021926","Total",113,37,12,25,6,64,17,47,6,5,1,0,0,0
"2011","E00021929","E00021929","Total",130,111,45,66,0,6,4,2,13,12,0,0,1,0
"2011","E00021932","E00021932","Total",125,65,37,28,1,43,7,36,16,13,0,3,0,0
"2011","E00021935","E00021935","Total",144,111,34,77,0,5,3,2,27,25,0,2,0,1
"2011","E00021928","E00021928","Total",120,106,55,51,0,1,0,1,10,10,0,0,0,3
"2011","E00021931","E00021931","Total",133,121,58,63,0,4,3,1,7,6,0,1,0,1
"2011","E00021933","E00021933","Total",121,115,65,50,0,3,0,3,3,3,0,0,0,0
"2011","E00021938","E00021938","Total",118,103,61,42,1,8,5,3,4,4,0,0,0,2
"2011","E00022196","E00022196","Total",124,105,43,62,0,6,2,4,13,12,0,1,0,0
"2011","E00022198","E00022198","Total",131,71,30,41,0,55,3,52,5,5,0,0,0,0
"2011","E00022201","E00022201","Total",128,39,19,20,4,80,22,58,3,3,0,0,0,2
"2011","E00022205","E00022205","Total",159,94,41,53,0,48,40,8,13,12,0,1,0,4
"2011","E00022225","E00022225","Total",143,31,21,10,17,88,48,40,6,6,0,0,0,1
"2011","E00022200","E00022200","Total",114,83,24,59,0,17,3,14,13,12,0,1,0,1
"2011","E00022202","E00022202","Total",115,99,36,63,0,4,1,3,12,10,0,2,0,0
"2011","E00022207","E00022207","Total",137,124,65,59,1,2,2,0,10,9,0,0,1,0
"2011","E00022223","E00022223","Total",122,7,1,6,1,112,25,87,2,2,0,0,0,0
"2011","E00022224","E00022224","Total",95,84,34,50,0,2,1,1,8,8,0,0,0,1
"2011","E00022193","E00022193","Total",119,49,19,30,0,53,46,7,17,16,0,1,0,0
"2011","E00022204","E00022204","Total",133,120,52,68,0,4,1,3,5,5,0,0,0,4
"2011","E00022208","E00022208","Total",132,122,56,66,0,3,0,3,7,6,0,1,0,0
"2011","E00022212","E00022212","Total",134,70,25,45,0,40,38,2,21,18,0,1,2,3
"2011","E00022215","E00022215","Total",114,100,39,61,1,2,1,1,11,11,0,0,0,0
"2011","E00021924","E00021924","Total",115,106,46,60,0,3,1,2,5,4,0,1,0,1
"2011","E00021934","E00021934","Total",132,115,55,60,1,3,1,2,12,12,0,0,0,1
"2011","E00021936","E00021936","Total",104,102,52,50,0,2,1,1,0,0,0,0,0,0
"2011","E00021937","E00021937","Total",141,112,45,67,0,6,4,2,22,19,1,2,0,1
"2011","E00022197","E00022197","Total",136,90,53,37,2,13,1,12,31,30,0,1,0,0
"2011","E00022203","E00022203","Total",105,85,51,34,0,5,1,4,15,14,1,0,0,0
"2011","E00022206","E00022206","Total",109,99,52,47,0,1,0,1,7,7,0,0,0,2
"2011","E00022226","E00022226","Total",129,99,34,65,0,12,3,9,17,14,0,3,0,1
"2011","E00022227","E00022227","Total",136,114,53,61,2,6,3,3,12,12,0,0,0,2
"2011","E00022199","E00022199","Total",188,79,31,48,3,53,39,14,51,46,0,4,1,2
"2011","E00022209","E00022209","Total",113,104,53,51,0,1,0,1,7,7,0,0,0,1
"2011","E00022210","E00022210","Total",117,32,14,18,0,50,11,39,34,32,1,1,0,1
"2011","E00022211","E00022211","Total",127,121,60,61,0,3,1,2,3,3,0,0,0,0
"2011","E00022213","E00022213","Total",105,97,35,62,0,0,0,0,7,5,0,2,0,1
"2011","E00022378","E00022378","Total",123,110,46,64,1,2,1,1,9,7,1,1,0,1
"2011","E00022379","E00022379","Total",137,121,52,69,1,2,2,0,13,12,0,1,0,0
"2011","E00022407","E00022407","Total",113,26,12,14,0,72,58,14,15,13,0,1,1,0
"2011","E00022408","E00022408","Total",133,129,53,76,0,3,2,1,1,1,0,0,0,0
"2011","E00022409","E00022409","Total",135,120,61,59,0,1,0,1,14,12,0,2,0,0
"2011","E00022381","E00022381","Total",145,95,41,54,0,35,26,9,15,15,0,0,0,0
"2011","E00022382","E00022382","Total",137,28,12,16,0,50,4,46,56,55,0,1,0,3
"2011","E00022383","E00022383","Total",120,79,38,41,1,20,19,1,19,16,0,2,1,1
"2011","E00022387","E00022387","Total",143,121,67,54,0,3,2,1,19,19,0,0,0,0
"2011","E00022391","E00022391","Total",147,125,59,66,0,2,1,1,19,17,0,2,0,1
"2011","E00022380","E00022380","Total",128,116,60,56,1,3,0,3,6,6,0,0,0,2
"2011","E00022384","E00022384","Total",111,99,50,49,0,1,0,1,10,10,0,0,0,1
"2011","E00022385","E00022385","Total",112,97,40,57,1,4,3,1,10,9,0,1,0,0
"2011","E00022386","E00022386","Total",126,119,52,67,0,2,1,1,5,5,0,0,0,0
"2011","E00022388","E00022388","Total",128,117,60,57,0,1,0,1,10,8,0,2,0,0
"2011","E00022389","E00022389","Total",114,90,35,55,1,3,1,2,18,17,0,0,1,2
"2011","E00022390","E00022390","Total",127,62,13,49,0,10,6,4,55,53,0,2,0,0
"2011","E00022392","E00022392","Total",131,96,42,54,0,4,2,2,28,26,0,1,1,3
"2011","E00022394","E00022394","Total",135,119,50,69,0,5,2,3,9,6,1,2,0,2
"2011","E00022399","E00022399","Total",151,105,40,65,2,12,8,4,32,30,0,2,0,0
"2011","E00022376","E00022376","Total",130,79,39,40,2,35,28,7,14,13,0,1,0,0
"2011","E00022393","E00022393","Total",134,93,61,32,1,9,5,4,25,18,1,3,3,6
"2011","E00022396","E00022396","Total",135,112,49,63,0,3,3,0,19,17,0,2,0,1
"2011","E00022397","E00022397","Total",133,108,49,59,1,8,6,2,16,15,0,1,0,0
"2011","E00022401","E00022401","Total",108,82,35,47,0,11,7,4,14,14,0,0,0,1
"2011","E00022398","E00022398","Total",115,67,28,39,0,14,9,5,29,28,0,1,0,5
"2011","E00022400","E00022400","Total",139,109,38,71,0,7,4,3,21,20,0,1,0,2
"2011","E00022403","E00022403","Total",126,96,44,52,0,6,4,2,23,23,0,0,0,1
"2011","E00022405","E00022405","Total",53,11,2,9,0,38,4,34,3,3,0,0,0,1
"2011","E00022406","E00022406","Total",111,45,18,27,0,43,30,13,23,22,0,1,0,0
"2011","E00022377","E00022377","Total",145,25,5,20,0,115,9,106,2,2,0,0,0,3
"2011","E00022395","E00022395","Total",120,57,18,39,0,53,17,36,9,8,0,0,1,1
"2011","E00022402","E00022402","Total",129,40,15,25,0,77,32,45,9,8,1,0,0,3
"2011","E00022404","E00022404","Total",145,20,2,18,1,117,14,103,3,2,0,0,1,4
"2011","E00022015","E00022015","Total",121,103,49,54,1,5,3,2,10,10,0,0,0,2
"2011","E00022019","E00022019","Total",138,112,34,78,0,3,1,2,22,21,0,1,0,1
"2011","E00022036","E00022036","Total",123,111,48,63,0,1,0,1,11,11,0,0,0,0
"2011","E00022038","E00022038","Total",141,126,48,78,0,4,1,3,10,9,0,1,0,1
"2011","E00022016","E00022016","Total",115,53,14,39,4,37,31,6,21,20,0,1,0,0
"2011","E00022020","E00022020","Total",103,94,45,49,0,2,2,0,7,5,0,2,0,0
"2011","E00022023","E00022023","Total",136,52,26,26,0,66,60,6,15,12,0,1,2,3
"2011","E00022039","E00022039","Total",128,77,33,44,4,34,33,1,12,12,0,0,0,1
"2011","E00022040","E00022040","Total",125,86,35,51,9,20,17,3,10,8,1,0,1,0
"2011","E00022017","E00022017","Total",125,108,31,77,0,5,2,3,12,11,0,1,0,0
"2011","E00022024","E00022024","Total",135,116,61,55,2,5,4,1,10,10,0,0,0,2
"2011","E00022025","E00022025","Total",136,111,35,76,0,2,2,0,22,21,0,1,0,1
"2011","E00022028","E00022028","Total",140,100,32,68,0,29,28,1,11,10,0,1,0,0
"2011","E00022037","E00022037","Total",138,66,18,48,0,13,8,5,55,55,0,0,0,4
"2011","E00022012","E00022012","Total",137,74,28,46,0,51,40,11,11,11,0,0,0,1
"2011","E00022026","E00022026","Total",144,138,65,73,0,2,1,1,3,3,0,0,0,1
"2011","E00022027","E00022027","Total",162,124,62,62,5,7,3,4,25,23,0,1,1,1
"2011","E00022030","E00022030","Total",132,120,43,77,0,3,3,0,9,9,0,0,0,0
"2011","E00022043","E00022043","Total",128,117,55,62,0,5,3,2,5,5,0,0,0,1
"2011","E00022044","E00022044","Total",132,116,54,62,0,2,1,1,13,10,0,3,0,1
"2011","E00022075","E00022075","Total",146,127,57,70,0,1,0,1,18,17,0,1,0,0
"2011","E00022076","E00022076","Total",119,110,40,70,1,3,2,1,5,4,0,1,0,0
"2011","E00022047","E00022047","Total",131,76,30,46,0,23,20,3,30,29,0,1,0,2
"2011","E00022048","E00022048","Total",128,85,40,45,5,9,8,1,27,23,0,3,1,2
"2011","E00022056","E00022056","Total",124,70,33,37,2,19,15,4,33,33,0,0,0,0
"2011","E00022058","E00022058","Total",141,71,36,35,0,17,11,6,51,47,1,2,1,2
"2011","E00022059","E00022059","Total",125,70,36,34,1,40,31,9,13,13,0,0,0,1
"2011","E00021840","E00021840","Total",144,101,29,72,0,15,5,10,28,24,0,4,0,0
"2011","E00021842","E00021842","Total",146,109,46,63,0,7,3,4,27,25,0,1,1,3
"2011","E00021851","E00021851","Total",116,102,36,66,0,2,2,0,11,11,0,0,0,1
"2011","E00021854","E00021854","Total",134,106,42,64,1,10,2,8,17,15,0,2,0,0
"2011","E00021855","E00021855","Total",107,91,41,50,0,3,1,2,13,12,0,1,0,0
"2011","E00021841","E00021841","Total",128,67,16,51,0,26,11,15,31,30,0,0,1,4
"2011","E00021852","E00021852","Total",149,105,33,72,1,23,18,5,20,19,0,1,0,0
"2011","E00021853","E00021853","Total",142,63,21,42,1,57,7,50,16,16,0,0,0,5
"2011","E00021857","E00021857","Total",112,23,8,15,0,61,49,12,25,25,0,0,0,3
"2011","E00021859","E00021859","Total",136,74,25,49,2,15,8,7,45,43,0,1,1,0
"2011","E00022018","E00022018","Total",134,45,13,32,0,78,50,28,10,9,0,0,1,1
"2011","E00022021","E00022021","Total",126,95,33,62,2,4,3,1,24,24,0,0,0,1
"2011","E00022041","E00022041","Total",124,9,2,7,0,105,94,11,8,7,0,1,0,2
"2011","E00022042","E00022042","Total",117,9,4,5,0,100,75,25,5,5,0,0,0,3
"2011","E00022194","E00022194","Total",126,109,54,55,2,1,1,0,14,14,0,0,0,0
"2011","E00022214","E00022214","Total",95,45,18,27,2,28,3,25,20,18,0,0,2,0
"2011","E00022216","E00022216","Total",122,101,42,59,0,7,5,2,14,14,0,0,0,0
"2011","E00022218","E00022218","Total",164,79,35,44,0,42,38,4,42,40,0,0,2,1
"2011","E00022219","E00022219","Total",142,113,56,57,7,9,1,8,9,9,0,0,0,4
"2011","E00022195","E00022195","Total",149,127,64,63,3,3,2,1,13,12,0,1,0,3
"2011","E00022217","E00022217","Total",140,72,15,57,1,11,5,6,54,53,0,1,0,2
"2011","E00022220","E00022220","Total",117,74,31,43,0,1,1,0,37,36,0,0,1,5
"2011","E00022221","E00022221","Total",119,94,49,45,0,7,3,4,17,17,0,0,0,1
"2011","E00022222","E00022222","Total",112,94,44,50,0,6,3,3,10,9,0,1,0,2
"2011","E00022119","E00022119","Total",139,57,22,35,0,57,49,8,20,15,3,2,0,5
"2011","E00022133","E00022133","Total",117,26,10,16,0,85,56,29,4,4,0,0,0,2
"2011","E00022134","E00022134","Total",113,40,17,23,1,52,42,10,18,17,0,0,1,2
"2011","E00022137","E00022137","Total",185,57,16,41,3,101,19,82,22,21,0,0,1,2
"2011","E00022139","E00022139","Total",125,53,17,36,3,49,40,9,18,17,0,1,0,2
"2011","E00022127","E00022127","Total",133,34,7,27,3,69,51,18,26,26,0,0,0,1
"2011","E00022130","E00022130","Total",108,18,2,16,0,86,50,36,2,2,0,0,0,2
"2011","E00022131","E00022131","Total",120,26,0,26,3,82,50,32,8,7,0,1,0,1
"2011","E00022132","E00022132","Total",106,53,20,33,1,42,36,6,9,9,0,0,0,1
"2011","E00022135","E00022135","Total",127,44,11,33,3,63,53,10,16,16,0,0,0,1
"2011","E00022122","E00022122","Total",123,74,15,59,1,12,5,7,30,27,0,3,0,6
"2011","E00022128","E00022128","Total",129,53,19,34,0,33,26,7,41,40,0,1,0,2
"2011","E00022138","E00022138","Total",137,70,25,45,0,34,22,12,32,29,0,0,3,1
"2011","E00022140","E00022140","Total",125,84,34,50,0,12,5,7,28,27,0,1,0,1
"2011","E00022142","E00022142","Total",127,51,17,34,0,23,7,16,52,49,0,2,1,1
"2011","E00022123","E00022123","Total",139,86,33,53,0,25,13,12,25,24,0,0,1,3
"2011","E00022141","E00022141","Total",140,45,14,31,3,55,44,11,34,32,0,2,0,3
"2011","E00022145","E00022145","Total",119,44,9,35,2,58,48,10,11,10,0,1,0,4
"2011","E00022148","E00022148","Total",125,72,26,46,0,15,10,5,38,37,0,1,0,0
"2011","E00022149","E00022149","Total",140,85,29,56,1,32,16,16,20,19,0,1,0,2
"2011","E00022118","E00022118","Total",126,54,11,43,1,47,22,25,24,23,0,1,0,0
"2011","E00022120","E00022120","Total",122,51,15,36,0,58,48,10,10,10,0,0,0,3
"2011","E00022129","E00022129","Total",127,65,20,45,2,25,14,11,35,33,0,0,2,0
"2011","E00022136","E00022136","Total",108,54,16,38,0,45,36,9,7,5,0,2,0,2
"2011","E00022143","E00022143","Total",119,72,21,51,1,23,7,16,21,19,0,2,0,2
"2011","E00021843","E00021843","Total",129,70,24,46,1,19,8,11,37,36,0,1,0,2
"2011","E00021856","E00021856","Total",133,105,40,65,1,5,0,5,22,22,0,0,0,0
"2011","E00021863","E00021863","Total",140,94,31,63,0,14,5,9,32,31,0,1,0,0
"2011","E00021868","E00021868","Total",118,68,21,47,0,20,5,15,30,29,0,0,1,0
"2011","E00021871","E00021871","Total",104,69,18,51,0,11,2,9,24,23,0,1,0,0
"2011","E00021845","E00021845","Total",131,71,23,48,0,14,11,3,45,41,0,3,1,1
"2011","E00021846","E00021846","Total",110,62,27,35,0,9,3,6,37,37,0,0,0,2
"2011","E00021849","E00021849","Total",113,63,18,45,0,13,7,6,35,34,0,1,0,2
"2011","E00021867","E00021867","Total",116,67,20,47,0,6,1,5,43,40,0,3,0,0
"2011","E00021874","E00021874","Total",128,78,30,48,0,15,6,9,35,33,0,2,0,0
"2011","E00171500","E00171500","Total",125,23,1,22,19,45,10,35,38,38,0,0,0,0
"2011","E00171512","E00171512","Total",120,77,22,55,1,17,14,3,25,24,0,1,0,0
"2011","E00171514","E00171514","Total",130,61,10,51,2,4,3,1,63,60,0,3,0,0
"2011","E00022022","E00022022","Total",145,117,49,68,1,5,2,3,22,19,0,3,0,0
"2011","E00022029","E00022029","Total",156,136,53,83,1,2,0,2,16,16,0,0,0,1
"2011","E00022031","E00022031","Total",191,115,49,66,2,42,10,32,30,25,0,4,1,2
"2011","E00022032","E00022032","Total",134,113,52,61,0,3,3,0,18,15,1,2,0,0
"2011","E00022013","E00022013","Total",130,96,42,54,0,6,3,3,26,23,2,1,0,2
"2011","E00022014","E00022014","Total",134,74,28,46,4,34,10,24,20,18,0,1,1,2
"2011","E00022033","E00022033","Total",156,46,17,29,1,95,28,67,14,14,0,0,0,0
"2011","E00022034","E00022034","Total",131,86,34,52,0,19,3,16,25,24,0,1,0,1
"2011","E00022035","E00022035","Total",126,85,37,48,13,4,3,1,24,20,1,2,1,0
"2011","E00021844","E00021844","Total",172,62,18,44,2,86,70,16,21,19,0,1,1,1
"2011","E00021847","E00021847","Total",132,87,50,37,1,27,21,6,16,15,0,1,0,1
"2011","E00021848","E00021848","Total",155,67,16,51,0,37,14,23,48,44,0,3,1,3
"2011","E00021850","E00021850","Total",144,63,18,45,3,13,2,11,62,59,0,2,1,3
"2011","E00021873","E00021873","Total",186,80,30,50,0,21,6,15,85,85,0,0,0,0
"2011","E00021858","E00021858","Total",139,87,28,59,1,25,4,21,24,24,0,0,0,2
"2011","E00021860","E00021860","Total",145,90,29,61,3,28,4,24,19,18,0,1,0,5
"2011","E00021861","E00021861","Total",143,108,37,71,0,14,4,10,21,19,0,0,2,0
"2011","E00021862","E00021862","Total",130,87,28,59,0,21,4,17,21,19,0,1,1,1
"2011","E00021839","E00021839","Total",142,74,19,55,0,29,10,19,36,33,0,2,1,3
"2011","E00021864","E00021864","Total",131,65,14,51,0,31,4,27,35,32,0,3,0,0
"2011","E00021865","E00021865","Total",136,71,7,64,2,18,2,16,45,42,0,2,1,0
"2011","E00021866","E00021866","Total",119,64,8,56,0,17,4,13,38,37,0,1,0,0
"2011","E00021869","E00021869","Total",140,100,37,63,0,12,2,10,28,25,0,3,0,0
"2011","E00021870","E00021870","Total",141,114,53,61,0,6,3,3,20,16,0,2,2,1
"2011","E00022419","E00022419","Total",90,4,1,3,0,79,6,73,6,4,0,0,2,1
"2011","E00022423","E00022423","Total",139,74,23,51,0,22,12,10,41,37,0,3,1,2
"2011","E00022424","E00022424","Total",150,87,30,57,1,11,5,6,50,47,0,1,2,1
"2011","E00022430","E00022430","Total",169,87,33,54,5,23,20,3,51,51,0,0,0,3
"2011","E00022432","E00022432","Total",123,82,31,51,0,9,7,2,29,27,0,2,0,3
"2011","E00022413","E00022413","Total",121,27,3,24,14,30,5,25,49,49,0,0,0,1
"2011","E00022443","E00022443","Total",119,61,27,34,2,9,3,6,44,43,1,0,0,3
"2011","E00022444","E00022444","Total",140,88,33,55,1,9,1,8,41,38,0,3,0,1
"2011","E00022445","E00022445","Total",125,71,35,36,2,15,7,8,35,33,1,0,1,2
"2011","E00022446","E00022446","Total",134,39,11,28,11,30,12,18,51,49,0,2,0,3
"2011","E00022099","E00022099","Total",123,55,24,31,0,9,1,8,58,57,0,1,0,1
"2011","E00022100","E00022100","Total",128,77,32,45,1,7,1,6,43,43,0,0,0,0
"2011","E00022101","E00022101","Total",137,71,36,35,0,12,4,8,52,51,0,1,0,2
"2011","E00022102","E00022102","Total",124,81,40,41,0,9,4,5,32,31,0,1,0,2
"2011","E00022103","E00022103","Total",135,98,28,70,0,8,4,4,29,25,0,3,1,0
"2011","E00022427","E00022427","Total",122,56,13,43,3,18,9,9,45,45,0,0,0,0
"2011","E00022428","E00022428","Total",116,70,9,61,0,11,1,10,34,32,0,2,0,1
"2011","E00022429","E00022429","Total",128,60,8,52,3,34,13,21,30,27,0,3,0,1
"2011","E00022433","E00022433","Total",139,62,23,39,0,20,4,16,54,49,0,4,1,3
"2011","E00022436","E00022436","Total",121,71,26,45,3,15,3,12,32,28,0,4,0,0
"2011","E00022437","E00022437","Total",112,34,21,13,1,51,10,41,25,24,0,1,0,1
"2011","E00022412","E00022412","Total",147,68,35,33,2,22,5,17,52,51,0,1,0,3
"2011","E00022431","E00022431","Total",143,79,32,47,3,13,10,3,48,46,0,1,1,0
"2011","E00022434","E00022434","Total",125,101,46,55,1,1,0,1,20,19,0,0,1,2
"2011","E00022439","E00022439","Total",137,50,17,33,0,36,31,5,47,44,0,3,0,4
"2011","E00022441","E00022441","Total",129,79,30,49,0,9,7,2,41,41,0,0,0,0
"2011","E00022420","E00022420","Total",122,7,2,5,1,106,43,63,4,3,0,0,1,4
"2011","E00022421","E00022421","Total",159,8,6,2,0,139,91,48,6,4,0,1,1,6
"2011","E00022422","E00022422","Total",132,18,7,11,1,102,19,83,10,9,0,0,1,1
"2011","E00022426","E00022426","Total",122,54,16,38,1,49,45,4,17,17,0,0,0,1
"2011","E00022414","E00022414","Total",220,98,27,71,2,78,37,41,37,36,0,1,0,5
"2011","E00022415","E00022415","Total",143,64,15,49,2,23,3,20,54,50,1,3,0,0
"2011","E00022416","E00022416","Total",127,75,16,59,1,15,3,12,36,35,0,1,0,0
"2011","E00022417","E00022417","Total",136,74,16,58,2,14,2,12,45,41,0,4,0,1
"2011","E00022418","E00022418","Total",138,76,13,63,0,9,1,8,53,53,0,0,0,0
"2011","E00022425","E00022425","Total",142,79,14,65,0,15,1,14,48,46,0,2,0,0
"2011","E00022174","E00022174","Total",116,15,3,12,0,77,69,8,22,22,0,0,0,2
"2011","E00171516","E00171516","Total",218,25,7,18,0,171,157,14,18,18,0,0,0,4
"2011","E00171719","E00171719","Total",106,32,10,22,1,41,32,9,31,30,0,0,1,1
"2011","E00171722","E00171722","Total",53,11,5,6,0,26,20,6,16,16,0,0,0,0
"2011","E00022159","E00022159","Total",205,50,18,32,1,105,83,22,39,37,0,2,0,10
"2011","E00022160","E00022160","Total",140,65,19,46,6,40,27,13,27,27,0,0,0,2
"2011","E00022178","E00022178","Total",132,8,1,7,1,92,77,15,24,23,0,0,1,7
"2011","E00022182","E00022182","Total",126,54,18,36,0,43,33,10,26,23,0,1,2,3
"2011","E00022188","E00022188","Total",142,11,5,6,0,112,60,52,19,14,0,0,5,0
"2011","E00022190","E00022190","Total",107,36,9,27,3,31,18,13,37,36,1,0,0,0
"2011","E00022452","E00022452","Total",123,44,10,34,0,64,57,7,15,15,0,0,0,0
"2011","E00022454","E00022454","Total",144,72,27,45,5,43,30,13,22,21,0,1,0,2
"2011","E00022467","E00022467","Total",120,7,3,4,0,99,81,18,12,12,0,0,0,2
"2011","E00022472","E00022472","Total",124,14,3,11,0,73,54,19,36,32,1,2,1,1
"2011","E00022473","E00022473","Total",132,17,4,13,0,94,78,16,19,19,0,0,0,2
"2011","E00022457","E00022457","Total",132,55,23,32,0,67,59,8,10,10,0,0,0,0
"2011","E00022458","E00022458","Total",135,25,11,14,1,63,51,12,42,40,0,1,1,4
"2011","E00022459","E00022459","Total",111,41,11,30,0,52,28,24,16,14,0,2,0,2
"2011","E00022460","E00022460","Total",133,38,10,28,0,77,70,7,17,15,0,1,1,1
"2011","E00022464","E00022464","Total",116,31,15,16,2,69,60,9,12,11,0,1,0,2
"2011","E00022449","E00022449","Total",145,59,24,35,0,21,12,9,65,62,1,2,0,0
"2011","E00022462","E00022462","Total",121,36,7,29,0,64,44,20,20,20,0,0,0,1
"2011","E00022463","E00022463","Total",124,43,16,27,1,51,30,21,28,23,0,2,3,1
"2011","E00022466","E00022466","Total",114,79,40,39,2,12,7,5,20,20,0,0,0,1
"2011","E00022470","E00022470","Total",98,45,17,28,0,18,12,6,35,35,0,0,0,0
"2011","E00022450","E00022450","Total",170,71,24,47,2,36,16,20,59,59,0,0,0,2
"2011","E00022451","E00022451","Total",131,77,32,45,0,27,15,12,25,19,0,3,3,2
"2011","E00022461","E00022461","Total",122,78,29,49,0,13,9,4,31,30,0,0,1,0
"2011","E00022468","E00022468","Total",107,23,4,19,2,52,40,12,30,29,0,1,0,0
"2011","E00022469","E00022469","Total",138,19,5,14,0,94,88,6,21,19,0,2,0,4
"2011","E00022083","E00022083","Total",140,56,18,38,1,34,15,19,45,43,0,2,0,4
"2011","E00022085","E00022085","Total",138,68,23,45,0,13,3,10,56,55,0,1,0,1
"2011","E00022086","E00022086","Total",107,40,19,21,0,46,37,9,21,17,0,3,1,0
"2011","E00022090","E00022090","Total",176,94,31,63,2,23,3,20,56,54,0,1,1,1
"2011","E00022113","E00022113","Total",123,67,28,39,1,13,4,9,41,39,0,2,0,1
"2011","E00022115","E00022115","Total",162,70,14,56,3,32,3,29,56,53,0,1,2,1
"2011","E00022084","E00022084","Total",140,30,8,22,0,66,41,25,44,41,0,3,0,0
"2011","E00022104","E00022104","Total",126,42,15,27,0,26,22,4,56,54,0,2,0,2
"2011","E00022109","E00022109","Total",151,55,14,41,1,44,12,32,49,47,0,1,1,2
"2011","E00022111","E00022111","Total",134,60,14,46,3,23,2,21,44,43,0,1,0,4
"2011","E00022116","E00022116","Total",129,44,18,26,1,52,6,46,32,32,0,0,0,0
"2011","E00171727","E00171727","Total",91,54,2,52,0,28,22,6,6,5,0,1,0,3
"2011","E00171729","E00171729","Total",130,94,1,93,1,30,10,20,5,5,0,0,0,0
"2011","E00171732","E00171732","Total",122,84,2,82,1,34,10,24,3,3,0,0,0,0
"2011","E00022121","E00022121","Total",164,103,38,65,5,20,6,14,33,33,0,0,0,3
"2011","E00022124","E00022124","Total",242,53,21,32,4,124,31,93,58,54,0,1,3,3
"2011","E00022144","E00022144","Total",126,89,29,60,2,10,4,6,25,24,0,1,0,0
"2011","E00022146","E00022146","Total",129,66,16,50,3,14,10,4,44,43,0,0,1,2
"2011","E00022147","E00022147","Total",142,72,19,53,1,7,4,3,61,57,0,4,0,1
"2011","E00022117","E00022117","Total",159,48,18,30,24,43,25,18,44,42,0,1,1,0
"2011","E00022125","E00022125","Total",89,35,3,32,0,4,0,4,50,49,0,0,1,0
"2011","E00022150","E00022150","Total",80,9,1,8,0,59,45,14,6,6,0,0,0,6
"2011","E00022151","E00022151","Total",129,10,6,4,3,97,40,57,18,18,0,0,0,1
"2011","E00022152","E00022152","Total",153,51,7,44,0,7,2,5,92,90,0,2,0,3
"2011","E00171517","E00171517","Total",155,67,22,45,9,27,6,21,51,49,0,1,1,1
"2011","E00171721","E00171721","Total",117,14,3,11,32,37,0,37,33,31,1,0,1,1
"2011","E00022410","E00022410","Total",144,91,36,55,1,10,5,5,42,39,0,0,3,0
"2011","E00022411","E00022411","Total",124,85,34,51,1,6,1,5,32,31,0,1,0,0
"2011","E00022435","E00022435","Total",119,72,30,42,1,5,3,2,41,39,0,2,0,0
"2011","E00022438","E00022438","Total",177,64,17,47,1,10,2,8,97,93,0,4,0,5
"2011","E00022440","E00022440","Total",139,71,34,37,1,3,1,2,64,62,0,1,1,0
"2011","E00022442","E00022442","Total",91,41,17,24,0,13,10,3,36,34,0,2,0,1
"2011","E00022154","E00022154","Total",186,90,31,59,2,25,20,5,68,67,0,1,0,1
"2011","E00022161","E00022161","Total",117,43,18,25,0,36,7,29,38,37,0,1,0,0
"2011","E00022163","E00022163","Total",129,65,25,40,1,19,13,6,42,42,0,0,0,2
"2011","E00022165","E00022165","Total",139,90,29,61,0,14,6,8,35,34,0,1,0,0
"2011","E00022191","E00022191","Total",169,69,27,42,18,30,23,7,46,44,0,1,1,6
"2011","E00022477","E00022477","Total",127,62,23,39,2,43,32,11,17,16,0,0,1,3
"2011","E00022478","E00022478","Total",158,97,30,67,0,14,12,2,45,44,0,1,0,2
"2011","E00022479","E00022479","Total",132,89,31,58,1,12,7,5,30,28,0,1,1,0
"2011","E00022482","E00022482","Total",126,102,41,61,0,8,6,2,15,15,0,0,0,1
"2011","E00022448","E00022448","Total",102,71,22,49,0,10,9,1,21,21,0,0,0,0
"2011","E00022455","E00022455","Total",121,80,22,58,0,7,1,6,34,32,0,2,0,0
"2011","E00022481","E00022481","Total",129,102,32,70,1,1,1,0,23,22,0,1,0,2
"2011","E00022483","E00022483","Total",148,77,26,51,0,32,15,17,37,31,1,3,2,2
"2011","E00022485","E00022485","Total",138,87,27,60,0,26,4,22,24,22,0,0,2,1
"2011","E00022447","E00022447","Total",142,42,9,33,2,69,47,22,29,28,0,1,0,0
"2011","E00022456","E00022456","Total",141,5,2,3,0,67,30,37,67,64,0,1,2,2
"2011","E00022476","E00022476","Total",193,49,13,36,1,22,10,12,121,118,1,2,0,0
"2011","E00022480","E00022480","Total",155,45,19,26,1,80,50,30,28,26,0,2,0,1
"2011","E00022484","E00022484","Total",113,44,24,20,1,51,47,4,12,12,0,0,0,5
"2011","E00022486","E00022486","Total",137,29,14,15,2,54,25,29,49,49,0,0,0,3
"2011","E00022453","E00022453","Total",138,119,61,58,0,3,1,2,15,14,0,0,1,1
"2011","E00022465","E00022465","Total",120,70,38,32,0,26,20,6,24,21,1,2,0,0
"2011","E00022471","E00022471","Total",132,84,29,55,0,2,2,0,44,35,7,2,0,2
"2011","E00022474","E00022474","Total",154,117,42,75,2,9,7,2,22,21,0,1,0,4
"2011","E00022475","E00022475","Total",113,64,23,41,0,2,1,1,46,37,7,1,1,1
"2011","E00022155","E00022155","Total",158,81,37,44,0,32,20,12,44,40,0,3,1,1
"2011","E00022166","E00022166","Total",134,43,16,27,2,36,29,7,51,48,0,2,1,2
"2011","E00022167","E00022167","Total",130,30,8,22,0,5,1,4,94,92,0,1,1,1
"2011","E00022169","E00022169","Total",170,40,12,28,0,7,0,7,119,119,0,0,0,4
"2011","E00022170","E00022170","Total",139,79,30,49,0,7,2,5,52,49,0,1,2,1
"2011","E00022172","E00022172","Total",117,54,17,37,1,10,3,7,52,49,0,2,1,0
"2011","E00022173","E00022173","Total",155,64,29,35,2,65,22,43,24,20,0,4,0,0
"2011","E00022175","E00022175","Total",101,56,20,36,0,13,3,10,32,31,0,1,0,0
"2011","E00022176","E00022176","Total",155,105,32,73,2,8,6,2,39,38,0,1,0,1
"2011","E00022177","E00022177","Total",148,76,30,46,1,40,29,11,31,28,0,1,2,0
"2011","E00022158","E00022158","Total",147,59,25,34,1,33,25,8,52,49,0,1,2,2
"2011","E00022181","E00022181","Total",87,53,18,35,0,15,4,11,17,16,0,0,1,2
"2011","E00022183","E00022183","Total",101,57,19,38,0,8,1,7,34,34,0,0,0,2
"2011","E00022184","E00022184","Total",122,38,14,24,2,25,17,8,55,53,0,1,1,2
"2011","E00022185","E00022185","Total",132,54,16,38,0,32,22,10,42,41,0,0,1,4
"2011","E00022186","E00022186","Total",122,29,15,14,9,48,4,44,31,24,1,1,5,5
"2011","E00022153","E00022153","Total",163,49,12,37,0,14,1,13,96,94,0,2,0,4
"2011","E00022162","E00022162","Total",130,68,28,40,0,9,1,8,51,51,0,0,0,2
"2011","E00022187","E00022187","Total",127,59,22,37,1,26,6,20,39,37,0,2,0,2
"2011","E00022189","E00022189","Total",119,42,12,30,1,15,5,10,61,60,0,1,0,0
"2011","E00022192","E00022192","Total",109,55,28,27,0,24,19,5,30,28,1,0,1,0
"2011","E00022350","E00022350","Total",135,59,19,40,6,51,11,40,17,13,0,3,1,2
"2011","E00022352","E00022352","Total",126,67,31,36,3,5,2,3,50,47,0,2,1,1
"2011","E00022354","E00022354","Total",143,82,44,38,2,9,2,7,47,44,2,0,1,3
"2011","E00022357","E00022357","Total",182,64,33,31,0,22,12,10,94,93,0,0,1,2
"2011","E00022348","E00022348","Total",146,77,21,56,2,15,6,9,49,46,0,2,1,3
"2011","E00022360","E00022360","Total",138,79,27,52,2,8,3,5,48,46,0,2,0,1
"2011","E00022364","E00022364","Total",128,85,39,46,1,5,3,2,37,36,0,1,0,0
"2011","E00022369","E00022369","Total",127,91,29,62,1,7,6,1,26,26,0,0,0,2
"2011","E00022372","E00022372","Total",114,61,30,31,0,17,6,11,34,32,0,2,0,2
"2011","E00022079","E00022079","Total",110,50,16,34,0,28,2,26,32,32,0,0,0,0
"2011","E00022080","E00022080","Total",127,83,28,55,0,7,3,4,36,35,0,0,1,1
"2011","E00022087","E00022087","Total",123,63,28,35,2,10,4,6,47,43,1,2,1,1
"2011","E00022108","E00022108","Total",126,72,18,54,0,13,1,12,39,37,0,2,0,2
"2011","E00022114","E00022114","Total",136,87,36,51,2,19,10,9,27,26,0,1,0,1
"2011","E00171483","E00171483","Total",128,21,4,17,2,21,12,9,82,77,1,1,3,2
"2011","E00171730","E00171730","Total",129,25,6,19,0,22,8,14,81,79,0,1,1,1
"2011","E00022082","E00022082","Total",126,40,13,27,0,26,15,11,59,59,0,0,0,1
"2011","E00022089","E00022089","Total",101,52,23,29,0,23,1,22,25,24,1,0,0,1
"2011","E00022091","E00022091","Total",110,54,22,32,3,15,7,8,38,36,0,2,0,0
"2011","E00022092","E00022092","Total",136,70,35,35,1,22,7,15,41,40,1,0,0,2
"2011","E00022093","E00022093","Total",143,32,11,21,0,91,83,8,19,17,0,2,0,1
"2011","E00022095","E00022095","Total",128,16,4,12,4,90,70,20,16,15,0,0,1,2
"2011","E00022078","E00022078","Total",102,39,16,23,1,23,19,4,35,34,0,1,0,4
"2011","E00022088","E00022088","Total",204,35,12,23,19,33,4,29,115,112,0,2,1,2
"2011","E00022106","E00022106","Total",136,63,15,48,1,4,3,1,68,66,0,2,0,0
"2011","E00022107","E00022107","Total",115,65,29,36,1,3,3,0,44,41,0,3,0,2
"2011","E00022110","E00022110","Total",109,68,30,38,0,11,3,8,29,28,0,0,1,1
"2011","E00022112","E00022112","Total",183,86,26,60,19,28,11,17,48,43,1,4,0,2
"2011","E00022351","E00022351","Total",101,25,8,17,1,61,50,11,14,13,0,1,0,0
"2011","E00022355","E00022355","Total",121,9,4,5,1,57,50,7,53,52,0,0,1,1
"2011","E00022356","E00022356","Total",220,43,12,31,11,120,46,74,41,40,0,0,1,5
"2011","E00022358","E00022358","Total",154,82,19,63,1,21,12,9,50,49,0,1,0,0
"2011","E00022359","E00022359","Total",176,61,12,49,0,37,13,24,77,76,0,1,0,1
"2011","E00022368","E00022368","Total",194,66,20,46,2,25,19,6,99,98,0,1,0,2
"2011","E00022346","E00022346","Total",142,57,16,41,0,10,7,3,73,72,1,0,0,2
"2011","E00022347","E00022347","Total",129,75,33,42,0,11,8,3,43,41,0,2,0,0
"2011","E00022361","E00022361","Total",116,79,27,52,2,8,6,2,27,27,0,0,0,0
"2011","E00022363","E00022363","Total",133,71,23,48,3,26,18,8,32,29,0,3,0,1
"2011","E00022365","E00022365","Total",157,82,33,49,3,37,26,11,34,34,0,0,0,1
"2011","E00022077","E00022077","Total",109,74,21,53,0,9,4,5,26,24,0,2,0,0
"2011","E00022094","E00022094","Total",117,60,20,40,0,14,8,6,42,38,0,3,1,1
"2011","E00022096","E00022096","Total",97,54,18,36,0,14,12,2,28,27,0,1,0,1
"2011","E00022097","E00022097","Total",109,75,26,49,0,13,9,4,21,20,0,1,0,0
"2011","E00022098","E00022098","Total",133,91,39,52,0,8,4,4,32,31,0,0,1,2
"2011","E00022228","E00022228","Total",130,72,35,37,3,10,6,4,43,41,0,1,1,2
"2011","E00022234","E00022234","Total",142,93,45,48,0,15,6,9,34,33,0,1,0,0
"2011","E00022264","E00022264","Total",140,69,40,29,0,29,9,20,40,38,1,1,0,2
"2011","E00022265","E00022265","Total",100,61,28,33,0,23,14,9,13,13,0,0,0,3
"2011","E00022267","E00022267","Total",92,57,25,32,3,8,8,0,22,21,0,1,0,2
"2011","E00022345","E00022345","Total",105,55,28,27,6,9,8,1,34,34,0,0,0,1
"2011","E00022353","E00022353","Total",119,47,17,30,2,47,38,9,23,23,0,0,0,0
"2011","E00022366","E00022366","Total",159,85,46,39,0,8,3,5,64,62,0,2,0,2
"2011","E00022367","E00022367","Total",119,56,21,35,0,37,32,5,25,23,0,2,0,1
"2011","E00022370","E00022370","Total",122,69,24,45,0,15,11,4,38,37,0,1,0,0
"2011","E00022341","E00022341","Total",161,81,32,49,2,27,15,12,51,49,0,2,0,0
"2011","E00022349","E00022349","Total",141,17,5,12,21,87,8,79,16,15,0,1,0,0
"2011","E00022362","E00022362","Total",189,99,38,61,1,14,7,7,72,68,0,3,1,3
"2011","E00022371","E00022371","Total",147,67,26,41,10,18,5,13,49,47,0,1,1,3
"2011","E00022375","E00022375","Total",121,45,6,39,0,3,0,3,73,68,0,4,1,0
"2011","E00022342","E00022342","Total",113,21,5,16,0,82,43,39,8,8,0,0,0,2
"2011","E00022343","E00022343","Total",105,28,7,21,3,58,33,25,14,13,0,1,0,2
"2011","E00022344","E00022344","Total",125,52,16,36,2,50,45,5,19,19,0,0,0,2
"2011","E00022373","E00022373","Total",137,28,7,21,0,93,36,57,15,15,0,0,0,1
"2011","E00022374","E00022374","Total",119,18,3,15,3,89,7,82,9,5,0,1,3,0
"2011","E00021944","E00021944","Total",131,86,34,52,3,5,1,4,36,35,0,1,0,1
"2011","E00021945","E00021945","Total",145,100,44,56,0,7,0,7,34,33,1,0,0,4
"2011","E00021965","E00021965","Total",101,81,29,52,0,3,0,3,17,17,0,0,0,0
"2011","E00021969","E00021969","Total",129,96,46,50,2,7,2,5,23,21,0,0,2,1
"2011","E00021949","E00021949","Total",136,48,13,35,0,52,11,41,32,28,0,1,3,4
"2011","E00021954","E00021954","Total",130,78,37,41,0,29,8,21,22,19,0,2,1,1
"2011","E00021966","E00021966","Total",116,64,39,25,0,12,3,9,37,36,0,1,0,3
"2011","E00021970","E00021970","Total",112,46,18,28,0,39,7,32,27,26,0,0,1,0
"2011","E00021972","E00021972","Total",69,21,9,12,0,26,5,21,21,21,0,0,0,1
"2011","E00021952","E00021952","Total",130,96,52,44,1,10,2,8,21,20,0,1,0,2
"2011","E00021953","E00021953","Total",134,71,40,31,0,10,0,10,53,51,0,1,1,0
"2011","E00021955","E00021955","Total",133,78,35,43,0,9,1,8,46,40,1,4,1,0
"2011","E00021956","E00021956","Total",137,88,59,29,0,9,5,4,37,34,0,3,0,3
"2011","E00021964","E00021964","Total",108,71,34,37,9,7,1,6,20,18,0,2,0,1
"2011","E00021957","E00021957","Total",129,67,35,32,0,14,1,13,46,46,0,0,0,2
"2011","E00021958","E00021958","Total",131,68,27,41,4,21,3,18,38,38,0,0,0,0
"2011","E00021959","E00021959","Total",134,78,41,37,2,9,2,7,42,40,0,1,1,3
"2011","E00021961","E00021961","Total",143,84,38,46,2,17,11,6,38,38,0,0,0,2
"2011","E00021942","E00021942","Total",145,79,32,47,6,11,3,8,48,46,0,2,0,1
"2011","E00021943","E00021943","Total",154,77,33,44,0,23,8,15,54,53,0,1,0,0
"2011","E00021960","E00021960","Total",135,70,30,40,2,7,1,6,54,50,0,0,4,2
"2011","E00021962","E00021962","Total",141,37,17,20,5,18,5,13,81,80,0,0,1,0
"2011","E00021963","E00021963","Total",145,60,35,25,0,17,2,15,66,63,0,3,0,2
"2011","E00021946","E00021946","Total",157,80,38,42,0,5,1,4,70,67,0,3,0,2
"2011","E00021971","E00021971","Total",139,41,18,23,1,62,12,50,31,31,0,0,0,4
"2011","E00171484","E00171484","Total",86,27,14,13,4,13,4,9,42,42,0,0,0,0
"2011","E00171486","E00171486","Total",113,19,8,11,0,6,1,5,88,86,0,2,0,0
"2011","E00171488","E00171488","Total",85,15,5,10,0,11,4,7,58,57,0,1,0,1
"2011","E00171724","E00171724","Total",120,50,19,31,14,20,1,19,33,30,1,2,0,3
"2011","E00022156","E00022156","Total",150,86,35,51,12,28,8,20,22,20,0,1,1,2
"2011","E00022164","E00022164","Total",127,27,10,17,1,58,54,4,39,36,0,3,0,2
"2011","E00022168","E00022168","Total",135,73,30,43,0,18,5,13,42,42,0,0,0,2
"2011","E00022171","E00022171","Total",154,82,34,48,0,26,9,17,45,43,0,1,1,1
"2011","E00022258","E00022258","Total",161,29,15,14,5,73,41,32,54,52,2,0,0,0
"2011","E00022259","E00022259","Total",151,93,32,61,0,6,1,5,52,48,0,1,3,0
"2011","E00022260","E00022260","Total",126,37,14,23,1,42,27,15,45,43,0,1,1,1
"2011","E00022261","E00022261","Total",142,53,24,29,0,20,8,12,68,65,1,2,0,1
"2011","E00022262","E00022262","Total",210,69,30,39,0,98,13,85,43,35,0,2,6,0
"2011","E00022230","E00022230","Total",140,72,38,34,1,13,3,10,53,50,0,3,0,1
"2011","E00022236","E00022236","Total",111,42,21,21,0,32,7,25,36,35,0,0,1,1
"2011","E00022244","E00022244","Total",143,48,28,20,1,58,27,31,32,31,0,1,0,4
"2011","E00022263","E00022263","Total",145,8,1,7,0,106,54,52,30,27,0,2,1,1
"2011","E00022266","E00022266","Total",158,45,17,28,2,31,6,25,80,73,1,3,3,0
"2011","E00022281","E00022281","Total",140,19,9,10,0,74,13,61,45,43,1,1,0,2
"2011","E00022287","E00022287","Total",184,31,14,17,2,132,22,110,16,16,0,0,0,3
"2011","E00022288","E00022288","Total",119,46,16,30,1,22,5,17,48,45,0,0,3,2
"2011","E00022290","E00022290","Total",145,22,6,16,1,104,22,82,16,15,0,0,1,2
"2011","E00171494","E00171494","Total",172,18,3,15,1,131,17,114,18,14,1,0,3,4
"2011","E00171495","E00171495","Total",176,21,5,16,4,137,28,109,12,11,0,0,1,2
"2011","E00021941","E00021941","Total",141,74,23,51,0,18,3,15,49,45,2,2,0,0
"2011","E00021947","E00021947","Total",126,61,30,31,1,20,0,20,44,42,0,2,0,0
"2011","E00021950","E00021950","Total",142,65,23,42,0,20,0,20,55,54,0,1,0,2
"2011","E00021951","E00021951","Total",136,58,26,32,6,42,5,37,28,26,0,2,0,2
"2011","E00021967","E00021967","Total",131,50,17,33,2,11,2,9,66,65,0,0,1,2
"2011","E00022317","E00022317","Total",130,52,22,30,1,21,0,21,54,54,0,0,0,2
"2011","E00022331","E00022331","Total",100,46,14,32,0,25,1,24,29,28,0,0,1,0
"2011","E00022332","E00022332","Total",137,40,16,24,1,59,20,39,36,34,0,2,0,1
"2011","E00022337","E00022337","Total",106,63,24,39,0,11,7,4,31,30,0,1,0,1
"2011","E00022340","E00022340","Total",107,59,29,30,0,1,0,1,46,45,0,1,0,1
"2011","E00022313","E00022313","Total",169,43,25,18,0,77,3,74,42,41,0,1,0,7
"2011","E00022314","E00022314","Total",145,62,24,38,1,36,4,32,46,42,0,4,0,0
"2011","E00022316","E00022316","Total",153,36,17,19,0,24,6,18,91,86,0,1,4,2
"2011","E00022318","E00022318","Total",141,54,30,24,0,15,2,13,71,68,0,3,0,1
"2011","E00022319","E00022319","Total",154,60,25,35,2,33,1,32,59,59,0,0,0,0
"2011","E00022308","E00022308","Total",110,45,26,19,2,12,1,11,51,49,0,2,0,0
"2011","E00022321","E00022321","Total",117,34,8,26,1,24,5,19,57,56,0,0,1,1
"2011","E00022323","E00022323","Total",118,67,33,34,0,17,2,15,34,32,0,1,1,0
"2011","E00022325","E00022325","Total",129,64,30,34,0,27,5,22,37,36,0,1,0,1
"2011","E00022327","E00022327","Total",145,65,31,34,0,44,6,38,35,32,0,3,0,1
"2011","E00022333","E00022333","Total",129,77,31,46,0,12,3,9,38,37,0,1,0,2
"2011","E00022334","E00022334","Total",141,93,34,59,2,5,1,4,40,37,1,2,0,1
"2011","E00022335","E00022335","Total",122,84,25,59,0,6,1,5,32,31,0,1,0,0
"2011","E00022338","E00022338","Total",137,67,26,41,0,20,2,18,50,50,0,0,0,0
"2011","E00022339","E00022339","Total",139,49,19,30,0,20,11,9,69,67,0,1,1,1
"2011","E00022239","E00022239","Total",156,114,44,70,0,4,1,3,38,33,0,5,0,0
"2011","E00022245","E00022245","Total",169,98,47,51,14,19,4,15,34,32,0,2,0,4
"2011","E00022248","E00022248","Total",148,75,34,41,0,10,5,5,60,55,1,4,0,3
"2011","E00022250","E00022250","Total",116,77,41,36,0,10,6,4,26,24,0,1,1,3
"2011","E00022229","E00022229","Total",168,48,17,31,2,25,14,11,90,86,0,1,3,3
"2011","E00022231","E00022231","Total",121,68,18,50,2,19,11,8,30,30,0,0,0,2
"2011","E00022247","E00022247","Total",125,64,24,40,0,11,3,8,48,45,0,3,0,2
"2011","E00022251","E00022251","Total",98,24,3,21,0,17,6,11,56,53,0,3,0,1
"2011","E00022254","E00022254","Total",115,8,2,6,5,87,15,72,13,12,0,0,1,2
"2011","E00022235","E00022235","Total",157,80,12,68,1,19,10,9,57,53,0,4,0,0
"2011","E00022238","E00022238","Total",146,75,10,65,0,27,12,15,44,43,0,1,0,0
"2011","E00022240","E00022240","Total",247,69,15,54,27,69,16,53,82,78,0,3,1,0
"2011","E00022242","E00022242","Total",146,66,13,53,0,17,11,6,61,60,0,0,1,2
"2011","E00022243","E00022243","Total",152,69,9,60,0,29,20,9,54,53,0,1,0,0
"2011","E00022237","E00022237","Total",114,81,35,46,0,10,6,4,22,22,0,0,0,1
"2011","E00022241","E00022241","Total",114,66,32,34,0,17,15,2,29,27,0,2,0,2
"2011","E00022246","E00022246","Total",120,77,31,46,1,6,2,4,36,35,0,1,0,0
"2011","E00022252","E00022252","Total",111,57,25,32,3,24,3,21,26,24,0,1,1,1
"2011","E00022253","E00022253","Total",131,90,34,56,0,2,0,2,37,35,0,1,1,2
"2011","E00022232","E00022232","Total",145,63,17,46,3,8,6,2,70,67,0,2,1,1
"2011","E00022233","E00022233","Total",162,71,18,53,1,8,4,4,81,80,0,0,1,1
"2011","E00022249","E00022249","Total",131,48,14,34,0,9,4,5,70,66,0,4,0,4
"2011","E00022255","E00022255","Total",164,60,17,43,4,11,6,5,88,83,0,3,2,1
"2011","E00022256","E00022256","Total",145,54,14,40,1,2,0,2,86,84,0,2,0,2
"2011","E00022257","E00022257","Total",105,42,12,30,0,4,2,2,59,59,0,0,0,0
"2011","E00021989","E00021989","Total",124,41,16,25,1,16,7,9,66,64,0,2,0,0
"2011","E00021993","E00021993","Total",133,47,8,39,1,18,6,12,67,67,0,0,0,0
"2011","E00021996","E00021996","Total",128,58,21,37,0,3,2,1,66,64,0,1,1,1
"2011","E00021997","E00021997","Total",144,44,13,31,0,17,3,14,83,78,0,2,3,0
"2011","E00022000","E00022000","Total",86,40,11,29,1,8,3,5,36,35,0,1,0,1
"2011","E00021977","E00021977","Total",129,63,24,39,0,12,2,10,53,52,0,1,0,1
"2011","E00021990","E00021990","Total",121,60,23,37,0,9,1,8,51,51,0,0,0,1
"2011","E00021991","E00021991","Total",123,72,34,38,1,7,0,7,43,43,0,0,0,0
"2011","E00021992","E00021992","Total",111,61,20,41,0,12,2,10,38,34,0,4,0,0
"2011","E00021995","E00021995","Total",152,84,30,54,0,4,2,2,64,64,0,0,0,0
"2011","E00021973","E00021973","Total",134,75,24,51,1,13,4,9,45,44,0,1,0,0
"2011","E00021974","E00021974","Total",164,74,23,51,0,4,2,2,86,81,0,4,1,0
"2011","E00021994","E00021994","Total",142,79,24,55,0,6,0,6,57,55,0,2,0,0
"2011","E00022001","E00022001","Total",134,58,15,43,0,8,2,6,66,66,0,0,0,2
"2011","E00022004","E00022004","Total",170,54,16,38,0,6,0,6,108,107,0,1,0,2
"2011","E00022280","E00022280","Total",129,69,18,51,1,6,1,5,52,52,0,0,0,1
"2011","E00022289","E00022289","Total",163,83,35,48,1,7,3,4,70,70,0,0,0,2
"2011","E00022292","E00022292","Total",131,76,24,52,0,15,3,12,38,37,0,1,0,2
"2011","E00022293","E00022293","Total",112,38,21,17,1,25,9,16,46,45,1,0,0,2
"2011","E00022294","E00022294","Total",117,72,29,43,0,8,0,8,36,31,0,5,0,1
"2011","E00022268","E00022268","Total",152,30,12,18,0,57,6,51,62,61,0,1,0,3
"2011","E00022269","E00022269","Total",198,80,21,59,0,33,0,33,83,78,0,2,3,2
"2011","E00022295","E00022295","Total",138,63,19,44,1,12,4,8,61,59,0,2,0,1
"2011","E00022297","E00022297","Total",120,59,31,28,0,25,3,22,36,33,0,2,1,0
"2011","E00022300","E00022300","Total",141,44,18,26,6,31,10,21,60,59,0,1,0,0
"2011","E00021789","E00021789","Total",197,62,24,38,2,54,32,22,78,76,0,2,0,1
"2011","E00021790","E00021790","Total",158,85,30,55,0,39,7,32,32,31,0,1,0,2
"2011","E00021791","E00021791","Total",116,6,3,3,0,102,87,15,7,7,0,0,0,1
"2011","E00021792","E00021792","Total",140,48,12,36,1,54,41,13,36,32,0,2,2,1
"2011","E00021793","E00021793","Total",116,30,8,22,1,66,61,5,16,16,0,0,0,3
"2011","E00021794","E00021794","Total",119,20,8,12,0,80,73,7,16,16,0,0,0,3
"2011","E00021795","E00021795","Total",134,8,2,6,1,116,100,16,7,7,0,0,0,2
"2011","E00021797","E00021797","Total",143,34,14,20,0,94,75,19,14,13,0,1,0,1
"2011","E00021798","E00021798","Total",125,26,9,17,0,83,70,13,12,12,0,0,0,4
"2011","E00022322","E00022322","Total",136,102,48,54,0,6,2,4,24,23,0,0,1,4
"2011","E00022324","E00022324","Total",98,32,13,19,1,12,7,5,52,49,0,2,1,1
"2011","E00022326","E00022326","Total",124,64,26,38,0,12,5,7,46,43,0,3,0,2
"2011","E00022336","E00022336","Total",133,48,13,35,0,41,3,38,42,34,2,3,3,2
"2011","E00171489","E00171489","Total",92,42,20,22,2,1,1,0,45,43,0,2,0,2
"2011","E00171491","E00171491","Total",88,21,5,16,8,1,0,1,58,56,0,2,0,0
"2011","E00171725","E00171725","Total",101,30,14,16,1,3,0,3,65,62,2,1,0,2
"2011","E00022310","E00022310","Total",193,55,22,33,9,23,3,20,105,103,1,1,0,1
"2011","E00022312","E00022312","Total",120,54,17,37,3,16,3,13,46,46,0,0,0,1
"2011","E00022320","E00022320","Total",137,50,17,33,9,12,4,8,65,63,0,2,0,1
"2011","E00022330","E00022330","Total",69,40,17,23,0,8,1,7,21,18,1,1,1,0
"2011","E00171492","E00171492","Total",117,35,11,24,15,18,2,16,47,45,0,2,0,2
"2011","E00171503","E00171503","Total",73,7,2,5,16,24,1,23,25,25,0,0,0,1
"2011","E00171506","E00171506","Total",85,39,20,19,0,9,0,9,36,35,0,0,1,1
"2011","E00022307","E00022307","Total",215,139,51,88,4,24,6,18,46,44,0,2,0,2
"2011","E00022309","E00022309","Total",159,86,44,42,1,31,5,26,40,38,0,2,0,1
"2011","E00022311","E00022311","Total",167,83,31,52,0,7,2,5,75,73,0,2,0,2
"2011","E00022329","E00022329","Total",94,66,21,45,0,8,2,6,20,19,0,1,0,0
"2011","E00021978","E00021978","Total",143,68,34,34,1,12,3,9,61,60,0,1,0,1
"2011","E00021979","E00021979","Total",164,105,53,52,0,16,2,14,41,38,1,1,1,2
"2011","E00021998","E00021998","Total",176,54,20,34,3,19,7,12,99,95,1,2,1,1
"2011","E00022002","E00022002","Total",132,77,26,51,0,17,0,17,36,32,0,3,1,2
"2011","E00021999","E00021999","Total",117,69,35,34,1,10,4,6,36,35,0,1,0,1
"2011","E00022003","E00022003","Total",142,36,12,24,1,12,2,10,91,90,0,0,1,2
"2011","E00022005","E00022005","Total",167,53,20,33,1,37,2,35,75,74,0,0,1,1
"2011","E00022006","E00022006","Total",92,50,16,34,0,4,2,2,37,37,0,0,0,1
"2011","E00022009","E00022009","Total",103,57,29,28,1,19,2,17,24,23,0,0,1,2
"2011","E00021975","E00021975","Total",142,88,39,49,0,11,6,5,41,38,0,2,1,2
"2011","E00021980","E00021980","Total",112,49,23,26,1,12,1,11,49,49,0,0,0,1
"2011","E00021984","E00021984","Total",138,46,22,24,1,6,3,3,84,80,1,3,0,1
"2011","E00022007","E00022007","Total",164,109,40,69,2,10,1,9,43,41,0,2,0,0
"2011","E00022008","E00022008","Total",132,70,31,39,0,18,4,14,42,35,0,7,0,2
"2011","E00021976","E00021976","Total",103,55,26,29,0,7,1,6,41,40,0,1,0,0
"2011","E00021981","E00021981","Total",164,54,16,38,1,17,1,16,90,85,0,2,3,2
"2011","E00021982","E00021982","Total",106,46,24,22,0,4,1,3,54,53,0,1,0,2
"2011","E00022010","E00022010","Total",144,60,16,44,0,24,1,23,56,55,0,1,0,4
"2011","E00022011","E00022011","Total",130,55,14,41,0,8,2,6,65,62,0,1,2,2
"2011","E00021983","E00021983","Total",126,50,26,24,0,24,2,22,52,49,0,3,0,0
"2011","E00021985","E00021985","Total",94,50,26,24,0,3,0,3,41,41,0,0,0,0
"2011","E00021986","E00021986","Total",142,67,32,35,0,17,3,14,55,54,0,0,1,3
"2011","E00021987","E00021987","Total",110,42,25,17,1,9,1,8,57,57,0,0,0,1
"2011","E00021988","E00021988","Total",182,64,35,29,0,16,3,13,101,98,1,0,2,1
"2011","E00021808","E00021808","Total",125,34,18,16,0,21,13,8,68,64,0,2,2,2
"2011","E00021821","E00021821","Total",121,31,23,8,0,50,2,48,40,40,0,0,0,0
"2011","E00021823","E00021823","Total",122,40,27,13,1,7,1,6,74,71,1,1,1,0
"2011","E00021825","E00021825","Total",87,40,20,20,0,9,3,6,36,36,0,0,0,2
"2011","E00021828","E00021828","Total",109,59,30,29,0,11,8,3,39,38,0,0,1,0
"2011","E00022270","E00022270","Total",120,16,5,11,0,92,9,83,12,10,0,1,1,0
"2011","E00022272","E00022272","Total",137,22,10,12,0,104,13,91,11,10,0,1,0,0
"2011","E00022298","E00022298","Total",134,14,6,8,0,110,20,90,8,7,0,0,1,2
"2011","E00022299","E00022299","Total",125,30,13,17,0,66,16,50,28,28,0,0,0,1
"2011","E00022301","E00022301","Total",137,22,4,18,0,102,23,79,12,12,0,0,0,1
"2011","E00022271","E00022271","Total",137,55,22,33,3,34,4,30,44,44,0,0,0,1
"2011","E00022303","E00022303","Total",105,17,4,13,6,65,4,61,14,12,0,0,2,3
"2011","E00022304","E00022304","Total",113,66,39,27,1,8,1,7,38,37,0,1,0,0
"2011","E00022305","E00022305","Total",181,67,38,29,22,23,5,18,68,65,0,2,1,1
"2011","E00022306","E00022306","Total",117,18,1,17,2,82,12,70,14,12,0,1,1,1
"2011","E00022273","E00022273","Total",152,75,34,41,1,24,2,22,51,48,0,2,1,1
"2011","E00022276","E00022276","Total",249,55,19,36,9,9,4,5,175,170,1,4,0,1
"2011","E00022277","E00022277","Total",142,59,23,36,3,15,4,11,63,59,1,3,0,2
"2011","E00022278","E00022278","Total",134,65,32,33,1,13,3,10,54,53,0,1,0,1
"2011","E00022279","E00022279","Total",150,50,24,26,0,18,4,14,80,78,0,2,0,2
"2011","E00022274","E00022274","Total",143,52,17,35,1,64,12,52,22,22,0,0,0,4
"2011","E00022275","E00022275","Total",161,65,23,42,2,39,3,36,54,50,0,1,3,1
"2011","E00022291","E00022291","Total",157,71,28,43,3,29,11,18,52,50,2,0,0,2
"2011","E00022296","E00022296","Total",130,34,11,23,0,64,19,45,29,27,0,1,1,3
"2011","E00022302","E00022302","Total",146,87,57,30,3,15,6,9,40,40,0,0,0,1
"2011","E00021826","E00021826","Total",60,15,5,10,0,27,17,10,18,17,0,0,1,0
"2011","E00021827","E00021827","Total",134,16,5,11,0,109,59,50,8,8,0,0,0,1
"2011","E00021830","E00021830","Total",137,5,0,5,0,128,117,11,2,2,0,0,0,2
"2011","E00021833","E00021833","Total",120,3,1,2,1,105,46,59,11,10,0,0,1,0
"2011","E00021836","E00021836","Total",194,26,7,19,2,105,37,68,59,56,0,2,1,2
"2011","E00021829","E00021829","Total",146,45,7,38,0,57,46,11,43,41,0,1,1,1
"2011","E00021831","E00021831","Total",98,32,12,20,0,37,33,4,28,23,2,3,0,1
"2011","E00021832","E00021832","Total",114,30,13,17,0,57,33,24,27,27,0,0,0,0
"2011","E00021834","E00021834","Total",120,48,21,27,0,45,40,5,24,23,0,0,1,3
"2011","E00021835","E00021835","Total",127,26,16,10,2,80,58,22,18,18,0,0,0,1
"2011","E00021837","E00021837","Total",112,32,16,16,2,48,33,15,30,28,0,2,0,0
"2011","E00021807","E00021807","Total",117,61,26,35,0,13,7,6,43,43,0,0,0,0
"2011","E00021824","E00021824","Total",164,62,28,34,1,10,2,8,88,85,0,2,1,3
"2011","E00171502","E00171502","Total",161,70,37,33,0,13,6,7,77,75,0,1,1,1
"2011","E00171505","E00171505","Total",138,58,29,29,1,13,8,5,66,65,0,1,0,0
"2011","E00021809","E00021809","Total",123,44,19,25,0,48,5,43,30,29,0,1,0,1
"2011","E00021811","E00021811","Total",146,51,23,28,1,21,8,13,71,69,0,2,0,2
"2011","E00021812","E00021812","Total",157,71,25,46,0,7,4,3,78,78,0,0,0,1
"2011","E00021813","E00021813","Total",132,69,22,47,0,17,5,12,46,40,0,6,0,0
"2011","E00021838","E00021838","Total",103,26,4,22,6,29,21,8,42,42,0,0,0,0
"2011","E00021814","E00021814","Total",148,39,15,24,1,77,66,11,30,27,0,3,0,1
"2011","E00021815","E00021815","Total",97,12,2,10,0,60,39,21,25,24,0,0,1,0
"2011","E00021817","E00021817","Total",162,45,17,28,2,33,10,23,78,76,0,2,0,4
"2011","E00021819","E00021819","Total",179,19,2,17,0,145,22,123,14,13,0,0,1,1
"2011","E00021822","E00021822","Total",112,34,10,24,0,33,2,31,44,41,0,1,2,1
"2011","E00021805","E00021805","Total",126,24,3,21,0,37,4,33,65,64,0,0,1,0
"2011","E00021810","E00021810","Total",227,67,25,42,0,69,32,37,91,90,0,1,0,0
"2011","E00021816","E00021816","Total",84,3,1,2,0,76,7,69,4,4,0,0,0,1
"2011","E00021818","E00021818","Total",117,16,4,12,0,78,16,62,23,23,0,0,0,0
"2011","E00021820","E00021820","Total",111,32,10,22,0,70,11,59,7,6,0,0,1,2
"2011","E00021796","E00021796","Total",143,42,11,31,0,63,47,16,36,34,0,2,0,2
"2011","E00021799","E00021799","Total",113,50,19,31,1,46,36,10,15,13,0,2,0,1
"2011","E00021800","E00021800","Total",111,43,13,30,0,33,14,19,33,33,0,0,0,2
"2011","E00021802","E00021802","Total",98,33,12,21,0,42,31,11,22,21,1,0,0,1
"2011","E00021769","E00021769","Total",147,86,30,56,1,10,4,6,49,44,0,3,2,1
"2011","E00021770","E00021770","Total",139,43,9,34,1,36,20,16,57,54,0,3,0,2
"2011","E00021776","E00021776","Total",142,62,11,51,0,25,8,17,54,52,0,2,0,1
"2011","E00021783","E00021783","Total",126,68,21,47,0,11,7,4,47,46,0,1,0,0
"2011","E00021801","E00021801","Total",117,46,17,29,1,18,10,8,51,49,0,1,1,1
"2011","E00021773","E00021773","Total",128,46,10,36,1,16,9,7,60,57,0,3,0,5
"2011","E00021774","E00021774","Total",145,63,19,44,1,23,6,17,57,52,1,3,1,1
"2011","E00021775","E00021775","Total",141,83,27,56,1,12,5,7,45,41,0,4,0,0
"2011","E00021777","E00021777","Total",120,50,14,36,0,29,17,12,39,38,0,1,0,2
"2011","E00021779","E00021779","Total",137,73,22,51,0,21,5,16,42,41,0,1,0,1
"2011","E00021768","E00021768","Total",205,101,40,61,2,27,12,15,75,74,0,1,0,0
"2011","E00021803","E00021803","Total",91,48,15,33,1,2,1,1,39,39,0,0,0,1
"2011","E00171508","E00171508","Total",117,69,21,48,1,13,3,10,32,30,0,2,0,2
"2011","E00171509","E00171509","Total",103,68,31,37,0,8,3,5,27,27,0,0,0,0
"2011","E00171511","E00171511","Total",109,48,16,32,0,15,7,8,46,44,0,2,0,0
"2011","E00021772","E00021772","Total",125,53,22,31,1,36,9,27,34,34,0,0,0,1
"2011","E00021778","E00021778","Total",136,64,17,47,1,15,6,9,53,50,1,2,0,3
"2011","E00021780","E00021780","Total",78,21,8,13,0,15,8,7,41,37,0,4,0,1
"2011","E00021781","E00021781","Total",103,36,18,18,0,43,8,35,23,20,0,2,1,1
"2011","E00021784","E00021784","Total",114,56,22,34,2,15,7,8,41,39,0,2,0,0
"2011","E00021804","E00021804","Total",119,56,22,34,1,18,4,14,42,39,0,3,0,2
"2011","E00021782","E00021782","Total",158,76,21,55,0,14,3,11,64,59,1,4,0,4
"2011","E00021785","E00021785","Total",80,9,3,6,0,8,2,6,63,59,0,3,1,0
"2011","E00021786","E00021786","Total",133,47,22,25,0,28,6,22,56,55,0,1,0,2
"2011","E00021787","E00021787","Total",139,51,22,29,1,44,33,11,36,34,0,1,1,7
"2011","E00021788","E00021788","Total",123,45,23,22,0,38,30,8,34,32,0,1,1,6
