OA11CD,Rural Urban,All categories: Type of central heating in household,Does not have central heating,Does have central heating,Occupancy rating (rooms) of -1 or less,Occupancy rating (bedrooms) of -1 or less,Average household size,Average number of rooms per household,Average number of bedrooms per household
E00016403,Total,142,2,140,38,29,2.6,4.1,2.1
E00016437,Total,159,3,156,63,50,3.4,4.5,2.5
E00016439,Total,178,0,178,81,35,2.1,3.4,1.7
E00016442,Total,139,2,137,50,28,2.5,3.7,2.0
E00016399,Total,141,0,141,46,28,3.3,4.6,2.7
E00016401,Total,154,3,151,51,13,2.2,3.7,2.0
E00016406,Total,119,2,117,42,22,2.8,4.0,2.2
E00016435,Total,170,1,169,65,31,2.5,3.8,2.0
E00016395,Total,115,0,115,32,25,2.5,4.2,2.1
E00016404,Total,120,4,116,23,16,3.1,5.3,3.2
E00016405,Total,138,9,129,53,21,2.2,3.8,2.1
E00016408,Total,68,1,67,18,9,2.2,3.9,1.9
E00016410,Total,112,3,109,19,16,2.9,5.9,3.1
E00016438,Total,132,20,112,48,15,1.8,3.2,1.6
E00016398,Total,111,2,109,29,15,2.1,3.7,1.9
E00016431,Total,110,1,109,25,17,2.2,4.0,2.0
E00016432,Total,160,5,155,38,21,2.2,3.9,2.1
E00016434,Total,167,1,166,62,23,2.4,3.8,2.2
E00173943,Total,164,4,160,49,17,2.1,3.6,1.8
E00173946,Total,185,11,174,66,12,1.8,3.4,1.8
E00016397,Total,210,13,197,75,34,2.3,3.8,2.0
E00016433,Total,140,2,138,29,16,2.1,4.0,2.0
E00016436,Total,101,2,99,31,18,2.0,3.8,1.9
E00016440,Total,108,5,103,31,20,3.1,4.5,2.6
E00016441,Total,204,5,199,74,42,2.1,3.5,1.8
E00016412,Total,151,4,147,45,24,2.3,4.1,2.3
E00016414,Total,144,4,140,45,31,2.4,4.0,2.1
E00016418,Total,153,12,141,42,27,2.6,4.1,2.1
E00016422,Total,111,4,107,36,28,3.1,4.4,2.4
E00016402,Total,128,2,126,44,23,2.4,3.9,2.1
E00016407,Total,146,16,130,58,35,1.7,3.1,1.2
E00016409,Total,146,2,144,55,32,2.7,3.9,2.1
E00016411,Total,172,11,161,57,25,2.2,3.6,1.8
E00016413,Total,126,3,123,38,26,2.4,4.1,2.2
E00016415,Total,140,3,137,52,22,2.4,4.4,2.2
E00016416,Total,104,0,104,38,22,2.5,3.9,2.1
E00016419,Total,118,1,117,29,16,3.1,4.8,2.8
E00016420,Total,121,0,121,49,36,2.9,4.4,2.2
E00173947,Total,123,3,120,50,39,2.6,3.6,1.8
E00173948,Total,171,3,168,104,21,2.2,3.1,1.8
E00016417,Total,138,2,136,43,23,2.5,4.2,2.2
E00016421,Total,125,3,122,51,33,2.4,3.7,2.0
E00016423,Total,122,1,121,36,33,3.0,4.4,2.4
E00016424,Total,123,0,123,43,25,2.5,3.9,2.1
E00016427,Total,105,2,103,45,27,2.2,3.7,1.8
E00016396,Total,134,2,132,50,23,2.0,3.7,1.9
E00016426,Total,134,3,131,40,27,2.3,3.9,1.8
E00016428,Total,157,7,150,86,39,2.2,3.3,1.7
E00016429,Total,124,2,122,17,8,2.1,4.5,2.3
E00016430,Total,120,4,116,56,21,2.2,3.8,2.0
E00016680,Total,122,19,103,66,26,1.8,2.8,1.2
E00016716,Total,159,31,128,92,43,2.0,2.9,1.3
E00016717,Total,102,17,85,44,20,1.8,2.9,1.2
E00016719,Total,117,2,115,40,27,2.1,3.6,1.8
E00016720,Total,148,16,132,76,41,2.2,3.0,1.3
E00016725,Total,119,16,103,66,44,2.1,2.9,1.2
E00016706,Total,103,2,101,34,23,2.4,4.1,2.2
E00016708,Total,130,4,126,39,31,2.7,4.2,2.2
E00016709,Total,137,3,134,40,22,2.9,4.9,2.7
E00016714,Total,114,5,109,30,23,2.7,4.1,2.2
E00016715,Total,125,10,115,30,22,2.6,4.7,2.3
E00016675,Total,116,21,95,49,25,2.0,3.2,1.4
E00016677,Total,131,7,124,31,19,2.2,4.0,2.2
E00016683,Total,138,16,122,58,33,2.2,3.5,1.8
E00016697,Total,121,3,118,42,27,3.0,4.2,2.4
E00173940,Total,113,4,109,25,12,3.1,4.8,2.9
E00173949,Total,148,6,142,33,19,2.6,4.2,2.4
E00016684,Total,107,2,105,34,17,2.2,3.6,1.8
E00016687,Total,108,6,102,46,15,1.7,3.0,1.4
E00016694,Total,135,3,132,41,19,2.4,4.1,2.2
E00016718,Total,128,5,123,36,21,2.0,3.7,1.7
E00016721,Total,109,2,107,28,21,2.2,4.1,2.0
E00016723,Total,123,3,120,48,32,2.2,3.6,1.8
E00016679,Total,91,7,84,18,11,2.5,4.4,2.4
E00016689,Total,115,5,110,19,13,2.3,4.4,2.3
E00016693,Total,125,3,122,39,16,2.8,4.4,2.6
E00016701,Total,88,2,86,24,14,2.5,4.3,2.3
E00173939,Total,94,1,93,35,21,2.3,3.5,1.8
E00016210,Total,142,3,139,47,19,2.4,4.1,2.2
E00016239,Total,148,8,140,61,23,2.2,3.6,2.0
E00016240,Total,85,2,83,35,15,2.0,3.5,1.8
E00016241,Total,143,5,138,46,23,2.0,3.7,1.9
E00016245,Total,97,0,97,38,12,2.8,4.3,2.5
E00016211,Total,113,1,112,38,19,2.3,4.1,2.2
E00016213,Total,170,2,168,57,39,2.2,3.7,1.9
E00016244,Total,128,4,124,40,34,2.8,4.7,2.4
E00016250,Total,141,4,137,40,27,2.0,3.9,1.9
E00174011,Total,53,0,53,34,6,2.0,2.9,1.7
E00174032,Total,132,4,128,61,39,2.7,3.9,2.2
E00174033,Total,41,3,38,15,10,3.2,4.6,2.8
E00016216,Total,171,0,171,40,21,2.0,3.9,2.0
E00016236,Total,204,14,190,85,25,1.9,3.2,1.7
E00016246,Total,137,9,128,41,25,2.6,4.4,2.3
E00016248,Total,174,0,174,35,14,1.8,3.8,1.6
E00016252,Total,164,9,155,43,19,2.1,4.2,2.1
E00016214,Total,162,4,158,33,22,2.4,4.6,2.4
E00016215,Total,135,5,130,36,29,2.3,4.6,2.4
E00016217,Total,186,8,178,49,17,2.2,4.3,2.2
E00016237,Total,112,5,107,15,11,2.6,5.6,3.1
E00016247,Total,140,7,133,25,7,2.0,4.3,2.1
E00016253,Total,132,5,127,30,20,2.3,4.6,2.3
E00016209,Total,158,3,155,53,32,2.7,4.4,2.4
E00016235,Total,145,6,139,50,28,1.9,3.8,1.9
E00016238,Total,181,10,171,64,22,2.2,4.2,2.3
E00173941,Total,105,4,101,55,26,2.8,4.0,2.2
E00173942,Total,77,4,73,30,19,2.6,3.9,2.1
E00016881,Total,104,2,102,34,20,2.2,3.9,2.1
E00016915,Total,143,0,143,77,34,2.0,3.0,1.6
E00016916,Total,142,4,138,48,29,2.5,3.7,2.0
E00016920,Total,126,4,122,41,24,2.6,4.1,2.1
E00173950,Total,117,0,117,31,10,2.2,3.8,2.0
E00173951,Total,139,2,137,37,19,2.3,3.9,1.9
E00016921,Total,131,2,129,33,13,2.3,4.0,2.2
E00016922,Total,144,3,141,42,14,2.2,4.5,2.5
E00016923,Total,156,2,154,35,13,2.4,4.5,2.4
E00016925,Total,199,9,190,48,15,2.2,4.9,2.9
E00016926,Total,133,0,133,34,28,2.5,4.5,2.4
E00016917,Total,179,3,176,76,37,2.7,4.6,2.5
E00016918,Total,156,7,149,42,24,2.4,4.4,2.4
E00016919,Total,141,5,136,37,19,2.3,4.6,2.5
E00016924,Total,186,2,184,38,18,2.3,4.7,2.4
E00016927,Total,135,2,133,34,8,2.2,4.4,2.3
E00016879,Total,165,6,159,34,20,2.7,5.3,2.9
E00016884,Total,130,4,126,30,13,2.7,5.7,3.0
E00016886,Total,151,13,138,45,20,2.3,4.7,2.5
E00016893,Total,135,7,128,25,16,2.7,5.1,2.8
E00016885,Total,137,3,134,23,8,2.0,4.6,2.3
E00016887,Total,102,2,100,13,5,2.1,5.2,2.7
E00016889,Total,116,2,114,28,16,2.5,4.4,2.3
E00016890,Total,137,10,127,59,39,2.2,3.5,1.6
E00016895,Total,134,7,127,21,10,2.1,4.8,2.3
E00016159,Total,120,1,119,11,9,2.1,4.9,2.5
E00016173,Total,133,0,133,18,14,2.3,4.7,2.5
E00016176,Total,135,5,130,10,3,2.3,4.8,2.7
E00016184,Total,131,2,129,18,9,1.9,4.1,2.0
E00016186,Total,143,5,138,24,14,2.2,4.5,2.3
E00016188,Total,139,2,137,26,11,2.0,4.2,2.2
E00016164,Total,110,1,109,19,13,2.9,5.0,2.7
E00016170,Total,150,3,147,38,16,2.2,4.1,2.3
E00016175,Total,149,4,145,19,15,2.1,4.1,2.1
E00016181,Total,140,7,133,40,22,2.4,4.4,2.3
E00016182,Total,131,3,128,7,4,2.6,6.3,3.4
E00016162,Total,129,4,125,9,6,2.0,4.9,2.4
E00016198,Total,105,3,102,21,9,2.4,4.4,2.3
E00016202,Total,100,0,100,36,25,3.0,4.3,2.5
E00016205,Total,129,5,124,3,1,2.0,5.1,2.5
E00016208,Total,140,4,136,17,6,2.1,4.2,2.2
E00016199,Total,119,1,118,29,22,2.6,4.6,2.4
E00016200,Total,84,0,84,42,21,2.4,3.5,1.8
E00016201,Total,56,2,54,27,18,2.9,4.3,2.3
E00016203,Total,129,3,126,39,19,2.3,3.9,2.0
E00016207,Total,114,0,114,33,16,3.2,4.9,2.9
E00016163,Total,129,6,123,35,12,2.6,4.8,2.6
E00016165,Total,119,2,117,8,5,2.2,5.5,2.6
E00016168,Total,86,3,83,12,9,2.1,4.8,2.2
E00016169,Total,116,1,115,7,5,2.5,6.6,3.4
E00016172,Total,127,11,116,42,15,2.0,3.6,1.8
E00016177,Total,121,7,114,11,5,2.1,4.8,2.4
E00016219,Total,146,3,143,35,12,1.8,3.8,1.9
E00016220,Total,136,13,123,37,11,1.9,3.6,1.8
E00016221,Total,146,7,139,30,18,2.1,3.9,2.0
E00016223,Total,107,5,102,19,10,2.1,4.4,2.2
E00016225,Total,117,6,111,34,11,2.3,4.0,2.1
E00016255,Total,101,2,99,20,12,2.2,4.1,2.1
E00016218,Total,113,3,110,28,13,2.2,3.9,1.9
E00016222,Total,160,2,158,47,22,2.3,4.2,2.2
E00016224,Total,156,4,152,24,14,2.1,4.3,2.2
E00016226,Total,120,2,118,24,17,2.6,5.0,2.6
E00016227,Total,139,5,134,32,16,2.1,4.2,2.1
E00016228,Total,125,1,124,11,7,2.3,5.3,2.8
E00016229,Total,182,7,175,51,28,2.3,4.5,2.3
E00016230,Total,134,2,132,31,16,2.6,4.7,2.6
E00016231,Total,145,5,140,38,23,2.2,4.1,2.2
E00016232,Total,130,5,125,38,28,2.4,4.0,2.0
E00016233,Total,154,3,151,52,37,2.4,3.8,1.9
E00016212,Total,120,3,117,20,23,2.7,5.1,2.7
E00016249,Total,118,3,115,32,16,2.1,4.1,2.0
E00016254,Total,107,7,100,15,13,3.0,5.5,3.0
E00173952,Total,108,3,105,25,13,2.2,4.4,2.3
E00174016,Total,98,3,95,20,16,2.5,4.8,2.5
E00174022,Total,91,5,86,28,7,2.4,4.3,2.2
E00174008,Total,130,19,111,75,8,1.7,2.7,1.5
E00174010,Total,120,19,101,95,16,1.7,2.1,1.3
E00174013,Total,126,15,111,87,14,1.8,2.6,1.4
E00174015,Total,107,15,92,51,5,1.7,2.9,1.6
E00174025,Total,127,13,114,76,15,1.7,2.6,1.4
E00174027,Total,96,14,82,58,4,1.6,2.6,1.3
E00016178,Total,121,0,121,25,15,2.2,4.0,2.0
E00016179,Total,128,3,125,20,15,2.2,4.6,2.5
E00016180,Total,132,5,127,16,7,2.0,4.7,2.4
E00016187,Total,130,3,127,12,5,2.3,5.6,2.8
E00016189,Total,128,3,125,1,1,2.4,5.7,3.1
E00016166,Total,101,1,100,33,2,1.8,4.2,2.1
E00016167,Total,120,1,119,6,4,2.5,6.2,3.0
E00016171,Total,153,13,140,52,16,1.9,3.7,1.8
E00016174,Total,121,4,117,6,1,2.0,5.0,2.4
E00016204,Total,140,1,139,14,8,1.9,4.2,2.1
E00016206,Total,121,2,119,23,6,2.2,4.6,2.4
E00016160,Total,131,0,131,4,2,2.3,5.7,2.9
E00016183,Total,119,3,116,8,5,2.2,4.8,2.4
E00016185,Total,114,6,108,6,3,2.1,5.2,2.7
E00016191,Total,122,4,118,5,3,2.0,5.4,2.7
E00016195,Total,128,5,123,10,4,2.0,4.8,2.4
E00016197,Total,150,23,127,24,11,1.8,4.2,2.0
E00016161,Total,166,10,156,31,16,2.0,4.1,2.0
E00016190,Total,156,8,148,57,11,1.5,3.2,1.5
E00016192,Total,173,10,163,58,16,1.8,3.4,1.8
E00016193,Total,154,17,137,64,15,1.6,3.2,1.5
E00016194,Total,152,3,149,55,15,1.6,3.2,1.5
E00016196,Total,179,2,177,41,18,2.1,4.0,2.1
E00016905,Total,114,7,107,26,12,2.6,4.4,2.4
E00016907,Total,115,0,115,18,15,2.7,5.1,2.9
E00016908,Total,123,1,122,26,12,1.8,3.9,1.8
E00016910,Total,128,1,127,47,29,2.5,4.0,2.3
E00016912,Total,97,0,97,35,19,2.3,3.7,1.9
E00016909,Total,146,1,145,39,28,2.8,4.2,2.1
E00016911,Total,171,3,168,49,33,2.6,4.2,2.2
E00016913,Total,158,3,155,39,25,2.9,4.4,2.4
E00016914,Total,125,0,125,51,25,2.7,4.0,2.1
E00016896,Total,140,2,138,36,16,2.1,4.0,2.0
E00016898,Total,113,3,110,25,12,2.5,4.5,2.3
E00016900,Total,144,7,137,20,13,2.3,4.5,2.4
E00016901,Total,85,6,79,16,12,2.4,4.4,2.2
E00016904,Total,107,2,105,36,15,2.4,3.8,2.0
E00016906,Total,113,4,109,28,14,2.3,4.2,2.2
E00016883,Total,142,1,141,31,9,2.5,4.7,2.7
E00016888,Total,129,1,128,19,14,2.5,5.0,2.7
E00016891,Total,171,5,166,39,25,2.3,4.2,2.2
E00016892,Total,126,3,123,25,13,2.4,4.5,2.4
E00016894,Total,151,6,145,28,22,2.3,4.8,2.5
E00016880,Total,115,2,113,20,11,3.0,5.0,2.7
E00016897,Total,180,5,175,52,23,2.2,4.0,1.9
E00016899,Total,159,5,154,34,15,1.9,3.7,1.9
E00016902,Total,137,5,132,20,8,2.3,4.5,2.3
E00016903,Total,128,9,119,29,21,2.7,4.8,2.6
E00016564,Total,133,5,128,22,11,2.6,5.0,2.6
E00016567,Total,82,3,79,34,26,2.6,3.9,2.1
E00016569,Total,128,5,123,16,15,2.5,4.9,2.5
E00016571,Total,115,4,111,7,11,2.7,5.8,3.1
E00173700,Total,103,0,103,46,45,3.8,5.6,3.7
E00173702,Total,105,5,100,45,43,4.0,6.1,3.8
E00016558,Total,126,2,124,35,13,1.9,3.8,1.9
E00016561,Total,121,0,121,25,18,2.2,4.3,2.1
E00016566,Total,113,1,112,20,12,2.5,4.9,2.7
E00016568,Total,144,9,135,16,10,2.2,5.2,2.6
E00016572,Total,147,4,143,49,27,2.2,4.7,2.4
E00016575,Total,127,1,126,27,20,2.2,4.1,2.0
E00016557,Total,95,3,92,16,10,2.1,4.3,2.2
E00016559,Total,137,4,133,27,20,2.4,4.7,2.4
E00016560,Total,146,5,141,47,34,2.3,4.2,2.1
E00016562,Total,147,0,147,27,13,2.4,5.0,2.5
E00016563,Total,126,2,124,24,16,2.4,4.7,2.4
E00016565,Total,154,4,150,39,24,2.4,4.5,2.4
E00016544,Total,149,8,141,31,16,2.1,4.6,2.3
E00016574,Total,128,5,123,15,10,2.5,5.2,2.8
E00016576,Total,125,4,121,18,9,2.5,5.4,2.7
E00016577,Total,144,1,143,15,11,2.6,5.5,2.9
E00016578,Total,108,4,104,15,10,2.5,5.6,2.9
E00016635,Total,175,6,169,51,21,2.2,4.1,2.1
E00016640,Total,142,1,141,31,15,1.9,3.9,2.0
E00016641,Total,147,7,140,49,42,2.8,4.4,2.2
E00016642,Total,183,6,177,76,29,2.2,3.7,1.9
E00016643,Total,147,0,147,34,22,2.1,3.9,1.9
E00016630,Total,152,6,146,36,18,2.1,4.3,2.2
E00016647,Total,151,2,149,58,36,2.5,4.2,2.3
E00016648,Total,136,6,130,57,29,2.4,4.0,2.1
E00016649,Total,138,5,133,36,24,2.3,3.8,1.9
E00016651,Total,148,2,146,34,14,2.3,4.2,2.1
E00016629,Total,159,0,159,39,23,2.5,4.4,2.3
E00016650,Total,122,3,119,29,18,2.1,4.5,2.1
E00016652,Total,129,5,124,27,17,2.2,4.0,2.0
E00016654,Total,133,1,132,50,27,2.0,3.3,1.5
E00016657,Total,139,3,136,29,22,2.0,3.8,1.8
E00016633,Total,109,7,102,40,21,2.3,4.0,2.3
E00016636,Total,133,21,112,45,20,1.8,3.2,1.3
E00016638,Total,84,3,81,26,18,2.0,3.5,1.6
E00016639,Total,200,5,195,44,26,2.4,4.1,2.1
E00016674,Total,122,4,118,17,12,2.2,4.8,2.6
E00174018,Total,234,2,232,175,22,1.6,2.4,1.3
E00174019,Total,84,3,81,33,14,2.0,3.8,1.9
E00174021,Total,55,4,51,14,10,2.1,3.4,1.5
E00016628,Total,149,11,138,38,15,2.3,4.3,2.2
E00016637,Total,194,3,191,42,25,2.4,4.4,2.3
E00174024,Total,114,12,102,45,16,2.2,4.2,2.1
E00174029,Total,112,10,102,37,23,2.1,3.7,1.8
E00174030,Total,110,2,108,33,15,2.1,3.8,1.8
E00016644,Total,208,8,200,67,35,2.4,3.7,1.9
E00016645,Total,170,7,163,30,14,2.3,4.5,2.2
E00016646,Total,173,5,168,51,19,2.4,4.2,2.2
E00016584,Total,233,4,229,71,45,2.7,4.5,2.4
E00016596,Total,126,2,124,15,14,2.6,5.1,2.6
E00016598,Total,228,10,218,35,21,2.1,4.6,2.3
E00016623,Total,173,0,173,50,26,2.1,3.7,1.8
E00174036,Total,97,3,94,18,12,2.1,4.4,2.3
E00174038,Total,190,7,183,74,45,2.2,3.6,1.8
E00016585,Total,134,4,130,35,9,2.0,4.1,2.0
E00016593,Total,244,7,237,76,10,2.1,4.8,2.8
E00016600,Total,144,4,140,8,5,2.8,5.7,3.1
E00016602,Total,133,4,129,7,5,2.6,5.2,2.7
E00016624,Total,129,15,114,34,9,2.0,4.1,2.2
E00016625,Total,139,6,133,7,2,2.3,5.1,2.6
E00016587,Total,184,9,175,27,17,2.4,4.8,2.5
E00016594,Total,157,2,155,24,11,2.2,4.4,2.3
E00016605,Total,181,5,176,35,21,2.2,4.5,2.2
E00016608,Total,91,4,87,4,4,2.3,5.0,2.5
E00016626,Total,135,2,133,11,6,2.6,5.4,2.8
E00016589,Total,133,5,128,11,9,2.2,5.1,2.6
E00016595,Total,127,2,125,36,22,2.0,3.6,1.7
E00016597,Total,133,2,131,17,9,1.8,3.6,1.6
E00016599,Total,139,4,135,37,20,2.1,4.1,2.0
E00016601,Total,139,0,139,27,21,2.5,4.2,2.2
E00016607,Total,115,2,113,31,6,1.7,3.7,1.9
E00016573,Total,130,0,130,16,10,2.5,5.2,2.7
E00016579,Total,134,3,131,46,27,2.5,4.2,2.3
E00016580,Total,168,8,160,29,13,2.3,4.6,2.4
E00016581,Total,186,8,178,50,33,2.6,4.5,2.4
E00016582,Total,180,10,170,29,21,2.4,4.9,2.6
E00016546,Total,141,5,136,29,20,2.3,4.4,2.3
E00016547,Total,164,2,162,35,20,2.7,4.9,2.5
E00016548,Total,137,0,137,13,9,2.5,5.4,2.8
E00016550,Total,158,5,153,40,24,2.1,3.9,2.0
E00016583,Total,121,5,116,30,11,2.3,4.5,2.3
E00016542,Total,135,0,135,31,21,2.7,4.5,2.5
E00016552,Total,142,1,141,40,23,2.3,3.9,2.0
E00016554,Total,123,6,117,15,11,2.5,5.0,2.7
E00016555,Total,114,0,114,25,13,2.5,5.2,2.6
E00016556,Total,126,2,124,25,15,2.8,5.0,2.6
E00016543,Total,168,6,162,43,21,2.1,4.0,1.9
E00016545,Total,128,2,126,33,22,2.7,4.4,2.3
E00016549,Total,134,4,130,9,12,2.9,5.7,3.1
E00016551,Total,140,4,136,7,8,3.1,6.2,3.3
E00016553,Total,130,3,127,9,9,2.8,5.7,2.8
E00016335,Total,91,3,88,6,4,2.3,5.2,2.7
E00016336,Total,136,1,135,8,11,2.6,5.2,2.8
E00016339,Total,117,1,116,7,4,2.7,5.6,3.0
E00016340,Total,131,5,126,6,6,2.5,5.4,2.6
E00016341,Total,115,3,112,4,2,2.6,5.6,3.1
E00016309,Total,146,9,137,38,14,2.1,4.7,2.5
E00016323,Total,114,5,109,22,11,2.4,4.8,2.5
E00016324,Total,161,4,157,35,23,2.7,4.6,2.5
E00016325,Total,142,7,135,38,14,2.1,4.1,2.2
E00016327,Total,124,4,120,21,12,2.4,4.7,2.6
E00016326,Total,124,3,121,20,14,2.5,4.9,2.6
E00016329,Total,144,1,143,21,13,2.7,5.0,2.8
E00016332,Total,148,6,142,13,9,2.6,5.4,3.1
E00016333,Total,111,3,108,8,9,2.5,5.1,2.7
E00016337,Total,122,2,120,7,4,2.8,5.8,3.2
E00016311,Total,126,7,119,6,7,2.5,5.3,2.7
E00016328,Total,126,5,121,8,5,2.1,5.1,2.4
E00016330,Total,117,5,112,24,13,2.2,4.4,2.3
E00016331,Total,137,2,135,17,15,2.8,5.3,2.8
E00016334,Total,163,5,158,13,10,3.0,5.5,2.9
E00016613,Total,150,5,145,9,6,2.6,6.1,3.3
E00016614,Total,128,1,127,12,12,3.1,5.4,3.2
E00016615,Total,122,6,116,15,12,2.5,5.2,2.7
E00016618,Total,116,2,114,29,19,2.3,4.1,2.1
E00016621,Total,135,2,133,29,12,1.8,3.7,1.8
E00016609,Total,104,4,100,5,5,2.8,5.6,3.0
E00016617,Total,137,1,136,8,8,2.5,5.5,2.9
E00016619,Total,136,1,135,14,7,2.3,5.2,2.7
E00016620,Total,117,4,113,8,4,2.8,5.7,3.1
E00016622,Total,107,3,104,23,14,2.4,4.4,2.2
E00016588,Total,164,4,160,22,14,2.3,4.7,2.5
E00016592,Total,185,4,181,18,4,2.0,4.7,2.4
E00016604,Total,106,5,101,8,6,2.0,4.7,2.4
E00016611,Total,105,6,99,16,12,1.9,4.1,2.0
E00016612,Total,90,1,89,5,2,2.3,5.7,3.1
E00016616,Total,117,2,115,26,11,2.2,4.1,2.3
E00016590,Total,171,4,167,13,13,2.2,4.8,2.4
E00016591,Total,130,3,127,19,7,2.5,5.9,3.0
E00016603,Total,198,5,193,26,13,2.4,5.7,2.9
E00016606,Total,165,4,161,7,3,2.4,5.5,2.9
E00016610,Total,133,5,128,11,9,2.4,5.1,2.6
E00016653,Total,127,2,125,15,13,2.3,4.9,2.6
E00016655,Total,143,3,140,49,25,2.2,3.8,2.1
E00016656,Total,154,9,145,31,18,2.2,4.5,2.1
E00016662,Total,117,3,114,5,5,2.3,5.1,2.6
E00016664,Total,161,6,155,20,14,2.2,4.5,2.3
E00016631,Total,140,1,139,26,15,2.4,4.6,2.4
E00016658,Total,107,6,101,46,19,2.1,3.7,1.9
E00016659,Total,121,3,118,21,9,2.0,3.8,1.8
E00016660,Total,159,4,155,29,23,2.2,4.1,2.0
E00016663,Total,149,3,146,45,29,2.5,4.2,2.2
E00016632,Total,133,4,129,28,25,2.4,4.5,2.1
E00016666,Total,127,6,121,20,13,2.2,5.1,2.6
E00016667,Total,159,8,151,46,22,2.6,4.6,2.5
E00016669,Total,113,6,107,39,24,2.5,3.9,2.0
E00016673,Total,121,5,116,42,31,2.7,4.3,2.2
E00016668,Total,117,7,110,22,14,2.1,4.3,2.2
E00016670,Total,111,3,108,14,11,2.5,5.1,2.7
E00016671,Total,75,10,65,20,4,2.1,4.6,2.2
E00016672,Total,141,4,137,37,27,2.6,4.8,2.4
E00173708,Total,83,3,80,18,10,1.8,3.6,1.8
E00173710,Total,118,1,117,24,10,2.4,4.3,2.3
E00016661,Total,121,6,115,26,16,2.2,4.3,2.2
E00173936,Total,113,1,112,51,20,2.3,3.6,1.9
E00173937,Total,110,4,106,74,11,1.8,2.6,1.3
E00173938,Total,149,12,137,50,22,2.0,3.5,1.7
E00174035,Total,101,12,89,55,22,2.1,3.0,1.8
E00016796,Total,157,3,154,51,22,2.5,4.1,2.2
E00016799,Total,138,2,136,33,24,2.8,4.8,2.5
E00016804,Total,216,8,208,60,28,2.0,3.7,1.8
E00016805,Total,138,4,134,26,22,2.6,4.9,2.5
E00016806,Total,103,0,103,15,15,2.5,4.7,2.3
E00016781,Total,110,4,106,18,16,2.4,4.6,2.4
E00016793,Total,113,1,112,25,21,2.4,4.3,2.1
E00016794,Total,113,4,109,34,16,2.0,3.6,1.8
E00016801,Total,107,4,103,22,13,2.2,4.5,2.4
E00016803,Total,101,1,100,22,13,2.5,4.6,2.3
E00016808,Total,106,6,100,26,21,2.3,4.2,2.0
E00016813,Total,144,10,134,29,14,2.1,4.4,2.2
E00016814,Total,129,3,126,30,20,2.4,4.7,2.5
E00016815,Total,109,1,108,22,17,2.6,4.8,2.4
E00016818,Total,130,3,127,27,13,2.4,4.8,2.5
E00016819,Total,112,8,104,20,15,2.4,5.0,2.6
E00016778,Total,140,9,131,33,17,2.6,4.4,2.3
E00016788,Total,117,7,110,14,10,2.4,4.9,2.5
E00016791,Total,125,8,117,38,28,2.6,4.6,2.5
E00016800,Total,112,6,106,28,16,2.2,4.1,2.1
E00016820,Total,106,3,103,33,19,2.2,4.1,2.1
E00016823,Total,122,7,115,33,18,2.2,4.0,2.0
E00016300,Total,148,5,143,45,27,2.2,4.1,2.1
E00016310,Total,91,4,87,4,4,2.7,6.0,3.1
E00016312,Total,140,4,136,25,19,2.6,5.0,2.6
E00016343,Total,137,2,135,5,2,2.6,5.9,3.1
E00016344,Total,193,14,179,48,31,2.3,4.4,2.4
E00016301,Total,162,6,156,15,12,2.4,5.2,2.7
E00016302,Total,120,4,116,19,15,2.3,4.8,2.4
E00016316,Total,119,1,118,10,6,2.7,5.8,3.0
E00016338,Total,169,9,160,27,14,2.2,4.6,2.3
E00016342,Total,108,6,102,13,7,2.7,5.2,2.8
E00016303,Total,162,3,159,16,11,2.3,5.0,2.7
E00016304,Total,156,7,149,14,11,2.2,5.1,2.4
E00016313,Total,106,4,102,5,3,2.1,4.8,2.2
E00016318,Total,127,8,119,5,3,2.3,5.3,2.8
E00016345,Total,122,3,119,14,10,2.2,4.8,2.3
E00016307,Total,166,7,159,32,16,2.0,4.0,2.0
E00016314,Total,129,0,129,30,14,2.3,4.5,2.4
E00016319,Total,120,1,119,13,12,1.9,4.1,2.0
E00016321,Total,159,3,156,65,31,2.1,3.6,1.9
E00016322,Total,168,2,166,40,17,2.2,4.2,2.1
E00016305,Total,116,1,115,24,16,2.4,4.6,2.4
E00016306,Total,170,1,169,33,18,2.0,4.2,2.0
E00016308,Total,145,7,138,37,18,2.2,4.2,2.1
E00016315,Total,194,3,191,49,34,2.2,4.3,2.2
E00016317,Total,119,3,116,19,12,2.4,4.9,2.5
E00016320,Total,122,3,119,19,14,2.3,4.7,2.4
E00016779,Total,88,9,79,23,17,3.3,4.9,2.7
E00016789,Total,144,2,142,14,10,2.6,5.6,3.0
E00016797,Total,144,2,142,16,13,2.7,5.6,2.9
E00016798,Total,152,3,149,47,28,2.8,4.3,2.3
E00016821,Total,160,4,156,41,21,2.5,4.5,2.4
E00016780,Total,156,3,153,62,28,2.1,3.4,1.6
E00016782,Total,174,6,168,58,26,2.2,4.2,2.1
E00016790,Total,91,9,82,42,22,1.8,3.2,1.4
E00016792,Total,170,18,152,102,47,2.1,3.0,1.5
E00016795,Total,114,3,111,25,13,2.4,4.5,2.4
E00016783,Total,154,3,151,27,16,2.2,4.6,2.2
E00016802,Total,161,6,155,25,17,2.4,4.6,2.3
E00016807,Total,194,4,190,38,32,2.3,4.2,2.1
E00016809,Total,157,7,150,35,19,2.1,4.1,2.0
E00016810,Total,144,2,142,34,27,2.9,4.8,2.5
E00016784,Total,123,2,121,24,17,2.2,4.6,2.3
E00016811,Total,134,7,127,37,24,2.4,4.5,2.3
E00016812,Total,117,2,115,17,11,2.6,4.9,2.6
E00016816,Total,104,4,100,16,10,2.1,4.7,2.4
E00016817,Total,115,3,112,15,10,2.7,5.0,2.6
E00016785,Total,110,8,102,30,11,1.8,3.8,1.8
E00016786,Total,98,1,97,15,14,2.5,4.7,2.5
E00016787,Total,274,29,245,126,44,1.7,3.0,1.3
E00016822,Total,129,5,124,32,20,2.3,4.4,2.1
E00016824,Total,102,6,96,19,15,2.5,5.2,2.5
E00016445,Total,128,8,120,5,4,2.2,4.8,2.4
E00016448,Total,124,2,122,4,4,2.7,6.2,3.4
E00016452,Total,118,5,113,6,4,2.6,6.2,3.2
E00016454,Total,119,2,117,10,4,2.2,5.0,2.6
E00016455,Total,113,6,107,8,7,2.1,4.8,2.5
E00016446,Total,167,3,164,40,16,2.0,4.0,1.9
E00016453,Total,120,9,111,20,9,1.9,3.9,1.9
E00016456,Total,128,7,121,20,12,2.2,4.6,2.3
E00016457,Total,135,7,128,30,7,1.9,3.7,1.8
E00016462,Total,149,4,145,29,6,1.8,4.3,2.2
E00173944,Total,131,15,116,50,18,1.9,3.6,1.9
E00173945,Total,134,5,129,58,12,1.9,3.1,1.6
E00016444,Total,111,1,110,18,8,2.8,5.8,3.1
E00016484,Total,136,1,135,16,7,2.7,6.2,3.3
E00016485,Total,117,4,113,28,17,2.1,3.9,2.0
E00016488,Total,113,1,112,12,9,2.9,5.9,3.3
E00016489,Total,204,1,203,68,57,2.8,4.6,2.5
E00016443,Total,129,6,123,14,6,2.7,5.9,3.1
E00016483,Total,110,4,106,23,13,2.2,4.6,2.3
E00016486,Total,137,2,135,12,10,2.8,5.6,3.1
E00016487,Total,123,7,116,15,9,2.3,4.7,2.3
E00016491,Total,120,4,116,14,5,2.1,4.5,2.3
E00016449,Total,127,7,120,26,13,2.1,4.4,2.2
E00016450,Total,122,6,116,23,10,2.0,4.2,1.9
E00016451,Total,129,2,127,14,10,2.5,5.1,2.6
E00016490,Total,131,5,126,19,8,2.1,4.6,2.4
E00016492,Total,115,5,110,26,12,2.2,4.4,2.3
E00016281,Total,135,9,126,10,7,2.5,5.4,2.8
E00016290,Total,122,9,113,6,3,2.6,5.3,3.0
E00016292,Total,107,3,104,15,13,2.9,5.2,2.7
E00016293,Total,123,1,122,15,13,2.9,5.9,2.9
E00016295,Total,135,7,128,13,11,2.6,5.5,2.9
E00016258,Total,132,4,128,6,7,2.8,6.1,3.1
E00016259,Total,130,5,125,10,11,2.4,5.3,2.7
E00016298,Total,139,0,139,12,14,3.1,5.8,3.2
E00016299,Total,138,5,133,11,14,2.9,5.7,3.1
E00016274,Total,116,7,109,14,6,2.5,5.1,2.6
E00016276,Total,150,7,143,30,17,2.3,4.8,2.4
E00016277,Total,124,6,118,30,16,2.6,5.2,2.7
E00016278,Total,104,1,103,14,13,2.6,5.4,2.8
E00016285,Total,110,1,109,26,10,2.4,5.0,2.6
E00016256,Total,121,4,117,20,17,2.6,5.7,2.9
E00016284,Total,114,5,109,15,9,2.5,5.4,2.7
E00016286,Total,136,6,130,17,13,2.8,5.9,3.0
E00016296,Total,120,5,115,23,16,2.8,5.5,3.0
E00016297,Total,138,2,136,19,17,2.3,5.1,2.5
E00016275,Total,159,6,153,52,36,2.5,4.3,2.3
E00016279,Total,112,2,110,9,7,2.8,5.6,3.0
E00016280,Total,102,2,100,9,5,2.7,5.7,3.1
E00016283,Total,135,8,127,10,9,2.6,5.2,2.8
E00016287,Total,118,4,114,12,10,2.7,5.2,2.9
E00016513,Total,131,5,126,25,10,2.5,4.6,2.5
E00016514,Total,125,6,119,25,10,1.8,4.0,2.0
E00016515,Total,129,3,126,14,9,2.3,5.3,2.7
E00016516,Total,111,2,109,19,18,2.7,4.7,2.4
E00016519,Total,112,1,111,13,7,2.1,4.8,2.4
E00016521,Total,131,1,130,15,8,1.9,4.0,1.9
E00016493,Total,161,4,157,52,31,2.3,3.9,1.9
E00016499,Total,119,4,115,14,11,2.4,5.2,2.6
E00016502,Total,107,1,106,15,8,2.6,4.7,2.5
E00016503,Total,109,6,103,24,8,1.6,3.4,1.5
E00016507,Total,103,5,98,5,8,2.4,5.1,2.6
E00016540,Total,119,5,114,8,7,2.6,5.4,3.0
E00016498,Total,227,5,222,39,26,2.5,5.1,2.6
E00016500,Total,127,1,126,14,11,2.3,4.5,2.4
E00016505,Total,156,1,155,37,25,2.1,4.0,2.0
E00016541,Total,137,2,135,2,2,2.6,6.0,3.2
E00016494,Total,156,6,150,30,16,2.1,4.3,2.0
E00016495,Total,109,5,104,12,7,1.9,4.0,1.9
E00016501,Total,149,1,148,7,6,2.8,6.1,3.1
E00016508,Total,139,8,131,10,9,2.5,5.6,2.9
E00016511,Total,125,2,123,6,2,2.7,5.6,3.1
E00016504,Total,115,1,114,5,6,2.8,6.9,3.5
E00016506,Total,133,0,133,9,8,2.7,5.4,3.0
E00016509,Total,158,0,158,10,7,2.5,5.9,3.1
E00016510,Total,107,4,103,2,3,2.5,5.6,3.1
E00016512,Total,124,2,122,6,5,2.7,5.8,3.0
E00016750,Total,116,1,115,25,14,2.4,4.7,2.3
E00016752,Total,130,8,122,9,8,2.7,5.9,3.1
E00016753,Total,108,7,101,25,11,2.5,4.4,2.4
E00016758,Total,141,2,139,42,19,2.2,4.0,2.2
E00016763,Total,132,2,130,12,9,2.4,4.9,2.6
E00016738,Total,172,5,167,45,24,2.4,4.4,2.2
E00016739,Total,119,2,117,15,9,2.6,5.2,2.7
E00016740,Total,140,1,139,29,21,2.5,4.9,2.6
E00016749,Total,127,4,123,26,12,2.4,4.8,2.5
E00016755,Total,176,7,169,50,26,2.4,4.4,2.2
E00016745,Total,160,1,159,28,30,2.5,4.7,2.4
E00016746,Total,148,9,139,19,21,2.4,4.9,2.4
E00016751,Total,127,4,123,36,22,2.4,4.7,2.5
E00016754,Total,131,2,129,13,12,2.2,4.8,2.5
E00016757,Total,117,7,110,14,7,2.2,5.1,2.5
E00016732,Total,165,7,158,47,26,2.1,3.9,2.0
E00016735,Total,152,4,148,23,15,2.4,4.6,2.4
E00016741,Total,132,8,124,17,7,2.0,4.5,2.2
E00016742,Total,150,4,146,36,17,2.1,3.9,2.0
E00016733,Total,130,3,127,13,8,2.4,5.2,2.7
E00016734,Total,118,4,114,16,19,2.4,4.7,2.3
E00016743,Total,117,5,112,9,8,2.5,5.2,2.8
E00016744,Total,130,2,128,14,11,2.6,5.6,2.8
E00016747,Total,114,4,110,23,15,2.2,4.3,2.0
E00016261,Total,119,2,117,25,22,3.1,5.6,2.9
E00016282,Total,145,3,142,45,14,2.3,4.7,2.5
E00016288,Total,179,4,175,49,22,2.4,4.4,2.3
E00016289,Total,125,5,120,31,14,2.7,5.3,2.7
E00016294,Total,121,3,118,26,10,2.9,6.0,3.2
E00016260,Total,139,5,134,5,13,2.5,5.7,2.9
E00016262,Total,110,4,106,18,11,2.4,4.8,2.4
E00016266,Total,132,4,128,15,15,2.7,5.6,2.8
E00016267,Total,102,4,98,14,9,2.7,5.6,3.0
E00016271,Total,148,1,147,18,9,2.7,5.5,2.9
E00016257,Total,147,3,144,33,12,3.1,5.8,3.2
E00016263,Total,99,2,97,19,8,2.4,5.7,2.9
E00016265,Total,186,4,182,42,23,2.4,4.7,2.5
E00016268,Total,170,8,162,50,20,2.7,5.0,2.8
E00016291,Total,167,12,155,52,25,2.0,4.2,2.2
E00016264,Total,115,0,115,9,6,2.6,6.2,3.4
E00016269,Total,125,4,121,12,14,2.8,5.9,3.0
E00016270,Total,100,1,99,9,5,3.0,6.3,3.4
E00016272,Total,131,4,127,15,8,2.7,5.4,2.9
E00016273,Total,132,3,129,16,9,3.1,6.2,3.3
E00016930,Total,216,8,208,36,22,2.7,5.2,2.8
E00016946,Total,149,7,142,16,12,2.7,5.1,2.8
E00016952,Total,119,4,115,27,12,2.3,4.0,2.1
E00016964,Total,114,5,109,21,15,2.4,4.3,2.3
E00016929,Total,111,0,111,21,12,2.5,4.4,2.4
E00016931,Total,103,2,101,22,18,2.8,4.5,2.4
E00016932,Total,110,1,109,20,12,2.6,4.5,2.4
E00016954,Total,93,1,92,20,15,2.9,4.4,2.3
E00016961,Total,124,7,117,23,18,2.4,4.5,2.5
E00016933,Total,168,10,158,28,23,2.8,5.0,2.8
E00016953,Total,130,10,120,15,8,1.9,3.9,1.9
E00016957,Total,110,5,105,15,14,2.7,4.6,2.4
E00016960,Total,107,3,104,23,14,2.3,4.0,2.0
E00016966,Total,77,3,74,12,8,2.6,4.7,2.6
E00016940,Total,101,7,94,16,11,2.9,5.0,2.7
E00016941,Total,134,4,130,20,16,2.8,5.5,3.1
E00016942,Total,118,1,117,22,18,2.3,4.6,2.4
E00016943,Total,123,1,122,42,20,1.9,3.2,1.4
E00016944,Total,118,4,114,16,9,2.7,5.2,2.9
E00016945,Total,107,7,100,15,9,1.9,3.5,1.6
E00016728,Total,113,6,107,38,12,2.2,3.9,2.2
E00016764,Total,110,3,107,16,10,2.5,5.2,2.9
E00016766,Total,139,2,137,58,13,2.5,4.1,2.5
E00016768,Total,143,2,141,29,18,1.9,3.7,1.7
E00016772,Total,140,3,137,19,6,2.4,5.2,2.7
E00016737,Total,113,2,111,20,7,2.2,4.9,2.4
E00016748,Total,132,4,128,29,15,1.9,3.9,1.9
E00016756,Total,115,1,114,20,15,2.4,4.3,2.3
E00016760,Total,145,2,143,32,22,2.0,3.8,2.0
E00173704,Total,112,7,105,35,10,2.1,3.8,2.0
E00173705,Total,66,2,64,25,7,2.1,3.8,2.1
E00173707,Total,73,2,71,44,9,1.6,2.8,1.4
E00016729,Total,107,3,104,6,4,2.3,6.3,3.2
E00016730,Total,131,10,121,12,10,2.5,5.4,2.8
E00016759,Total,130,5,125,13,8,2.5,5.5,2.8
E00016761,Total,121,4,117,4,2,2.7,5.9,3.0
E00016762,Total,116,3,113,23,15,2.7,4.9,2.8
E00016765,Total,109,3,106,37,16,2.0,4.2,2.2
E00016767,Total,130,8,122,27,15,2.1,4.8,2.3
E00016770,Total,95,7,88,43,6,1.5,3.0,1.4
E00016771,Total,167,1,166,24,13,2.3,5.0,2.5
E00016774,Total,132,6,126,14,7,2.7,5.5,3.0
E00016777,Total,146,3,143,22,14,2.6,5.6,2.9
E00016731,Total,135,6,129,37,9,2.3,4.2,2.4
E00016769,Total,153,12,141,46,16,2.4,4.1,2.2
E00016773,Total,122,3,119,36,16,2.3,4.0,2.0
E00016775,Total,111,6,105,28,18,2.3,4.0,2.1
E00016776,Total,149,7,142,25,9,2.2,4.5,2.3
E00016460,Total,135,7,128,16,6,2.5,5.1,2.8
E00016463,Total,230,9,221,111,50,2.2,3.4,1.8
E00016467,Total,137,3,134,17,7,2.3,5.1,2.7
E00016469,Total,141,9,132,26,16,2.2,4.2,2.2
E00016471,Total,101,0,101,43,30,2.3,3.7,1.8
E00016472,Total,187,3,184,73,23,1.9,3.3,1.7
E00016447,Total,135,6,129,24,14,2.2,4.2,2.2
E00016458,Total,146,9,137,29,18,2.2,4.4,2.2
E00016459,Total,98,3,95,2,1,2.3,5.3,2.9
E00016464,Total,119,5,114,36,23,2.5,4.1,2.2
E00016465,Total,121,1,120,44,2,1.8,3.6,1.9
E00016466,Total,116,2,114,5,5,2.3,5.8,3.0
E00016475,Total,86,3,83,26,18,2.5,4.2,2.3
E00016476,Total,108,2,106,25,18,2.7,4.6,2.5
E00016478,Total,83,2,81,5,3,2.0,4.4,2.3
E00016479,Total,96,1,95,31,17,2.6,4.1,2.2
E00016480,Total,114,1,113,47,21,2.6,3.8,2.0
E00016482,Total,107,2,105,23,13,2.4,4.1,2.3
E00016468,Total,94,5,89,5,4,2.3,5.1,2.7
E00016470,Total,104,3,101,11,5,2.3,4.7,2.4
E00016473,Total,126,2,124,14,10,2.4,5.2,2.8
E00016474,Total,128,9,119,25,9,2.0,4.6,2.0
E00016477,Total,134,3,131,26,11,2.2,4.3,2.1
E00016481,Total,170,4,166,59,14,1.8,3.5,1.9
E00016126,Total,126,3,123,6,6,2.5,5.6,3.1
E00016127,Total,142,3,139,10,11,2.9,5.6,3.1
E00016131,Total,137,2,135,27,17,2.3,4.6,2.3
E00016134,Total,138,0,138,37,14,1.9,3.8,1.9
E00016140,Total,123,6,117,36,21,2.1,3.9,2.0
E00016118,Total,144,2,142,19,9,2.7,5.5,2.9
E00016154,Total,153,2,151,37,14,1.8,3.6,1.7
E00016155,Total,153,2,151,47,31,2.5,4.3,2.2
E00016156,Total,141,4,137,27,19,2.1,4.0,1.9
E00016157,Total,125,3,122,24,17,2.8,4.6,2.5
E00016112,Total,142,2,140,28,16,2.2,4.2,2.2
E00016119,Total,122,2,120,9,5,2.7,5.6,3.0
E00016121,Total,126,3,123,21,14,2.1,4.2,2.0
E00016123,Total,122,8,114,14,10,2.7,5.2,2.8
E00016158,Total,125,7,118,8,11,2.5,5.2,2.6
E00016113,Total,162,6,156,28,24,2.4,4.4,2.1
E00016120,Total,110,4,106,21,17,2.9,4.7,2.6
E00016122,Total,120,3,117,21,19,2.8,5.0,2.7
E00016124,Total,112,3,109,15,10,2.6,4.7,2.6
E00016125,Total,120,8,112,15,12,2.7,4.7,2.5
E00016114,Total,106,3,103,18,13,2.5,4.8,2.6
E00016128,Total,133,3,130,22,19,2.7,4.8,2.7
E00016130,Total,132,4,128,25,16,2.5,4.6,2.4
E00016133,Total,119,2,117,24,19,2.8,4.9,2.7
E00016135,Total,135,0,135,27,19,2.4,4.2,2.1
E00016948,Total,146,1,145,42,23,2.8,4.3,2.4
E00016949,Total,130,1,129,27,10,2.8,4.3,2.5
E00016951,Total,126,2,124,31,14,2.8,4.3,2.4
E00016955,Total,128,0,128,26,17,2.6,4.3,2.3
E00016956,Total,108,1,107,25,19,2.6,4.6,2.2
E00016950,Total,110,2,108,15,6,2.7,5.5,3.1
E00016967,Total,115,3,112,14,9,2.7,5.4,2.9
E00016968,Total,118,1,117,11,6,2.5,5.4,2.9
E00016969,Total,115,2,113,12,9,2.3,4.8,2.4
E00016971,Total,113,1,112,20,13,2.5,4.7,2.7
E00016928,Total,132,2,130,26,18,3.2,5.1,2.9
E00016947,Total,141,3,138,21,18,2.2,4.1,2.0
E00016958,Total,122,5,117,24,13,3.0,4.9,2.8
E00016963,Total,124,2,122,16,12,2.6,5.2,2.8
E00016937,Total,151,0,151,10,10,2.7,5.6,2.9
E00016959,Total,108,1,107,6,6,2.7,5.7,3.1
E00016962,Total,190,4,186,61,23,2.2,4.1,2.2
E00016965,Total,142,2,140,48,16,2.2,3.6,2.0
E00016970,Total,144,3,141,25,20,2.6,4.7,2.5
E00016934,Total,126,3,123,15,14,2.9,5.2,2.8
E00016935,Total,157,10,147,17,11,2.6,5.3,2.9
E00016936,Total,125,2,123,10,7,2.9,5.4,3.1
E00016938,Total,102,2,100,7,11,3.1,5.8,3.0
E00016939,Total,122,5,117,16,9,2.5,5.2,2.7
E00016496,Total,121,1,120,19,11,2.2,4.1,2.0
E00016517,Total,97,2,95,18,13,2.5,4.9,2.5
E00016518,Total,133,2,131,18,9,2.2,4.5,2.2
E00016523,Total,120,2,118,30,9,2.0,4.2,2.0
E00016524,Total,131,2,129,22,11,2.5,5.2,2.7
E00016525,Total,126,1,125,16,7,2.0,4.7,2.3
E00016497,Total,120,8,112,22,14,2.3,4.2,2.3
E00016527,Total,103,5,98,26,14,2.4,4.1,2.1
E00016528,Total,113,7,106,18,14,1.9,3.9,1.8
E00016531,Total,127,4,123,20,15,2.6,5.2,2.9
E00016532,Total,105,0,105,26,15,2.1,3.9,1.9
E00016535,Total,112,1,111,21,17,2.2,4.0,2.1
E00016520,Total,124,5,119,20,11,2.1,4.3,2.2
E00016522,Total,146,6,140,32,15,1.9,3.7,1.7
E00016526,Total,141,4,137,29,11,2.1,3.9,1.9
E00016529,Total,115,1,114,14,13,2.3,4.4,2.4
E00016530,Total,118,0,118,18,16,2.6,4.5,2.3
E00016533,Total,113,2,111,10,11,2.9,5.2,2.9
E00016534,Total,110,2,108,6,5,2.7,5.7,3.1
E00016536,Total,115,2,113,15,5,2.7,5.2,3.0
E00016537,Total,106,4,102,11,9,2.7,5.1,2.8
E00016538,Total,121,1,120,20,14,2.8,4.9,2.8
E00016539,Total,146,1,145,24,12,2.2,4.2,2.2
E00016830,Total,139,6,133,14,5,2.5,5.3,2.9
E00016839,Total,117,1,116,14,8,2.1,4.6,2.3
E00016845,Total,136,3,133,20,8,2.3,4.5,2.5
E00016872,Total,140,5,135,20,9,2.6,5.0,2.8
E00016873,Total,134,1,133,25,22,2.3,4.3,2.1
E00016838,Total,129,4,125,40,25,2.2,3.8,1.8
E00016840,Total,126,5,121,13,10,2.7,5.7,3.2
E00016847,Total,105,3,102,27,19,2.5,3.9,2.0
E00016852,Total,87,3,84,9,3,2.5,5.2,2.7
E00016858,Total,99,0,99,24,13,2.5,4.2,2.2
E00016874,Total,116,3,113,39,7,1.8,3.5,1.7
E00016826,Total,116,1,115,25,14,2.3,4.5,2.4
E00016831,Total,112,3,109,27,11,2.4,4.4,2.4
E00016832,Total,125,1,124,29,9,2.0,4.3,2.1
E00016833,Total,121,0,121,7,5,2.8,6.4,3.5
E00016875,Total,98,0,98,21,19,2.6,4.8,2.6
E00016828,Total,114,1,113,14,6,2.2,4.5,2.2
E00016850,Total,92,0,92,11,9,2.3,4.4,2.2
E00016854,Total,120,1,119,12,7,2.3,4.6,2.5
E00016855,Total,111,6,105,18,11,1.9,3.8,1.8
E00016857,Total,126,0,126,30,14,2.1,4.0,2.0
E00016878,Total,116,1,115,38,13,2.3,4.0,2.2
E00016827,Total,134,3,131,35,16,2.1,4.1,2.1
E00016834,Total,139,1,138,21,13,2.3,4.5,2.3
E00016842,Total,100,2,98,33,12,2.7,4.5,2.5
E00016856,Total,188,17,171,65,27,1.8,3.3,1.6
E00016876,Total,106,1,105,16,8,1.8,3.9,1.9
E00016877,Total,111,6,105,28,16,1.8,3.6,1.7
E00016115,Total,125,3,122,21,12,2.4,4.5,2.2
E00016136,Total,119,4,115,23,10,2.7,4.6,2.6
E00016137,Total,129,2,127,17,18,3.0,5.0,2.8
E00016138,Total,122,3,119,40,29,2.7,4.0,2.1
E00016139,Total,129,3,126,23,22,2.5,4.6,2.3
E00016116,Total,134,5,129,15,9,2.4,5.0,2.6
E00016129,Total,141,4,137,39,18,2.1,3.8,2.0
E00016142,Total,140,1,139,36,25,2.5,4.0,2.2
E00016144,Total,119,2,117,21,18,2.1,4.0,1.9
E00016145,Total,137,1,136,39,38,2.5,3.9,1.8
E00016150,Total,138,1,137,33,27,2.4,3.8,1.8
E00016117,Total,147,9,138,28,21,2.3,4.2,2.1
E00016132,Total,127,3,124,24,11,2.1,4.0,2.1
E00016143,Total,113,2,111,11,7,2.6,5.0,2.8
E00016147,Total,153,5,148,36,28,2.2,3.9,1.9
E00016153,Total,125,3,122,21,10,2.1,4.1,2.1
E00016141,Total,118,2,116,27,13,2.4,4.4,2.3
E00016146,Total,127,5,122,25,14,2.1,4.2,2.2
E00016148,Total,127,4,123,27,15,2.4,4.1,2.2
E00016149,Total,132,0,132,28,22,2.1,3.7,1.7
E00016151,Total,112,1,111,19,16,2.4,4.3,2.2
E00016152,Total,125,0,125,36,23,2.0,3.5,1.6
E00016843,Total,106,7,99,15,12,2.3,4.6,2.4
E00016863,Total,146,3,143,29,12,2.1,4.2,2.2
E00016868,Total,128,2,126,18,12,1.9,4.0,1.9
E00016870,Total,139,6,133,14,13,2.4,4.9,2.5
E00016871,Total,119,6,113,10,9,2.2,4.8,2.5
E00016848,Total,98,2,96,9,7,2.6,6.3,3.2
E00016859,Total,146,2,144,19,12,2.6,5.6,2.9
E00016861,Total,181,5,176,35,22,2.6,4.5,2.3
E00016862,Total,141,9,132,25,14,2.3,4.7,2.5
E00016866,Total,148,5,143,28,22,2.5,4.8,2.5
E00016829,Total,135,3,132,42,18,1.9,3.5,1.7
E00016851,Total,134,3,131,8,4,2.3,5.6,3.0
E00016860,Total,155,2,153,39,19,2.2,3.9,2.1
E00016864,Total,154,6,148,26,12,2.1,4.0,2.0
E00016867,Total,132,2,130,14,5,1.9,4.3,2.1
E00016869,Total,123,3,120,37,13,1.8,3.5,1.6
E00016835,Total,151,5,146,27,15,2.2,4.6,2.1
E00016837,Total,125,3,122,16,16,2.2,4.4,2.2
E00016846,Total,140,7,133,20,12,2.3,4.4,2.2
E00016849,Total,102,14,88,45,24,2.3,3.4,1.8
E00016865,Total,139,5,134,21,14,2.7,5.1,2.7
E00016825,Total,113,1,112,27,21,2.4,4.2,2.2
E00016836,Total,124,0,124,14,7,2.5,6.2,3.5
E00016841,Total,130,0,130,25,16,2.6,4.6,2.4
E00016844,Total,111,3,108,6,6,2.4,5.5,2.8
E00016853,Total,116,3,113,36,14,1.8,3.9,1.9
E00016350,Total,133,7,126,17,13,2.7,4.5,2.4
E00016369,Total,132,5,127,20,15,2.5,4.5,2.3
E00016370,Total,144,7,137,22,10,2.3,4.4,2.2
E00016371,Total,119,5,114,24,19,2.4,4.4,2.2
E00016374,Total,120,4,116,21,17,2.4,4.3,2.2
E00016352,Total,110,0,110,21,16,2.6,4.5,2.4
E00016373,Total,123,3,120,20,12,2.4,4.8,2.6
E00016378,Total,125,3,122,28,17,2.4,4.3,2.2
E00016381,Total,143,5,138,28,17,2.4,4.3,2.3
E00016382,Total,107,5,102,12,11,2.3,4.8,2.4
E00016348,Total,91,2,89,15,13,2.6,4.5,2.2
E00016372,Total,118,3,115,23,16,2.6,4.5,2.3
E00016375,Total,105,2,103,15,11,2.5,4.4,2.2
E00016377,Total,120,2,118,22,11,2.4,4.4,2.3
E00016379,Total,131,4,127,19,10,2.4,4.4,2.3
E00016349,Total,125,6,119,20,23,2.4,4.4,2.3
E00016351,Total,196,10,186,47,37,2.6,4.3,2.3
E00016376,Total,111,6,105,22,15,2.5,4.6,2.4
E00016383,Total,132,5,127,21,15,2.6,4.6,2.4
E00016356,Total,136,1,135,23,16,2.8,4.5,2.4
E00016387,Total,146,5,141,25,16,2.4,4.5,2.4
E00016393,Total,118,2,116,19,13,2.6,4.6,2.4
E00165790,Total,108,2,106,19,19,2.4,4.4,2.2
E00016361,Total,104,3,101,9,6,2.1,4.7,2.3
E00016363,Total,139,6,133,17,12,2.3,4.7,2.5
E00016366,Total,99,1,98,8,5,2.8,6.2,3.2
E00016367,Total,81,0,81,6,3,2.0,4.8,2.4
E00016368,Total,100,0,100,4,2,2.9,6.1,3.4
E00016353,Total,117,3,114,19,18,2.7,4.6,2.3
E00016360,Total,194,4,190,51,20,2.2,4.0,2.2
E00016380,Total,100,1,99,21,14,2.4,4.4,2.4
E00016389,Total,110,4,106,17,15,2.7,4.6,2.4
E00016390,Total,85,4,81,13,10,2.7,5.0,2.7
E00016392,Total,119,1,118,14,11,2.3,4.2,2.0
E00016359,Total,120,1,119,14,11,2.6,5.0,2.6
E00016384,Total,121,4,117,18,13,2.7,5.4,2.9
E00016385,Total,177,1,176,34,23,2.1,4.4,2.0
E00016386,Total,145,2,143,47,12,1.5,3.1,1.3
E00016388,Total,132,5,127,16,8,2.4,5.2,2.8
E00016346,Total,106,5,101,20,11,2.4,4.6,2.4
E00016354,Total,104,9,95,36,11,2.1,3.8,2.0
E00016357,Total,131,6,125,39,17,2.4,4.2,2.4
E00016358,Total,122,7,115,27,17,2.1,4.1,2.1
E00016391,Total,118,4,114,9,5,2.6,5.6,3.0
E00016362,Total,131,5,126,21,15,2.5,4.8,2.5
E00016364,Total,126,5,121,22,19,2.2,4.3,2.2
E00016365,Total,109,2,107,13,8,2.0,4.1,2.0
E00016394,Total,120,1,119,16,10,2.5,5.0,2.9
E00165789,Total,158,4,154,43,16,1.8,3.3,1.6
E00016678,Total,105,2,103,32,24,2.6,4.1,2.1
E00016722,Total,150,1,149,42,37,2.7,4.0,2.0
E00016724,Total,110,15,95,44,25,2.6,4.1,2.3
E00016727,Total,110,1,109,28,17,3.0,4.7,2.8
E00016676,Total,96,1,95,23,12,2.7,4.8,2.6
E00016685,Total,127,4,123,51,23,2.5,3.9,2.2
E00016690,Total,128,2,126,28,19,2.3,4.0,2.1
E00016691,Total,108,0,108,24,18,2.7,4.4,2.4
E00016726,Total,102,0,102,33,22,1.8,3.3,1.5
E00016688,Total,107,0,107,19,16,2.8,4.8,3.0
E00016695,Total,108,3,105,30,14,2.8,4.6,2.6
E00016705,Total,124,8,116,63,15,2.0,3.2,1.7
E00016710,Total,124,2,122,49,28,2.4,3.8,2.1
E00016712,Total,97,1,96,44,21,2.3,3.8,2.2
E00016682,Total,129,35,94,58,16,1.9,3.1,1.6
E00016686,Total,133,1,132,42,29,2.6,4.4,2.5
E00016699,Total,126,7,119,47,24,2.4,3.6,1.9
E00016702,Total,186,9,177,98,18,1.6,3.6,2.1
E00016707,Total,183,18,165,71,33,2.4,3.8,2.0
E00016711,Total,146,20,126,61,23,1.8,3.3,1.6
E00016696,Total,104,1,103,35,19,2.3,3.8,2.1
E00016698,Total,160,4,156,47,31,2.0,3.6,1.8
E00016703,Total,112,2,110,38,15,2.4,3.9,2.1
E00016713,Total,223,4,219,108,34,1.8,3.0,1.4
E00165804,Total,112,2,110,27,12,2.0,3.9,2.0
