OA11CD,Rural Urban,All categories: Tenure,Owned: Total,Owned: Owned outright,Owned: Owned with a mortgage or loan,Shared ownership (part owned and part rented),Social rented: Total,Social rented: Rented from council (Local Authority),Social rented: Other social rented,Private rented: Total,Private rented: Private landlord or letting agency,Private rented: Employer of a household member,Private rented: Relative or friend of household member,Private rented: Other,Living rent free
E00016403,Total,142,8,5,3,0,124,116,8,10,10,0,0,0,0
E00016437,Total,159,20,4,16,0,127,121,6,11,11,0,0,0,1
E00016439,Total,178,8,1,7,0,127,100,27,42,41,0,0,1,1
E00016442,Total,139,14,7,7,1,110,103,7,14,12,0,0,2,0
E00016399,Total,141,9,1,8,0,123,12,111,4,3,0,0,1,5
E00016401,Total,154,21,4,17,30,90,15,75,11,10,0,0,1,2
E00016406,Total,119,5,2,3,2,99,9,90,12,11,0,0,1,1
E00016435,Total,170,13,4,9,26,113,45,68,17,17,0,0,0,1
E00016395,Total,115,20,11,9,1,59,15,44,34,32,0,1,1,1
E00016404,Total,120,37,11,26,1,33,14,19,47,44,1,2,0,2
E00016405,Total,138,45,12,33,0,28,9,19,63,61,0,2,0,2
E00016408,Total,68,28,6,22,0,2,1,1,37,37,0,0,0,1
E00016410,Total,112,52,20,32,0,16,15,1,42,41,0,1,0,2
E00016438,Total,132,45,11,34,1,7,7,0,78,77,0,1,0,1
E00016398,Total,111,18,8,10,6,67,22,45,19,17,0,2,0,1
E00016431,Total,110,19,6,13,6,58,52,6,23,22,0,1,0,4
E00016432,Total,160,30,5,25,21,70,36,34,38,36,0,2,0,1
E00016434,Total,167,17,7,10,14,122,32,90,11,10,0,1,0,3
E00173943,Total,164,20,5,15,39,83,8,75,18,17,0,0,1,4
E00173946,Total,185,46,6,40,1,21,5,16,117,115,0,0,2,0
E00016397,Total,210,66,14,52,2,50,15,35,92,88,0,2,2,0
E00016433,Total,140,28,11,17,1,84,78,6,26,26,0,0,0,1
E00016436,Total,101,24,2,22,0,58,56,2,16,16,0,0,0,3
E00016440,Total,108,14,6,8,0,82,76,6,10,10,0,0,0,2
E00016441,Total,204,23,5,18,16,128,100,28,35,31,0,3,1,2
E00016412,Total,151,34,7,27,1,64,63,1,51,49,0,2,0,1
E00016414,Total,144,35,6,29,0,82,78,4,25,25,0,0,0,2
E00016418,Total,153,34,3,31,0,75,9,66,41,37,0,2,2,3
E00016422,Total,111,11,2,9,0,92,60,32,8,8,0,0,0,0
E00016402,Total,128,22,6,16,1,88,84,4,16,13,3,0,0,1
E00016407,Total,146,41,10,31,1,35,5,30,69,68,0,1,0,0
E00016409,Total,146,8,2,6,23,95,37,58,16,14,0,2,0,4
E00016411,Total,172,38,9,29,14,64,12,52,56,55,0,1,0,0
E00016413,Total,126,24,8,16,1,79,72,7,18,18,0,0,0,4
E00016415,Total,140,16,7,9,5,94,81,13,23,22,0,1,0,2
E00016416,Total,104,10,3,7,1,78,64,14,15,14,0,0,1,0
E00016419,Total,118,12,1,11,0,87,85,2,17,16,0,1,0,2
E00016420,Total,121,12,3,9,0,92,85,7,13,12,0,1,0,4
E00173947,Total,123,4,2,2,0,92,83,9,24,22,0,0,2,3
E00173948,Total,171,8,1,7,16,104,22,82,41,41,0,0,0,2
E00016417,Total,138,27,10,17,1,104,68,36,5,5,0,0,0,1
E00016421,Total,125,7,1,6,0,112,95,17,6,6,0,0,0,0
E00016423,Total,122,24,9,15,1,82,76,6,14,14,0,0,0,1
E00016424,Total,123,11,5,6,0,109,108,1,3,3,0,0,0,0
E00016427,Total,105,8,3,5,0,86,84,2,11,10,0,1,0,0
E00016396,Total,134,16,2,14,0,99,68,31,18,16,0,1,1,1
E00016426,Total,134,20,4,16,0,93,81,12,19,17,0,2,0,2
E00016428,Total,157,29,11,18,0,31,19,12,95,93,0,1,1,2
E00016429,Total,124,48,18,30,1,47,31,16,26,22,0,3,1,2
E00016430,Total,120,19,8,11,8,78,76,2,13,13,0,0,0,2
E00016680,Total,122,36,4,32,0,3,3,0,83,83,0,0,0,0
E00016716,Total,159,34,5,29,0,22,6,16,101,98,2,1,0,2
E00016717,Total,102,35,5,30,0,6,4,2,59,59,0,0,0,2
E00016719,Total,117,31,8,23,0,74,71,3,11,10,0,1,0,1
E00016720,Total,148,37,6,31,0,12,7,5,99,98,0,1,0,0
E00016725,Total,119,43,6,37,0,7,3,4,69,68,0,1,0,0
E00016706,Total,103,17,4,13,1,44,38,6,40,37,0,1,2,1
E00016708,Total,130,41,11,30,0,66,49,17,21,19,0,2,0,2
E00016709,Total,137,43,10,33,3,53,43,10,37,33,2,2,0,1
E00016714,Total,114,28,6,22,0,40,27,13,46,43,0,3,0,0
E00016715,Total,125,41,10,31,3,43,28,15,38,38,0,0,0,0
E00016675,Total,116,33,6,27,0,13,5,8,69,69,0,0,0,1
E00016677,Total,131,39,9,30,7,37,8,29,48,48,0,0,0,0
E00016683,Total,138,65,8,57,0,5,4,1,68,66,0,2,0,0
E00016697,Total,121,26,8,18,2,71,38,33,21,21,0,0,0,1
E00173940,Total,113,40,7,33,0,44,31,13,29,28,0,1,0,0
E00173949,Total,148,54,8,46,20,4,2,2,70,65,0,5,0,0
E00016684,Total,107,46,8,38,7,14,4,10,40,36,0,4,0,0
E00016687,Total,108,56,11,45,0,6,2,4,46,44,0,2,0,0
E00016694,Total,135,34,12,22,17,59,14,45,22,21,0,0,1,3
E00016718,Total,128,21,6,15,0,96,89,7,10,10,0,0,0,1
E00016721,Total,109,15,1,14,1,79,75,4,13,11,0,1,1,1
E00016723,Total,123,31,13,18,0,79,75,4,13,12,0,1,0,0
E00016679,Total,91,33,16,17,0,50,22,28,8,6,0,2,0,0
E00016689,Total,115,49,14,35,1,41,37,4,24,20,0,3,1,0
E00016693,Total,125,23,10,13,0,71,58,13,28,26,0,2,0,3
E00016701,Total,88,32,11,21,4,33,22,11,17,16,0,1,0,2
E00173939,Total,94,4,4,0,6,72,68,4,10,9,1,0,0,2
E00016210,Total,142,12,3,9,0,82,11,71,45,44,0,1,0,3
E00016239,Total,148,8,3,5,1,42,5,37,96,94,1,0,1,1
E00016240,Total,85,3,0,3,0,75,12,63,7,7,0,0,0,0
E00016241,Total,143,26,11,15,1,99,94,5,17,17,0,0,0,0
E00016245,Total,97,19,7,12,1,67,58,9,10,10,0,0,0,0
E00016211,Total,113,29,9,20,0,66,53,13,17,15,0,1,1,1
E00016213,Total,170,40,6,34,0,93,81,12,36,32,0,4,0,1
E00016244,Total,128,48,14,34,13,30,19,11,33,33,0,0,0,4
E00016250,Total,141,21,6,15,0,94,60,34,24,24,0,0,0,2
E00174011,Total,53,6,1,5,17,14,10,4,16,16,0,0,0,0
E00174032,Total,132,29,10,19,1,38,9,29,62,59,0,3,0,2
E00174033,Total,41,14,5,9,1,13,11,2,13,13,0,0,0,0
E00016216,Total,171,63,21,42,0,28,0,28,78,75,0,3,0,2
E00016236,Total,204,56,14,42,2,23,4,19,117,112,3,2,0,6
E00016246,Total,137,47,13,34,2,59,47,12,27,25,0,2,0,2
E00016248,Total,174,43,13,30,0,38,8,30,93,92,0,0,1,0
E00016252,Total,164,59,18,41,0,62,17,45,42,40,0,1,1,1
E00016214,Total,162,83,39,44,5,27,15,12,46,45,0,1,0,1
E00016215,Total,135,57,20,37,2,38,28,10,37,31,0,5,1,1
E00016217,Total,186,60,18,42,1,60,9,51,62,56,0,6,0,3
E00016237,Total,112,77,40,37,1,4,2,2,29,26,0,3,0,1
E00016247,Total,140,55,16,39,1,42,21,21,42,41,0,1,0,0
E00016253,Total,132,62,21,41,1,29,11,18,40,36,0,4,0,0
E00016209,Total,158,43,18,25,2,65,19,46,46,42,0,2,2,2
E00016235,Total,145,27,11,16,0,37,13,24,81,80,0,1,0,0
E00016238,Total,181,53,24,29,1,39,16,23,87,82,0,3,2,1
E00173941,Total,105,18,10,8,0,24,8,16,58,55,0,0,3,5
E00173942,Total,77,11,8,3,0,17,10,7,49,47,0,1,1,0
E00016881,Total,104,24,9,15,0,59,50,9,19,18,0,1,0,2
E00016915,Total,143,11,1,10,0,67,41,26,60,57,0,1,2,5
E00016916,Total,142,20,4,16,0,103,77,26,18,15,0,0,3,1
E00016920,Total,126,18,5,13,0,85,74,11,22,22,0,0,0,1
E00173950,Total,117,14,3,11,17,49,7,42,36,31,0,2,3,1
E00173951,Total,139,3,0,3,10,122,12,110,3,3,0,0,0,1
E00016921,Total,131,27,6,21,3,79,75,4,21,20,0,1,0,1
E00016922,Total,144,38,14,24,0,67,46,21,38,38,0,0,0,1
E00016923,Total,156,55,20,35,1,40,33,7,55,54,0,1,0,5
E00016925,Total,199,65,25,40,3,28,9,19,99,97,0,2,0,4
E00016926,Total,133,29,9,20,0,78,55,23,23,23,0,0,0,3
E00016917,Total,179,50,14,36,1,18,9,9,109,107,0,1,1,1
E00016918,Total,156,36,9,27,0,13,7,6,104,102,0,2,0,3
E00016919,Total,141,58,25,33,0,36,21,15,47,47,0,0,0,0
E00016924,Total,186,66,23,43,1,37,10,27,79,77,0,1,1,3
E00016927,Total,135,65,15,50,0,24,14,10,45,44,0,1,0,1
E00016879,Total,165,94,44,50,1,33,15,18,35,32,0,3,0,2
E00016884,Total,130,69,32,37,0,23,5,18,38,36,0,2,0,0
E00016886,Total,151,58,20,38,2,36,19,17,54,53,0,0,1,1
E00016893,Total,135,54,27,27,0,43,7,36,38,35,0,3,0,0
E00016885,Total,137,66,31,35,0,29,15,14,39,35,2,2,0,3
E00016887,Total,102,62,28,34,0,18,7,11,21,21,0,0,0,1
E00016889,Total,116,53,19,34,0,35,26,9,25,24,0,1,0,3
E00016890,Total,137,36,7,29,1,68,68,0,31,30,0,1,0,1
E00016895,Total,134,57,21,36,0,25,1,24,51,48,0,1,2,1
E00016159,Total,120,63,27,36,0,24,19,5,32,32,0,0,0,1
E00016173,Total,133,63,21,42,2,41,39,2,25,24,0,1,0,2
E00016176,Total,135,94,26,68,0,6,5,1,33,32,0,1,0,2
E00016184,Total,131,65,28,37,0,5,3,2,59,52,2,5,0,2
E00016186,Total,143,64,28,36,0,22,19,3,54,52,0,2,0,3
E00016188,Total,139,64,27,37,0,32,8,24,43,41,0,2,0,0
E00016164,Total,110,33,14,19,0,66,60,6,11,9,1,0,1,0
E00016170,Total,150,47,14,33,0,67,52,15,36,34,1,1,0,0
E00016175,Total,149,44,12,32,1,74,25,49,30,29,0,1,0,0
E00016181,Total,140,20,6,14,3,96,10,86,20,20,0,0,0,1
E00016182,Total,131,91,36,55,1,13,6,7,23,22,0,1,0,3
E00016162,Total,129,64,22,42,0,28,27,1,37,36,0,1,0,0
E00016198,Total,105,37,9,28,0,37,32,5,28,26,0,2,0,3
E00016202,Total,100,9,2,7,1,81,80,1,7,5,0,0,2,2
E00016205,Total,129,92,32,60,0,2,1,1,34,33,0,1,0,1
E00016208,Total,140,42,24,18,1,63,55,8,34,31,0,3,0,0
E00016199,Total,119,35,12,23,0,63,61,2,19,15,0,4,0,2
E00016200,Total,84,6,1,5,0,72,66,6,5,5,0,0,0,1
E00016201,Total,56,5,2,3,0,45,44,1,6,6,0,0,0,0
E00016203,Total,129,12,3,9,0,111,109,2,4,4,0,0,0,2
E00016207,Total,114,17,9,8,0,92,82,10,5,2,0,3,0,0
E00016163,Total,129,59,15,44,0,35,34,1,35,34,0,1,0,0
E00016165,Total,119,65,34,31,1,20,9,11,33,32,0,1,0,0
E00016168,Total,86,39,18,21,0,8,0,8,39,39,0,0,0,0
E00016169,Total,116,80,48,32,0,17,16,1,16,15,0,1,0,3
E00016172,Total,127,49,15,34,0,39,31,8,39,38,0,0,1,0
E00016177,Total,121,55,21,34,0,35,25,10,30,28,0,2,0,1
E00016219,Total,146,41,11,30,0,44,28,16,57,52,1,3,1,4
E00016220,Total,136,48,10,38,0,30,14,16,58,53,0,5,0,0
E00016221,Total,146,47,15,32,0,36,33,3,63,60,0,3,0,0
E00016223,Total,107,49,21,28,3,33,13,20,22,20,0,1,1,0
E00016225,Total,117,47,11,36,3,28,8,20,37,35,1,0,1,2
E00016255,Total,101,47,9,38,4,19,7,12,30,28,0,2,0,1
E00016218,Total,113,41,11,30,0,11,5,6,60,56,0,4,0,1
E00016222,Total,160,47,14,33,0,53,29,24,59,56,1,2,0,1
E00016224,Total,156,69,17,52,2,18,7,11,62,59,0,2,1,5
E00016226,Total,120,47,13,34,2,43,29,14,27,22,0,4,1,1
E00016227,Total,139,58,16,42,0,20,10,10,59,59,0,0,0,2
E00016228,Total,125,59,21,38,2,26,12,14,36,35,0,1,0,2
E00016229,Total,182,67,21,46,0,38,12,26,77,70,0,7,0,0
E00016230,Total,134,59,26,33,13,22,4,18,36,34,1,1,0,4
E00016231,Total,145,38,8,30,0,72,45,27,30,30,0,0,0,5
E00016232,Total,130,33,8,25,0,52,46,6,44,39,3,2,0,1
E00016233,Total,154,20,2,18,12,99,89,10,21,17,0,4,0,2
E00016212,Total,120,45,16,29,0,56,46,10,19,11,0,8,0,0
E00016249,Total,118,25,9,16,0,78,72,6,12,9,0,3,0,3
E00016254,Total,107,48,15,33,1,41,10,31,16,10,0,6,0,1
E00173952,Total,108,24,11,13,0,56,34,22,28,28,0,0,0,0
E00174016,Total,98,42,19,23,2,28,22,6,25,19,0,6,0,1
E00174022,Total,91,46,13,33,0,18,15,3,24,24,0,0,0,3
E00174008,Total,130,37,9,28,15,1,1,0,77,73,1,3,0,0
E00174010,Total,120,32,7,25,0,2,1,1,86,83,0,2,1,0
E00174013,Total,126,36,12,24,0,2,2,0,88,86,0,1,1,0
E00174015,Total,107,42,11,31,0,4,3,1,61,59,0,2,0,0
E00174025,Total,127,36,4,32,7,2,2,0,81,80,0,1,0,1
E00174027,Total,96,43,12,31,0,0,0,0,52,50,0,2,0,1
E00016178,Total,121,35,13,22,0,74,51,23,12,11,0,1,0,0
E00016179,Total,128,54,23,31,0,48,45,3,26,22,0,4,0,0
E00016180,Total,132,68,35,33,0,35,33,2,29,27,1,0,1,0
E00016187,Total,130,89,34,55,1,13,13,0,27,24,0,3,0,0
E00016189,Total,128,98,36,62,0,10,10,0,20,20,0,0,0,0
E00016166,Total,101,41,19,22,0,8,7,1,52,52,0,0,0,0
E00016167,Total,120,85,60,25,0,4,3,1,28,26,0,1,1,3
E00016171,Total,153,31,16,15,0,2,1,1,113,109,4,0,0,7
E00016174,Total,121,78,39,39,0,20,1,19,23,23,0,0,0,0
E00016204,Total,140,63,25,38,0,35,35,0,42,41,0,1,0,0
E00016206,Total,121,62,25,37,1,26,21,5,31,31,0,0,0,1
E00016160,Total,131,107,72,35,1,5,4,1,17,17,0,0,0,1
E00016183,Total,119,69,32,37,0,2,2,0,47,46,0,1,0,1
E00016185,Total,114,87,50,37,0,4,3,1,23,21,0,2,0,0
E00016191,Total,122,76,47,29,0,7,1,6,39,38,0,1,0,0
E00016195,Total,128,81,35,46,0,16,16,0,31,30,0,1,0,0
E00016197,Total,150,48,19,29,0,6,1,5,96,95,0,0,1,0
E00016161,Total,166,62,19,43,0,35,25,10,67,64,0,3,0,2
E00016190,Total,156,31,14,17,0,91,86,5,34,34,0,0,0,0
E00016192,Total,173,49,15,34,0,69,36,33,52,51,0,1,0,3
E00016193,Total,154,52,15,37,0,3,0,3,98,94,0,3,1,1
E00016194,Total,152,25,6,19,1,75,8,67,51,51,0,0,0,0
E00016196,Total,179,69,13,56,2,68,63,5,38,36,0,2,0,2
E00016905,Total,114,32,8,24,1,50,45,5,29,25,0,2,2,2
E00016907,Total,115,43,14,29,0,51,42,9,19,17,0,0,2,2
E00016908,Total,123,14,3,11,9,81,64,17,18,15,0,2,1,1
E00016910,Total,128,16,3,13,0,98,95,3,14,11,0,1,2,0
E00016912,Total,97,8,1,7,2,79,72,7,8,7,0,1,0,0
E00016909,Total,146,21,4,17,1,108,87,21,15,14,0,0,1,1
E00016911,Total,171,30,9,21,28,103,58,45,8,7,0,1,0,2
E00016913,Total,158,16,2,14,9,119,92,27,14,14,0,0,0,0
E00016914,Total,125,19,4,15,0,94,91,3,12,12,0,0,0,0
E00016896,Total,140,53,15,38,4,22,10,12,60,60,0,0,0,1
E00016898,Total,113,42,17,25,0,20,13,7,51,48,0,3,0,0
E00016900,Total,144,72,22,50,0,22,15,7,50,49,0,1,0,0
E00016901,Total,85,28,7,21,0,9,8,1,42,42,0,0,0,6
E00016904,Total,107,36,8,28,3,26,11,15,40,39,0,1,0,2
E00016906,Total,113,63,14,49,0,15,10,5,35,33,0,2,0,0
E00016883,Total,142,52,18,34,0,46,26,20,44,40,0,4,0,0
E00016888,Total,129,57,19,38,0,47,21,26,24,20,0,4,0,1
E00016891,Total,171,43,7,36,0,70,41,29,56,45,0,11,0,2
E00016892,Total,126,55,15,40,1,23,13,10,47,41,0,6,0,0
E00016894,Total,151,62,20,42,2,45,19,26,39,23,0,16,0,3
E00016880,Total,115,40,6,34,0,54,38,16,20,20,0,0,0,1
E00016897,Total,180,58,20,38,1,41,14,27,80,77,0,2,1,0
E00016899,Total,159,67,18,49,3,17,14,3,72,70,0,1,1,0
E00016902,Total,137,55,17,38,3,35,26,9,43,42,0,0,1,1
E00016903,Total,128,59,14,45,1,18,5,13,49,45,0,4,0,1
E00016564,Total,133,74,24,50,1,29,11,18,29,25,0,3,1,0
E00016567,Total,82,12,2,10,1,59,46,13,10,8,0,0,2,0
E00016569,Total,128,76,27,49,0,25,15,10,27,26,0,1,0,0
E00016571,Total,115,94,36,58,0,5,3,2,16,13,1,2,0,0
E00173700,Total,103,46,26,20,0,43,4,39,14,9,0,5,0,0
E00173702,Total,105,54,23,31,0,42,4,38,9,7,0,2,0,0
E00016558,Total,126,48,9,39,1,36,12,24,41,37,1,2,1,0
E00016561,Total,121,42,7,35,0,35,7,28,43,41,0,2,0,1
E00016566,Total,113,50,20,30,0,25,7,18,37,36,0,1,0,1
E00016568,Total,144,61,20,41,3,36,14,22,40,34,0,6,0,4
E00016572,Total,147,54,24,30,0,46,24,22,47,45,0,2,0,0
E00016575,Total,127,69,17,52,1,37,14,23,20,17,0,2,1,0
E00016557,Total,95,33,11,22,0,21,10,11,40,34,0,6,0,1
E00016559,Total,137,62,27,35,0,30,5,25,44,41,0,3,0,1
E00016560,Total,146,60,18,42,0,20,5,15,65,60,1,3,1,1
E00016562,Total,147,72,25,47,2,28,3,25,45,44,0,1,0,0
E00016563,Total,126,66,26,40,0,28,0,28,31,28,0,3,0,1
E00016565,Total,154,60,18,42,0,54,34,20,40,38,0,2,0,0
E00016544,Total,149,85,35,50,0,28,22,6,34,34,0,0,0,2
E00016574,Total,128,80,28,52,0,20,13,7,26,19,0,6,1,2
E00016576,Total,125,68,22,46,0,24,8,16,31,30,0,1,0,2
E00016577,Total,144,92,36,56,1,27,19,8,21,18,0,3,0,3
E00016578,Total,108,72,28,44,0,13,7,6,21,15,0,6,0,2
E00016635,Total,175,59,28,31,1,22,7,15,92,91,0,1,0,1
E00016640,Total,142,26,12,14,0,98,16,82,17,16,0,1,0,1
E00016641,Total,147,31,3,28,4,89,79,10,13,12,0,1,0,10
E00016642,Total,183,44,21,23,12,89,60,29,35,34,0,0,1,3
E00016643,Total,147,46,15,31,1,76,72,4,23,22,0,1,0,1
E00016630,Total,152,61,16,45,9,31,8,23,50,45,2,2,1,1
E00016647,Total,151,25,6,19,2,73,62,11,51,49,0,1,1,0
E00016648,Total,136,37,13,24,0,34,11,23,65,64,0,1,0,0
E00016649,Total,138,13,2,11,0,71,19,52,54,50,1,1,2,0
E00016651,Total,148,51,15,36,12,32,11,21,53,51,0,1,1,0
E00016629,Total,159,36,11,25,4,83,77,6,34,33,0,0,1,2
E00016650,Total,122,43,10,33,1,61,35,26,16,15,0,1,0,1
E00016652,Total,129,16,5,11,0,86,40,46,26,24,0,1,1,1
E00016654,Total,133,7,2,5,0,108,19,89,18,17,0,0,1,0
E00016657,Total,139,21,4,17,2,98,37,61,18,17,0,1,0,0
E00016633,Total,109,32,9,23,0,45,10,35,31,30,0,0,1,1
E00016636,Total,133,39,13,26,0,2,1,1,92,90,0,1,1,0
E00016638,Total,84,20,9,11,1,3,2,1,59,58,0,0,1,1
E00016639,Total,200,35,15,20,44,108,9,99,13,9,0,1,3,0
E00016674,Total,122,76,29,47,1,18,7,11,27,26,0,1,0,0
E00174018,Total,234,52,12,40,12,11,8,3,158,157,0,1,0,1
E00174019,Total,84,18,10,8,18,26,6,20,20,19,0,1,0,2
E00174021,Total,55,21,5,16,0,6,4,2,28,26,0,2,0,0
E00016628,Total,149,58,30,28,23,29,6,23,36,35,0,1,0,3
E00016637,Total,194,99,55,44,8,11,2,9,76,72,1,3,0,0
E00174024,Total,114,35,11,24,1,9,4,5,67,67,0,0,0,2
E00174029,Total,112,20,10,10,0,9,6,3,83,83,0,0,0,0
E00174030,Total,110,38,5,33,5,25,14,11,42,41,0,0,1,0
E00016644,Total,208,44,9,35,4,74,45,29,72,72,0,0,0,14
E00016645,Total,170,60,21,39,5,59,29,30,40,38,0,2,0,6
E00016646,Total,173,45,17,28,1,61,22,39,66,64,0,2,0,0
E00016584,Total,233,86,33,53,3,54,14,40,89,83,1,2,3,1
E00016596,Total,126,87,31,56,0,19,17,2,19,19,0,0,0,1
E00016598,Total,228,117,41,76,4,46,28,18,59,54,0,4,1,2
E00016623,Total,173,63,7,56,0,49,5,44,61,59,0,1,1,0
E00174036,Total,97,55,21,34,4,16,9,7,21,20,0,1,0,1
E00174038,Total,190,63,16,47,2,27,11,16,96,92,0,4,0,2
E00016585,Total,134,69,32,37,0,9,1,8,56,54,0,2,0,0
E00016593,Total,244,136,62,74,4,12,6,6,90,84,2,0,4,2
E00016600,Total,144,120,47,73,0,17,14,3,7,6,0,1,0,0
E00016602,Total,133,95,29,66,0,27,9,18,11,11,0,0,0,0
E00016624,Total,129,48,15,33,4,15,7,8,60,57,0,3,0,2
E00016625,Total,139,91,35,56,0,15,3,12,33,29,0,3,1,0
E00016587,Total,184,89,32,57,3,58,47,11,33,33,0,0,0,1
E00016594,Total,157,82,23,59,1,29,14,15,43,40,0,3,0,2
E00016605,Total,181,97,31,66,1,28,13,15,54,51,0,3,0,1
E00016608,Total,91,58,22,36,0,15,7,8,17,17,0,0,0,1
E00016626,Total,135,98,42,56,0,13,12,1,24,23,0,1,0,0
E00016589,Total,133,74,43,31,1,43,8,35,13,13,0,0,0,2
E00016595,Total,127,11,1,10,1,107,24,83,8,8,0,0,0,0
E00016597,Total,133,15,3,12,5,93,21,72,18,18,0,0,0,2
E00016599,Total,139,57,16,41,8,29,25,4,44,42,0,2,0,1
E00016601,Total,139,29,6,23,0,87,81,6,21,19,0,1,1,2
E00016607,Total,115,32,16,16,0,62,9,53,20,20,0,0,0,1
E00016573,Total,130,63,18,45,1,16,7,9,49,49,0,0,0,1
E00016579,Total,134,39,15,24,0,29,9,20,64,62,0,2,0,2
E00016580,Total,168,83,30,53,2,28,8,20,55,51,1,2,1,0
E00016581,Total,186,63,21,42,0,55,22,33,67,64,1,2,0,1
E00016582,Total,180,98,35,63,1,29,12,17,52,49,0,3,0,0
E00016546,Total,141,47,13,34,1,17,4,13,73,68,0,4,1,3
E00016547,Total,164,95,33,62,1,14,4,10,53,52,0,1,0,1
E00016548,Total,137,101,45,56,1,13,8,5,20,19,0,0,1,2
E00016550,Total,158,68,23,45,1,22,4,18,67,63,0,3,1,0
E00016583,Total,121,61,14,47,0,42,18,24,18,16,0,2,0,0
E00016542,Total,135,56,12,44,1,49,45,4,26,24,0,2,0,3
E00016552,Total,142,30,12,18,4,90,3,87,12,12,0,0,0,6
E00016554,Total,123,88,27,61,0,7,1,6,24,22,0,2,0,4
E00016555,Total,114,38,14,24,0,60,38,22,12,12,0,0,0,4
E00016556,Total,126,77,25,52,1,23,16,7,22,22,0,0,0,3
E00016543,Total,168,62,13,49,1,55,38,17,48,43,0,4,1,2
E00016545,Total,128,34,10,24,0,71,32,39,16,12,1,3,0,7
E00016549,Total,134,113,50,63,0,4,2,2,12,11,0,1,0,5
E00016551,Total,140,115,41,74,0,9,7,2,8,6,0,2,0,8
E00016553,Total,130,78,32,46,0,18,6,12,22,20,0,2,0,12
E00016335,Total,91,63,21,42,0,6,2,4,22,18,0,3,1,0
E00016336,Total,136,86,38,48,14,11,3,8,23,22,0,1,0,2
E00016339,Total,117,100,34,66,2,6,2,4,6,5,0,1,0,3
E00016340,Total,131,103,30,73,0,8,3,5,19,18,0,0,1,1
E00016341,Total,115,101,34,67,2,4,1,3,7,7,0,0,0,1
E00016309,Total,146,68,29,39,0,21,4,17,56,55,0,1,0,1
E00016323,Total,114,47,17,30,1,50,25,25,14,14,0,0,0,2
E00016324,Total,161,75,27,48,1,37,19,18,46,44,0,2,0,2
E00016325,Total,142,43,14,29,1,6,2,4,92,88,0,4,0,0
E00016327,Total,124,72,27,45,0,16,5,11,36,35,0,1,0,0
E00016326,Total,124,81,27,54,0,18,2,16,25,24,0,0,1,0
E00016329,Total,144,61,21,40,12,37,1,36,32,31,0,1,0,2
E00016332,Total,148,112,60,52,2,9,2,7,25,24,0,1,0,0
E00016333,Total,111,66,27,39,0,13,1,12,32,28,1,3,0,0
E00016337,Total,122,101,44,57,3,7,1,6,11,9,0,2,0,0
E00016311,Total,126,88,28,60,0,14,6,8,24,22,0,2,0,0
E00016328,Total,126,86,22,64,1,14,10,4,25,25,0,0,0,0
E00016330,Total,117,53,18,35,0,29,20,9,33,33,0,0,0,2
E00016331,Total,137,81,42,39,0,9,1,8,47,44,0,2,1,0
E00016334,Total,163,117,34,83,0,12,4,8,31,28,0,3,0,3
E00016613,Total,150,133,71,62,1,3,1,2,12,11,0,1,0,1
E00016614,Total,128,55,18,37,1,55,10,45,13,12,0,1,0,4
E00016615,Total,122,87,37,50,0,0,0,0,35,35,0,0,0,0
E00016618,Total,116,28,8,20,1,62,18,44,23,22,0,1,0,2
E00016621,Total,135,19,1,18,0,87,21,66,28,27,0,1,0,1
E00016609,Total,104,89,44,45,1,1,0,1,12,11,0,0,1,1
E00016617,Total,137,98,46,52,0,15,5,10,24,22,0,2,0,0
E00016619,Total,136,85,38,47,0,38,23,15,12,11,0,1,0,1
E00016620,Total,117,105,39,66,1,4,3,1,7,6,0,0,1,0
E00016622,Total,107,42,12,30,0,40,5,35,23,20,0,3,0,2
E00016588,Total,164,105,46,59,0,12,11,1,43,39,0,4,0,4
E00016592,Total,185,118,64,54,1,7,1,6,58,54,0,4,0,1
E00016604,Total,106,93,56,37,0,1,0,1,12,12,0,0,0,0
E00016611,Total,105,39,15,24,11,11,2,9,44,39,2,3,0,0
E00016612,Total,90,60,34,26,0,14,6,8,15,11,0,4,0,1
E00016616,Total,117,44,17,27,0,12,5,7,61,58,0,2,1,0
E00016590,Total,171,108,44,64,0,22,14,8,41,39,0,2,0,0
E00016591,Total,130,80,43,37,0,28,14,14,20,19,0,1,0,2
E00016603,Total,198,120,49,71,0,36,27,9,41,39,0,2,0,1
E00016606,Total,165,123,45,78,0,13,7,6,29,28,0,1,0,0
E00016610,Total,133,90,30,60,2,11,3,8,30,30,0,0,0,0
E00016653,Total,127,83,21,62,0,14,5,9,28,25,0,2,1,2
E00016655,Total,143,52,8,44,1,11,1,10,78,70,0,7,1,1
E00016656,Total,154,70,27,43,2,17,8,9,63,61,0,2,0,2
E00016662,Total,117,78,24,54,0,11,4,7,27,25,0,2,0,1
E00016664,Total,161,99,27,72,1,12,4,8,49,47,0,2,0,0
E00016631,Total,140,75,23,52,1,25,3,22,38,37,0,1,0,1
E00016658,Total,107,32,16,16,1,5,0,5,68,66,0,2,0,1
E00016659,Total,121,45,8,37,1,39,5,34,35,34,0,0,1,1
E00016660,Total,159,69,17,52,0,42,6,36,48,46,0,1,1,0
E00016663,Total,149,60,14,46,0,33,6,27,54,50,0,4,0,2
E00016632,Total,133,60,17,43,0,21,3,18,51,50,0,1,0,1
E00016666,Total,127,62,22,40,6,22,9,13,36,35,0,1,0,1
E00016667,Total,159,75,20,55,0,29,14,15,54,51,0,3,0,1
E00016669,Total,113,37,5,32,1,39,32,7,36,36,0,0,0,0
E00016673,Total,121,72,17,55,1,18,6,12,29,28,0,1,0,1
E00016668,Total,117,50,17,33,2,46,7,39,19,19,0,0,0,0
E00016670,Total,111,78,34,44,1,9,7,2,21,20,0,1,0,2
E00016671,Total,75,33,15,18,0,28,7,21,14,14,0,0,0,0
E00016672,Total,141,69,21,48,0,28,4,24,43,41,0,0,2,1
E00173708,Total,83,26,4,22,1,4,3,1,52,51,0,1,0,0
E00173710,Total,118,63,20,43,3,16,5,11,35,34,0,1,0,1
E00016661,Total,121,76,26,50,0,19,5,14,23,22,0,0,1,3
E00173936,Total,113,9,0,9,10,70,1,69,24,23,0,1,0,0
E00173937,Total,110,23,5,18,13,4,2,2,69,69,0,0,0,1
E00173938,Total,149,54,8,46,1,5,1,4,87,84,0,2,1,2
E00174035,Total,101,52,5,47,1,2,0,2,46,44,0,2,0,0
E00016796,Total,157,42,10,32,0,75,7,68,39,36,0,1,2,1
E00016799,Total,138,73,20,53,0,20,0,20,45,44,0,1,0,0
E00016804,Total,216,115,78,37,1,19,3,16,77,76,0,1,0,4
E00016805,Total,138,64,27,37,0,38,7,31,36,34,0,0,2,0
E00016806,Total,103,42,14,28,0,34,4,30,25,24,0,1,0,2
E00016781,Total,110,57,24,33,0,32,7,25,20,20,0,0,0,1
E00016793,Total,113,14,6,8,0,89,6,83,9,9,0,0,0,1
E00016794,Total,113,36,9,27,0,38,21,17,36,35,1,0,0,3
E00016801,Total,107,57,22,35,0,18,2,16,32,31,0,0,1,0
E00016803,Total,101,47,17,30,0,27,8,19,25,22,0,3,0,2
E00016808,Total,106,40,13,27,0,30,10,20,32,31,0,1,0,4
E00016813,Total,144,79,16,63,0,27,9,18,38,38,0,0,0,0
E00016814,Total,129,67,30,37,0,26,8,18,34,32,0,2,0,2
E00016815,Total,109,54,17,37,0,22,4,18,32,29,0,3,0,1
E00016818,Total,130,58,17,41,2,35,1,34,34,33,0,1,0,1
E00016819,Total,112,47,17,30,0,34,4,30,30,29,0,1,0,1
E00016778,Total,140,60,15,45,1,34,4,30,42,41,0,1,0,3
E00016788,Total,117,58,25,33,0,33,11,22,26,26,0,0,0,0
E00016791,Total,125,52,15,37,3,31,6,25,37,36,0,0,1,2
E00016800,Total,112,43,9,34,0,28,12,16,41,40,0,1,0,0
E00016820,Total,106,23,6,17,0,44,30,14,38,38,0,0,0,1
E00016823,Total,122,50,13,37,0,37,6,31,34,34,0,0,0,1
E00016300,Total,148,60,14,46,0,6,1,5,79,72,2,5,0,3
E00016310,Total,91,75,34,41,0,4,1,3,11,11,0,0,0,1
E00016312,Total,140,63,17,46,3,22,2,20,51,48,0,3,0,1
E00016343,Total,137,117,56,61,1,2,0,2,16,13,0,3,0,1
E00016344,Total,193,92,23,69,1,14,5,9,84,83,0,1,0,2
E00016301,Total,162,98,31,67,1,14,3,11,47,47,0,0,0,2
E00016302,Total,120,69,20,49,0,29,11,18,21,21,0,0,0,1
E00016316,Total,119,86,39,47,1,14,2,12,16,15,0,1,0,2
E00016338,Total,169,95,26,69,19,22,11,11,33,33,0,0,0,0
E00016342,Total,108,77,32,45,2,5,3,2,23,23,0,0,0,1
E00016303,Total,162,95,30,65,1,28,5,23,38,37,0,0,1,0
E00016304,Total,156,86,28,58,0,22,1,21,46,44,0,1,1,2
E00016313,Total,106,60,14,46,3,3,1,2,40,40,0,0,0,0
E00016318,Total,127,86,20,66,1,10,2,8,29,26,0,2,1,1
E00016345,Total,122,66,23,43,1,9,1,8,46,41,0,5,0,0
E00016307,Total,166,48,12,36,3,74,19,55,37,33,0,2,2,4
E00016314,Total,129,52,17,35,0,52,11,41,23,23,0,0,0,2
E00016319,Total,120,30,10,20,1,63,27,36,23,18,1,3,1,3
E00016321,Total,159,53,18,35,0,23,5,18,83,81,0,2,0,0
E00016322,Total,168,63,19,44,13,44,19,25,44,40,1,2,1,4
E00016305,Total,116,51,19,32,1,38,19,19,23,21,0,2,0,3
E00016306,Total,170,45,8,37,1,96,71,25,28,28,0,0,0,0
E00016308,Total,145,47,15,32,0,39,15,24,58,57,1,0,0,1
E00016315,Total,194,79,28,51,0,67,32,35,48,46,0,0,2,0
E00016317,Total,119,75,21,54,0,14,12,2,30,28,0,2,0,0
E00016320,Total,122,74,22,52,0,14,4,10,32,30,0,1,1,2
E00016779,Total,88,35,8,27,0,21,0,21,32,30,0,0,2,0
E00016789,Total,144,111,49,62,0,2,2,0,30,25,0,4,1,1
E00016797,Total,144,108,51,57,0,13,3,10,19,17,0,2,0,4
E00016798,Total,152,45,13,32,0,19,13,6,86,82,0,4,0,2
E00016821,Total,160,82,30,52,1,33,21,12,43,41,0,1,1,1
E00016780,Total,156,48,11,37,0,31,7,24,74,72,0,1,1,3
E00016782,Total,174,74,23,51,0,29,16,13,71,69,0,0,2,0
E00016790,Total,91,17,5,12,1,20,7,13,52,49,1,1,1,1
E00016792,Total,170,20,5,15,0,35,29,6,115,112,2,0,1,0
E00016795,Total,114,48,17,31,2,31,11,20,30,29,0,1,0,3
E00016783,Total,154,74,27,47,2,47,3,44,31,30,0,0,1,0
E00016802,Total,161,64,17,47,3,46,2,44,48,46,0,2,0,0
E00016807,Total,194,53,16,37,2,64,7,57,74,70,0,2,2,1
E00016809,Total,157,77,20,57,0,34,2,32,46,42,0,1,3,0
E00016810,Total,144,56,15,41,0,29,2,27,58,56,0,2,0,1
E00016784,Total,123,61,24,37,1,30,6,24,31,31,0,0,0,0
E00016811,Total,134,48,19,29,0,28,7,21,57,49,1,5,2,1
E00016812,Total,117,74,30,44,0,16,5,11,26,22,0,4,0,1
E00016816,Total,104,57,21,36,0,17,2,15,29,27,0,2,0,1
E00016817,Total,115,69,27,42,0,17,3,14,28,28,0,0,0,1
E00016785,Total,110,28,14,14,1,45,34,11,35,35,0,0,0,1
E00016786,Total,98,51,20,31,3,23,5,18,21,20,0,1,0,0
E00016787,Total,274,11,6,5,1,238,229,9,20,15,1,3,1,4
E00016822,Total,129,50,14,36,0,33,6,27,44,43,0,1,0,2
E00016824,Total,102,56,20,36,1,11,3,8,31,29,0,0,2,3
E00016445,Total,128,73,27,46,0,28,2,26,25,24,0,0,1,2
E00016448,Total,124,111,53,58,0,6,2,4,7,7,0,0,0,0
E00016452,Total,118,91,55,36,0,3,0,3,23,22,0,1,0,1
E00016454,Total,119,76,32,44,0,20,4,16,23,23,0,0,0,0
E00016455,Total,113,67,25,42,0,23,13,10,19,18,0,1,0,4
E00016446,Total,167,81,30,51,0,20,7,13,65,61,0,3,1,1
E00016453,Total,120,56,21,35,0,32,1,31,32,32,0,0,0,0
E00016456,Total,128,56,19,37,0,32,9,23,40,36,0,3,1,0
E00016457,Total,135,54,19,35,5,10,0,10,66,63,0,3,0,0
E00016462,Total,149,86,23,63,5,6,0,6,50,47,0,2,1,2
E00173944,Total,131,37,7,30,0,7,3,4,86,79,4,1,2,1
E00173945,Total,134,36,7,29,1,28,2,26,67,67,0,0,0,2
E00016444,Total,111,61,21,40,5,18,5,13,27,27,0,0,0,0
E00016484,Total,136,95,44,51,0,7,1,6,32,29,0,2,1,2
E00016485,Total,117,33,13,20,0,65,63,2,19,19,0,0,0,0
E00016488,Total,113,92,44,48,1,5,2,3,13,12,0,0,1,2
E00016489,Total,204,85,32,53,0,32,30,2,84,84,0,0,0,3
E00016443,Total,129,100,38,62,0,20,18,2,7,7,0,0,0,2
E00016483,Total,110,49,18,31,0,29,7,22,30,28,0,2,0,2
E00016486,Total,137,91,33,58,0,26,18,8,18,18,0,0,0,2
E00016487,Total,123,67,26,41,0,46,41,5,10,9,0,1,0,0
E00016491,Total,120,51,15,36,0,40,9,31,28,27,0,1,0,1
E00016449,Total,127,55,19,36,0,29,5,24,42,40,1,1,0,1
E00016450,Total,122,56,20,36,0,20,1,19,46,45,0,1,0,0
E00016451,Total,129,67,24,43,0,34,18,16,27,25,0,2,0,1
E00016490,Total,131,80,19,61,0,23,16,7,28,23,2,3,0,0
E00016492,Total,115,43,20,23,0,46,36,10,25,23,0,1,1,1
E00016281,Total,135,107,38,69,1,12,3,9,15,14,0,0,1,0
E00016290,Total,122,86,29,57,1,9,0,9,26,24,0,2,0,0
E00016292,Total,107,85,27,58,0,6,2,4,16,16,0,0,0,0
E00016293,Total,123,89,35,54,1,10,1,9,23,21,0,1,1,0
E00016295,Total,135,110,29,81,2,5,0,5,17,15,0,2,0,1
E00016258,Total,132,107,40,67,3,7,1,6,15,12,0,3,0,0
E00016259,Total,130,79,26,53,1,33,11,22,15,14,0,1,0,2
E00016298,Total,139,107,38,69,2,8,1,7,21,20,0,1,0,1
E00016299,Total,138,101,38,63,1,17,2,15,18,17,0,1,0,1
E00016274,Total,116,78,29,49,0,16,1,15,22,21,0,1,0,0
E00016276,Total,150,59,16,43,0,40,9,31,48,44,0,4,0,3
E00016277,Total,124,57,26,31,3,29,5,24,34,30,0,4,0,1
E00016278,Total,104,75,20,55,1,9,4,5,18,18,0,0,0,1
E00016285,Total,110,67,18,49,0,15,5,10,27,26,0,1,0,1
E00016256,Total,121,74,29,45,0,22,7,15,21,17,0,1,3,4
E00016284,Total,114,80,24,56,0,16,5,11,16,14,0,2,0,2
E00016286,Total,136,100,32,68,0,7,5,2,28,27,0,1,0,1
E00016296,Total,120,71,18,53,0,19,4,15,28,27,0,0,1,2
E00016297,Total,138,83,41,42,0,28,10,18,25,21,0,3,1,2
E00016275,Total,159,64,21,43,1,40,17,23,52,48,0,4,0,2
E00016279,Total,112,76,25,51,1,10,3,7,25,18,0,4,3,0
E00016280,Total,102,83,26,57,0,2,2,0,11,10,0,1,0,6
E00016283,Total,135,100,28,72,0,12,3,9,23,22,0,0,1,0
E00016287,Total,118,93,24,69,1,6,1,5,18,17,0,1,0,0
E00016513,Total,131,55,23,32,0,28,2,26,48,46,0,2,0,0
E00016514,Total,125,46,15,31,0,61,4,57,16,16,0,0,0,2
E00016515,Total,129,69,29,40,0,41,14,27,18,18,0,0,0,1
E00016516,Total,111,47,17,30,1,44,10,34,17,17,0,0,0,2
E00016519,Total,112,73,24,49,0,13,2,11,25,23,1,1,0,1
E00016521,Total,131,38,11,27,0,54,5,49,39,39,0,0,0,0
E00016493,Total,161,60,10,50,0,63,11,52,34,33,0,1,0,4
E00016499,Total,119,68,34,34,0,22,6,16,26,24,0,2,0,3
E00016502,Total,107,63,21,42,0,30,4,26,14,12,0,2,0,0
E00016503,Total,109,46,5,41,1,19,2,17,43,41,0,1,1,0
E00016507,Total,103,63,14,49,2,14,4,10,24,20,0,4,0,0
E00016540,Total,119,93,50,43,2,3,0,3,19,19,0,0,0,2
E00016498,Total,227,154,59,95,3,38,7,31,30,28,0,2,0,2
E00016500,Total,127,41,17,24,0,69,14,55,16,16,0,0,0,1
E00016505,Total,156,36,14,22,2,79,11,68,37,36,0,1,0,2
E00016541,Total,137,114,46,68,0,7,2,5,14,12,0,1,1,2
E00016494,Total,156,95,35,60,6,5,1,4,47,46,0,1,0,3
E00016495,Total,109,70,11,59,0,5,4,1,30,28,0,2,0,4
E00016501,Total,149,123,55,68,0,7,0,7,18,16,0,2,0,1
E00016508,Total,139,114,47,67,2,9,3,6,12,11,0,1,0,2
E00016511,Total,125,107,38,69,1,3,0,3,13,13,0,0,0,1
E00016504,Total,115,105,53,52,0,3,0,3,6,5,0,1,0,1
E00016506,Total,133,117,52,65,1,1,0,1,14,14,0,0,0,0
E00016509,Total,158,122,60,62,0,17,2,15,19,19,0,0,0,0
E00016510,Total,107,96,50,46,0,0,0,0,10,8,0,2,0,1
E00016512,Total,124,106,45,61,0,4,0,4,13,10,0,3,0,1
E00016750,Total,116,68,16,52,0,7,1,6,38,35,0,2,1,3
E00016752,Total,130,111,58,53,1,0,0,0,16,16,0,0,0,2
E00016753,Total,108,47,14,33,2,34,23,11,25,25,0,0,0,0
E00016758,Total,141,37,12,25,4,72,23,49,25,23,0,2,0,3
E00016763,Total,132,91,24,67,0,17,1,16,24,20,0,3,1,0
E00016738,Total,172,84,23,61,0,45,8,37,43,43,0,0,0,0
E00016739,Total,119,77,27,50,1,29,5,24,11,10,0,0,1,1
E00016740,Total,140,67,21,46,0,32,5,27,40,37,0,2,1,1
E00016749,Total,127,71,16,55,0,27,5,22,29,28,1,0,0,0
E00016755,Total,176,62,17,45,1,58,26,32,55,52,0,3,0,0
E00016745,Total,160,96,20,76,0,35,4,31,27,25,0,1,1,2
E00016746,Total,148,84,22,62,2,35,17,18,26,24,0,2,0,1
E00016751,Total,127,53,18,35,3,29,12,17,40,38,0,1,1,2
E00016754,Total,131,71,22,49,1,14,5,9,44,41,0,3,0,1
E00016757,Total,117,84,25,59,0,6,0,6,24,22,0,1,1,3
E00016732,Total,165,46,8,38,0,19,1,18,100,99,0,1,0,0
E00016735,Total,152,67,22,45,0,40,14,26,44,39,0,5,0,1
E00016741,Total,132,57,15,42,0,42,23,19,30,29,0,1,0,3
E00016742,Total,150,57,12,45,0,48,21,27,44,41,1,1,1,1
E00016733,Total,130,90,31,59,0,22,6,16,16,14,0,1,1,2
E00016734,Total,118,75,24,51,0,14,4,10,29,27,0,2,0,0
E00016743,Total,117,81,28,53,5,6,2,4,25,23,0,2,0,0
E00016744,Total,130,89,37,52,0,21,1,20,20,20,0,0,0,0
E00016747,Total,114,44,17,27,0,29,4,25,39,34,0,5,0,2
E00016261,Total,119,73,25,48,0,21,9,12,23,23,0,0,0,2
E00016282,Total,145,72,15,57,0,23,10,13,49,48,0,1,0,1
E00016288,Total,179,98,24,74,1,15,1,14,62,61,0,1,0,3
E00016289,Total,125,71,17,54,0,22,3,19,32,32,0,0,0,0
E00016294,Total,121,78,22,56,1,23,7,16,19,18,0,1,0,0
E00016260,Total,139,103,33,70,1,18,1,17,16,14,0,2,0,1
E00016262,Total,110,72,29,43,0,7,1,6,31,31,0,0,0,0
E00016266,Total,132,98,35,63,1,15,3,12,16,16,0,0,0,2
E00016267,Total,102,77,31,46,1,11,4,7,12,12,0,0,0,1
E00016271,Total,148,112,49,63,3,6,3,3,23,22,0,1,0,4
E00016257,Total,147,101,30,71,0,21,12,9,23,19,0,4,0,2
E00016263,Total,99,63,27,36,0,23,9,14,12,12,0,0,0,1
E00016265,Total,186,98,32,66,2,33,7,26,51,50,0,0,1,2
E00016268,Total,170,89,39,50,0,45,8,37,36,35,0,0,1,0
E00016291,Total,167,56,15,41,7,30,12,18,69,66,0,0,3,5
E00016264,Total,115,105,53,52,0,2,2,0,7,6,0,1,0,1
E00016269,Total,125,100,36,64,0,7,4,3,16,15,0,0,1,2
E00016270,Total,100,87,40,47,0,2,0,2,9,8,0,1,0,2
E00016272,Total,131,86,43,43,0,3,2,1,42,41,0,1,0,0
E00016273,Total,132,87,29,58,1,13,4,9,29,28,0,1,0,2
E00016930,Total,216,147,65,82,1,39,19,20,26,25,0,0,1,3
E00016946,Total,149,83,23,60,3,44,16,28,18,15,0,3,0,1
E00016952,Total,119,34,11,23,0,73,17,56,11,10,0,0,1,1
E00016964,Total,114,50,11,39,1,47,13,34,16,14,0,2,0,0
E00016929,Total,111,37,14,23,1,56,16,40,16,15,0,0,1,1
E00016931,Total,103,36,11,25,0,57,20,37,10,10,0,0,0,0
E00016932,Total,110,37,9,28,0,60,12,48,13,13,0,0,0,0
E00016954,Total,93,29,10,19,0,51,20,31,13,13,0,0,0,0
E00016961,Total,124,53,21,32,0,49,9,40,20,17,0,2,1,2
E00016933,Total,168,102,30,72,0,45,11,34,20,17,0,3,0,1
E00016953,Total,130,22,4,18,0,87,17,70,17,16,0,0,1,4
E00016957,Total,110,57,17,40,1,38,9,29,14,12,0,2,0,0
E00016960,Total,107,31,11,20,2,52,17,35,21,21,0,0,0,1
E00016966,Total,77,42,11,31,1,19,9,10,13,11,0,2,0,2
E00016940,Total,101,68,18,50,0,6,3,3,25,23,0,2,0,2
E00016941,Total,134,116,44,72,0,7,0,7,11,9,0,1,1,0
E00016942,Total,118,77,25,52,0,7,4,3,33,33,0,0,0,1
E00016943,Total,123,68,9,59,0,4,1,3,48,45,0,3,0,3
E00016944,Total,118,81,35,46,1,10,3,7,26,26,0,0,0,0
E00016945,Total,107,61,3,58,0,10,4,6,36,33,0,1,2,0
E00016728,Total,113,28,13,15,0,71,66,5,14,13,0,1,0,0
E00016764,Total,110,44,15,29,0,36,32,4,27,27,0,0,0,3
E00016766,Total,139,43,17,26,1,74,48,26,19,16,0,1,2,2
E00016768,Total,143,23,8,15,1,111,109,2,7,7,0,0,0,1
E00016772,Total,140,86,32,54,2,22,17,5,29,26,0,3,0,1
E00016737,Total,113,54,18,36,5,36,21,15,17,16,0,1,0,1
E00016748,Total,132,33,5,28,0,73,46,27,24,23,0,1,0,2
E00016756,Total,115,12,0,12,0,80,41,39,22,20,0,1,1,1
E00016760,Total,145,50,17,33,8,51,28,23,35,35,0,0,0,1
E00173704,Total,112,32,13,19,7,21,19,2,48,47,0,1,0,4
E00173705,Total,66,14,0,14,15,21,16,5,15,14,1,0,0,1
E00173707,Total,73,6,3,3,29,0,0,0,36,35,0,1,0,2
E00016729,Total,107,77,41,36,0,21,5,16,9,7,0,1,1,0
E00016730,Total,131,92,46,46,0,13,2,11,26,24,0,2,0,0
E00016759,Total,130,99,50,49,0,10,6,4,21,19,0,1,1,0
E00016761,Total,121,103,40,63,0,3,1,2,13,11,0,2,0,2
E00016762,Total,116,69,31,38,0,19,14,5,27,26,0,1,0,1
E00016765,Total,109,56,20,36,1,7,1,6,43,42,0,1,0,2
E00016767,Total,130,59,14,45,0,40,13,27,30,29,0,1,0,1
E00016770,Total,95,37,10,27,2,2,1,1,54,51,0,2,1,0
E00016771,Total,167,96,32,64,0,41,16,25,29,29,0,0,0,1
E00016774,Total,132,90,40,50,3,16,3,13,22,21,0,1,0,1
E00016777,Total,146,96,35,61,1,14,5,9,34,32,0,2,0,1
E00016731,Total,135,61,16,45,1,32,26,6,39,39,0,0,0,2
E00016769,Total,153,47,9,38,0,75,73,2,31,31,0,0,0,0
E00016773,Total,122,23,8,15,0,83,78,5,14,13,0,1,0,2
E00016775,Total,111,20,6,14,0,83,79,4,7,6,0,1,0,1
E00016776,Total,149,66,19,47,0,44,18,26,37,34,0,3,0,2
E00016460,Total,135,89,45,44,0,25,6,19,21,18,0,0,3,0
E00016463,Total,230,45,13,32,13,95,16,79,74,70,1,2,1,3
E00016467,Total,137,93,42,51,0,20,5,15,24,24,0,0,0,0
E00016469,Total,141,63,26,37,0,38,24,14,39,38,0,1,0,1
E00016471,Total,101,16,5,11,2,68,62,6,14,13,0,1,0,1
E00016472,Total,187,42,24,18,1,104,25,79,40,38,2,0,0,0
E00016447,Total,135,68,20,48,1,32,28,4,33,31,0,2,0,1
E00016458,Total,146,69,14,55,0,49,22,27,26,25,0,0,1,2
E00016459,Total,98,76,41,35,0,4,2,2,17,14,2,1,0,1
E00016464,Total,119,17,1,16,0,89,86,3,12,7,0,4,1,1
E00016465,Total,121,41,16,25,0,70,34,36,6,5,0,0,1,4
E00016466,Total,116,84,44,40,0,12,3,9,19,19,0,0,0,1
E00016475,Total,86,15,5,10,2,58,21,37,10,9,0,1,0,1
E00016476,Total,108,36,5,31,1,47,16,31,23,20,0,1,2,1
E00016478,Total,83,55,22,33,0,12,7,5,16,15,0,1,0,0
E00016479,Total,96,17,4,13,0,72,18,54,6,3,0,1,2,1
E00016480,Total,114,15,3,12,0,90,27,63,7,7,0,0,0,2
E00016482,Total,107,28,11,17,0,53,20,33,26,25,0,1,0,0
E00016468,Total,94,68,35,33,0,7,2,5,17,14,0,2,1,2
E00016470,Total,104,60,21,39,0,27,14,13,14,10,0,1,3,3
E00016473,Total,126,75,17,58,1,29,9,20,16,15,0,1,0,5
E00016474,Total,128,54,17,37,2,17,11,6,50,48,0,1,1,5
E00016477,Total,134,77,24,53,3,23,17,6,29,28,0,0,1,2
E00016481,Total,170,32,9,23,3,19,4,15,113,106,0,2,5,3
E00016126,Total,126,112,58,54,0,7,4,3,7,7,0,0,0,0
E00016127,Total,142,108,45,63,10,9,4,5,12,12,0,0,0,3
E00016131,Total,137,60,19,41,2,60,45,15,14,14,0,0,0,1
E00016134,Total,138,36,14,22,3,85,76,9,14,14,0,0,0,0
E00016140,Total,123,52,11,41,2,42,34,8,25,22,0,3,0,2
E00016118,Total,144,100,45,55,2,22,16,6,20,20,0,0,0,0
E00016154,Total,153,40,17,23,2,83,72,11,28,24,0,3,1,0
E00016155,Total,153,54,15,39,0,27,20,7,72,71,1,0,0,0
E00016156,Total,141,27,6,21,0,102,8,94,12,10,0,1,1,0
E00016157,Total,125,54,19,35,1,58,25,33,11,10,0,1,0,1
E00016112,Total,142,66,11,55,0,41,34,7,34,34,0,0,0,1
E00016119,Total,122,97,47,50,1,4,2,2,20,18,0,2,0,0
E00016121,Total,126,66,16,50,6,17,12,5,36,32,0,4,0,1
E00016123,Total,122,100,36,64,1,6,1,5,12,12,0,0,0,3
E00016158,Total,125,93,28,65,1,8,4,4,23,22,1,0,0,0
E00016113,Total,162,58,18,40,0,82,30,52,19,18,0,1,0,3
E00016120,Total,110,43,13,30,0,53,14,39,14,13,0,0,1,0
E00016122,Total,120,61,15,46,0,50,18,32,9,8,0,1,0,0
E00016124,Total,112,41,13,28,0,55,18,37,14,13,0,1,0,2
E00016125,Total,120,43,14,29,0,53,13,40,23,19,0,4,0,1
E00016114,Total,106,42,9,33,1,51,17,34,12,10,0,2,0,0
E00016128,Total,133,54,13,41,1,60,19,41,17,15,0,2,0,1
E00016130,Total,132,55,14,41,0,59,21,38,16,14,0,1,1,2
E00016133,Total,119,36,8,28,2,70,12,58,11,9,0,1,1,0
E00016135,Total,135,43,11,32,2,72,16,56,17,16,0,0,1,1
E00016948,Total,146,19,3,16,0,99,36,63,25,21,0,4,0,3
E00016949,Total,130,26,9,17,0,81,31,50,22,21,0,1,0,1
E00016951,Total,126,17,2,15,0,88,36,52,20,20,0,0,0,1
E00016955,Total,128,29,9,20,0,82,25,57,17,17,0,0,0,0
E00016956,Total,108,30,10,20,0,68,34,34,9,9,0,0,0,1
E00016950,Total,110,87,45,42,1,8,3,5,12,9,0,3,0,2
E00016967,Total,115,82,33,49,1,14,4,10,18,16,0,1,1,0
E00016968,Total,118,83,41,42,1,19,5,14,14,13,0,0,1,1
E00016969,Total,115,45,23,22,0,56,11,45,13,11,0,1,1,1
E00016971,Total,113,60,27,33,0,41,11,30,12,11,0,1,0,0
E00016928,Total,132,73,17,56,0,37,11,26,20,19,0,1,0,2
E00016947,Total,141,14,8,6,0,122,89,33,3,3,0,0,0,2
E00016958,Total,122,57,14,43,0,50,22,28,14,12,0,1,1,1
E00016963,Total,124,89,39,50,0,19,4,15,15,13,0,2,0,1
E00016937,Total,151,130,80,50,0,4,1,3,10,10,0,0,0,7
E00016959,Total,108,95,56,39,1,3,2,1,8,7,0,1,0,1
E00016962,Total,190,37,14,23,2,126,21,105,23,21,0,0,2,2
E00016965,Total,142,25,11,14,2,94,28,66,19,19,0,0,0,2
E00016970,Total,144,45,17,28,0,81,20,61,18,17,0,1,0,0
E00016934,Total,126,82,35,47,5,13,5,8,23,21,0,2,0,3
E00016935,Total,157,111,45,66,1,16,4,12,27,25,0,2,0,2
E00016936,Total,125,91,33,58,1,12,6,6,21,18,0,3,0,0
E00016938,Total,102,79,39,40,0,6,0,6,17,16,1,0,0,0
E00016939,Total,122,86,33,53,4,6,0,6,24,23,0,0,1,2
E00016496,Total,121,60,22,38,9,33,3,30,19,18,0,0,1,0
E00016517,Total,97,42,14,28,4,40,4,36,11,11,0,0,0,0
E00016518,Total,133,63,26,37,1,41,8,33,28,26,0,2,0,0
E00016523,Total,120,44,15,29,0,52,8,44,20,16,0,4,0,4
E00016524,Total,131,62,26,36,4,26,7,19,38,35,0,3,0,1
E00016525,Total,126,103,75,28,0,9,3,6,12,12,0,0,0,2
E00016497,Total,120,39,8,31,0,24,2,22,57,54,0,3,0,0
E00016527,Total,103,35,7,28,0,7,1,6,60,58,0,2,0,1
E00016528,Total,113,49,8,41,12,8,2,6,44,44,0,0,0,0
E00016531,Total,127,48,17,31,4,58,11,47,16,14,0,2,0,1
E00016532,Total,105,28,4,24,0,39,11,28,37,36,0,1,0,1
E00016535,Total,112,33,6,27,0,43,10,33,36,33,0,2,1,0
E00016520,Total,124,48,21,27,1,66,7,59,8,7,0,1,0,1
E00016522,Total,146,39,14,25,0,96,24,72,9,9,0,0,0,2
E00016526,Total,141,32,16,16,0,87,22,65,21,21,0,0,0,1
E00016529,Total,115,50,16,34,1,53,10,43,11,11,0,0,0,0
E00016530,Total,118,38,20,18,0,69,11,58,11,10,0,1,0,0
E00016533,Total,113,70,29,41,0,31,8,23,11,10,0,0,1,1
E00016534,Total,110,89,48,41,3,9,3,6,9,9,0,0,0,0
E00016536,Total,115,45,12,33,0,58,13,45,10,9,0,1,0,2
E00016537,Total,106,55,18,37,3,30,13,17,17,15,0,1,1,1
E00016538,Total,121,54,10,44,0,58,18,40,9,8,0,1,0,0
E00016539,Total,146,60,20,40,3,74,15,59,8,8,0,0,0,1
E00016830,Total,139,108,47,61,0,7,3,4,23,23,0,0,0,1
E00016839,Total,117,71,9,62,0,18,2,16,28,25,0,2,1,0
E00016845,Total,136,68,17,51,0,40,5,35,28,24,0,4,0,0
E00016872,Total,140,73,27,46,0,38,10,28,25,22,0,2,1,4
E00016873,Total,134,30,4,26,0,72,38,34,30,29,0,0,1,2
E00016838,Total,129,18,8,10,0,100,99,1,7,6,0,0,1,4
E00016840,Total,126,82,45,37,4,16,14,2,24,24,0,0,0,0
E00016847,Total,105,13,6,7,0,84,62,22,8,8,0,0,0,0
E00016852,Total,87,49,21,28,2,10,8,2,25,25,0,0,0,1
E00016858,Total,99,3,1,2,0,92,9,83,4,4,0,0,0,0
E00016874,Total,116,4,4,0,0,100,4,96,7,6,0,0,1,5
E00016826,Total,116,35,14,21,0,65,52,13,14,12,0,1,1,2
E00016831,Total,112,36,15,21,0,56,40,16,18,16,0,1,1,2
E00016832,Total,125,75,46,29,0,34,13,21,14,13,0,1,0,2
E00016833,Total,121,106,55,51,0,2,0,2,13,12,0,1,0,0
E00016875,Total,98,44,15,29,1,37,29,8,14,12,0,2,0,2
E00016828,Total,114,62,22,40,0,23,11,12,25,24,0,0,1,4
E00016850,Total,92,35,10,25,0,40,18,22,16,14,0,2,0,1
E00016854,Total,120,60,16,44,0,47,17,30,12,12,0,0,0,1
E00016855,Total,111,63,6,57,0,8,0,8,39,38,0,1,0,1
E00016857,Total,126,56,18,38,2,43,23,20,25,25,0,0,0,0
E00016878,Total,116,23,4,19,0,79,70,9,12,12,0,0,0,2
E00016827,Total,134,59,21,38,2,32,12,20,40,38,0,1,1,1
E00016834,Total,139,46,11,35,1,48,18,30,43,39,0,4,0,1
E00016842,Total,100,46,17,29,0,42,35,7,12,11,0,1,0,0
E00016856,Total,188,55,12,43,1,17,15,2,113,107,0,6,0,2
E00016876,Total,106,20,3,17,1,65,17,48,17,14,0,1,2,3
E00016877,Total,111,34,10,24,0,63,60,3,13,13,0,0,0,1
E00016115,Total,125,33,8,25,1,76,20,56,14,10,0,4,0,1
E00016136,Total,119,37,8,29,0,69,24,45,12,12,0,0,0,1
E00016137,Total,129,51,16,35,0,62,16,46,13,12,0,1,0,3
E00016138,Total,122,39,8,31,0,68,32,36,14,11,0,1,2,1
E00016139,Total,129,52,15,37,1,68,23,45,7,7,0,0,0,1
E00016116,Total,134,92,26,66,1,14,6,8,27,26,0,1,0,0
E00016129,Total,141,65,25,40,0,41,14,27,34,31,0,2,1,1
E00016142,Total,140,22,10,12,1,101,79,22,13,13,0,0,0,3
E00016144,Total,119,24,8,16,0,87,44,43,6,5,0,0,1,2
E00016145,Total,137,10,4,6,0,104,101,3,23,23,0,0,0,0
E00016150,Total,138,20,6,14,0,97,93,4,20,18,0,2,0,1
E00016117,Total,147,62,27,35,1,53,10,43,29,24,0,3,2,2
E00016132,Total,127,62,19,43,11,25,8,17,27,26,0,1,0,2
E00016143,Total,113,57,15,42,0,47,17,30,9,7,0,1,1,0
E00016147,Total,153,57,24,33,8,70,12,58,18,17,0,0,1,0
E00016153,Total,125,30,13,17,0,82,8,74,13,11,0,2,0,0
E00016141,Total,118,41,20,21,1,66,22,44,8,8,0,0,0,2
E00016146,Total,127,37,17,20,0,70,28,42,18,17,0,0,1,2
E00016148,Total,127,43,9,34,10,62,21,41,11,9,0,2,0,1
E00016149,Total,132,26,2,24,1,89,37,52,15,14,0,1,0,1
E00016151,Total,112,26,6,20,0,74,31,43,12,10,0,2,0,0
E00016152,Total,125,23,4,19,0,88,28,60,13,10,1,1,1,1
E00016843,Total,106,59,23,36,0,20,14,6,26,22,0,3,1,1
E00016863,Total,146,49,10,39,9,33,5,28,55,53,0,1,1,0
E00016868,Total,128,55,27,28,2,50,32,18,20,20,0,0,0,1
E00016870,Total,139,81,31,50,1,25,8,17,31,31,0,0,0,1
E00016871,Total,119,68,33,35,0,39,28,11,11,10,0,0,1,1
E00016848,Total,98,70,27,43,1,19,2,17,7,7,0,0,0,1
E00016859,Total,146,99,49,50,0,10,3,7,36,34,0,2,0,1
E00016861,Total,181,70,23,47,0,34,16,18,73,66,1,5,1,4
E00016862,Total,141,69,19,50,0,33,10,23,38,36,0,2,0,1
E00016866,Total,148,62,24,38,0,39,21,18,46,40,2,1,3,1
E00016829,Total,135,54,9,45,0,29,17,12,52,50,0,1,1,0
E00016851,Total,134,109,47,62,0,7,3,4,15,15,0,0,0,3
E00016860,Total,155,44,11,33,1,45,30,15,64,64,0,0,0,1
E00016864,Total,154,57,17,40,0,71,65,6,25,23,0,2,0,1
E00016867,Total,132,74,32,42,1,33,22,11,23,22,0,1,0,1
E00016869,Total,123,26,3,23,2,78,48,30,17,17,0,0,0,0
E00016835,Total,151,69,20,49,1,50,26,24,31,31,0,0,0,0
E00016837,Total,125,72,23,49,0,19,16,3,34,30,0,4,0,0
E00016846,Total,140,75,26,49,3,20,12,8,38,37,0,1,0,4
E00016849,Total,102,28,1,27,0,35,16,19,39,37,0,0,2,0
E00016865,Total,139,62,23,39,0,55,5,50,21,20,0,1,0,1
E00016825,Total,113,19,3,16,0,73,66,7,20,20,0,0,0,1
E00016836,Total,124,67,30,37,0,46,22,24,9,9,0,0,0,2
E00016841,Total,130,28,8,20,0,92,80,12,9,9,0,0,0,1
E00016844,Total,111,63,28,35,0,38,11,27,10,10,0,0,0,0
E00016853,Total,116,12,7,5,2,89,86,3,13,13,0,0,0,0
E00016350,Total,133,55,17,38,1,58,13,45,18,17,0,1,0,1
E00016369,Total,132,50,13,37,1,61,27,34,19,18,0,1,0,1
E00016370,Total,144,54,16,38,0,57,15,42,33,33,0,0,0,0
E00016371,Total,119,57,17,40,0,40,13,27,22,20,0,2,0,0
E00016374,Total,120,44,20,24,0,60,21,39,16,14,0,2,0,0
E00016352,Total,110,49,10,39,0,48,13,35,13,13,0,0,0,0
E00016373,Total,123,44,14,30,1,49,11,38,27,24,1,2,0,2
E00016378,Total,125,51,16,35,2,60,16,44,12,11,0,1,0,0
E00016381,Total,143,55,20,35,1,49,21,28,37,33,0,0,4,1
E00016382,Total,107,53,20,33,2,40,11,29,11,9,0,1,1,1
E00016348,Total,91,47,15,32,9,25,9,16,10,10,0,0,0,0
E00016372,Total,118,44,7,37,3,53,19,34,17,16,0,0,1,1
E00016375,Total,105,53,13,40,0,30,12,18,21,18,0,2,1,1
E00016377,Total,120,49,15,34,1,56,22,34,14,12,0,1,1,0
E00016379,Total,131,60,30,30,0,58,36,22,13,10,0,3,0,0
E00016349,Total,125,53,14,39,0,58,21,37,13,11,0,1,1,1
E00016351,Total,196,76,17,59,0,102,35,67,15,14,0,1,0,3
E00016376,Total,111,49,20,29,0,47,12,35,13,12,0,1,0,2
E00016383,Total,132,67,18,49,0,50,15,35,15,15,0,0,0,0
E00016356,Total,136,67,15,52,2,58,17,41,8,7,0,0,1,1
E00016387,Total,146,62,23,39,1,61,21,40,20,17,0,3,0,2
E00016393,Total,118,55,18,37,2,45,20,25,16,16,0,0,0,0
E00165790,Total,108,46,14,32,0,51,12,39,11,10,0,1,0,0
E00016361,Total,104,48,22,26,0,29,13,16,27,24,1,2,0,0
E00016363,Total,139,65,25,40,0,66,18,48,5,5,0,0,0,3
E00016366,Total,99,80,33,47,0,17,4,13,2,2,0,0,0,0
E00016367,Total,81,51,23,28,0,18,2,16,9,8,0,0,1,3
E00016368,Total,100,72,21,51,0,21,4,17,7,6,0,0,1,0
E00016353,Total,117,57,19,38,0,46,18,28,13,12,0,1,0,1
E00016360,Total,194,82,20,62,8,55,21,34,47,44,0,3,0,2
E00016380,Total,100,43,11,32,0,42,12,30,12,11,0,1,0,3
E00016389,Total,110,46,19,27,1,50,13,37,11,11,0,0,0,2
E00016390,Total,85,50,20,30,1,23,8,15,10,8,0,2,0,1
E00016392,Total,119,51,10,41,0,61,26,35,7,6,0,1,0,0
E00016359,Total,120,82,39,43,0,27,4,23,9,9,0,0,0,2
E00016384,Total,121,85,32,53,0,15,6,9,20,19,0,1,0,1
E00016385,Total,177,31,10,21,1,132,40,92,10,9,0,1,0,3
E00016386,Total,145,16,4,12,0,114,33,81,14,10,0,4,0,1
E00016388,Total,132,105,50,55,0,10,4,6,16,16,0,0,0,1
E00016346,Total,106,48,21,27,0,38,9,29,15,13,0,1,1,5
E00016354,Total,104,24,9,15,0,39,5,34,36,33,0,2,1,5
E00016357,Total,131,23,5,18,1,96,40,56,10,10,0,0,0,1
E00016358,Total,122,39,9,30,6,35,10,25,39,29,1,7,2,3
E00016391,Total,118,97,40,57,2,3,0,3,16,14,0,2,0,0
E00016362,Total,131,64,21,43,4,46,11,35,15,14,0,0,1,2
E00016364,Total,126,59,17,42,0,51,20,31,14,11,0,2,1,2
E00016365,Total,109,34,12,22,0,66,14,52,7,7,0,0,0,2
E00016394,Total,120,60,14,46,0,47,13,34,13,12,0,1,0,0
E00165789,Total,158,27,7,20,0,113,23,90,15,9,0,0,6,3
E00016678,Total,105,20,9,11,1,73,67,6,9,9,0,0,0,2
E00016722,Total,150,16,3,13,1,115,64,51,12,9,0,3,0,6
E00016724,Total,110,39,5,34,5,20,11,9,46,45,0,1,0,0
E00016727,Total,110,26,7,19,0,62,58,4,22,20,0,2,0,0
E00016676,Total,96,24,10,14,0,50,37,13,18,17,0,1,0,4
E00016685,Total,127,28,10,18,1,83,43,40,15,13,0,1,1,0
E00016690,Total,128,14,4,10,0,103,58,45,8,8,0,0,0,3
E00016691,Total,108,44,12,32,0,37,29,8,27,25,2,0,0,0
E00016726,Total,102,3,0,3,1,85,78,7,11,10,0,1,0,2
E00016688,Total,107,42,17,25,0,51,50,1,13,10,0,2,1,1
E00016695,Total,108,39,18,21,0,47,43,4,21,20,0,1,0,1
E00016705,Total,124,28,7,21,0,22,8,14,72,71,0,0,1,2
E00016710,Total,124,31,11,20,1,53,47,6,39,38,0,1,0,0
E00016712,Total,97,12,0,12,0,40,33,7,45,41,0,1,3,0
E00016682,Total,129,46,9,37,1,5,4,1,74,70,0,4,0,3
E00016686,Total,133,29,7,22,0,72,71,1,29,29,0,0,0,3
E00016699,Total,126,34,5,29,0,60,50,10,27,26,0,1,0,5
E00016702,Total,186,16,3,13,1,128,27,101,40,39,0,1,0,1
E00016707,Total,183,31,9,22,0,32,28,4,118,113,0,4,1,2
E00016711,Total,146,35,8,27,1,21,6,15,88,85,0,2,1,1
E00016696,Total,104,25,10,15,1,54,52,2,23,23,0,0,0,1
E00016698,Total,160,34,13,21,0,86,73,13,39,37,0,2,0,1
E00016703,Total,112,19,8,11,1,67,65,2,21,19,0,1,1,4
E00016713,Total,223,21,4,17,7,101,46,55,91,86,2,2,1,3
E00165804,Total,112,29,12,17,2,51,47,4,27,25,0,2,0,3
